 Ilko Naaborg=i.j.naaborg@eco.rug.nl
 Pardis Nabavi=pardis.nabavi@indek.kth.se
 Mahmoud Sami NABI=msaminabi@gmail.com
 Munirul Haque Nabin=munirul.nabin@deakin.edu.au
 Andras Nabradi=nabradi@agr.unideb.hu
 Miruna Lucia Nachescu=mnachescu@oxygencomputers.ro
 Francisco Nadal De Simone=francisco.nadaldesimone@bcl.lu
 Jean-Pierre Nadal=jpnadal@ehess.fr
 Azhar Nadeem=azhar.nadeem@live.com
 Muhammad Nadeem=nadeem_sk@yahoo.com
 Simon Nadel=simon.nadel@ut-capitole.fr
 Jon James Nadenichek=jon.nadenichek@csun.edu
 Florence Naegelen=florence.naegelen@univ-fcomte.fr
 Randi Næs=randi.naes@fin.dep.no
 Tatiana-Roxana Nae=nae.roxana@yahoo.com
 Jörg Naeve=joerg.naeve@reutlingen-university.de
 Steven Nafziger=steven.nafziger@williams.edu
 Mamoru Nagano=mnagano@econ.seikei.ac.jp
 Hari K. Nagarajan=hknagarajan@irma.ac.in
 Sabitha Nagarajan=saprofessionalmail@gmail.com
 Boppana Nagarjuna=bnss@uohyd.ernet.in
 Shuichi Nagata=snagata@kwansei.ac.jp
 Jun Nagayasu=nagayasu@sk.tsukuba.ac.jp
 Biswajit Nag=biswajit@iift.ac.in
 Rosemarie Nagel=rosemarie.nagel@upf.edu
 Stefan Nagel=stenagel@umich.edu
 Arne J. Nagengast=arne.nagengast@bundesbank.de
 Alireza Naghavi=alireza.naghavi@unibo.it
 Amir Naghshineh-Pour=abibis@msn.com
 Matthew G. Nagler=mnagler@ccny.cuny.edu
 Stephan Nagl=snagl@kpmg.com
 Venkatarao Nagubadi=nagubadi2001@hotmail.com
 Rania Ihab Naguib=rania.naguib@live.uwe.ac.uk
 Éva Nagypál=eva.nagypal@cfpb.gov
 Nagy Imre Zoltan=dr.nagy.imre.zoltan@gmail.com
 Babu Nahata=nahata@louisville.edu
 Daehoon Nahm=daehoon.nahm@mq.edu.au
 Niek Nahuis=n.j.nahuis@minfin.nl
 Ruth-Aida Nahum=ruth-aida.nahum@infra.kth.se
 Abdul Sattar Nahyoun=asattar.n@gmail.com
 Iuliia Naidenova=naidenovayn@gmail.com
 Claire Naiditch=claire.naiditch@univ-lille1.fr
 Karmen Naidoo=karmen.naidoo@uct.ac.za
 Ahmad K. Naimzada=ahmad.naimzada@unimib.it
 Harikesh S. Nair=harikesh.nair@stanford.edu
 P Nair=paddynair@rediffmail.com
 Takumi Naito=tnaito@waseda.jp
 Boris Najman=najman.boris@gmail.com
 Luciano Nakabashi=luciano.nakabashi@gmail.com
 Jun Nakabayashi=nakabayashi@econ.tohoku.ac.jp
 Masaki Nakabayashi=mn@iss.u-tokyo.ac.jp
 Ryuichi Nakagawa=ryu-naka@kansai-u.ac.jp
 Daisuke Nakajima=nakajima@res.otaru-uc.ac.jp
 Kentaro Nakajima=nakajima.kentaro@gmail.com
 Makoto Nakajima=makoto.nakajima@gmail.com
 Tetsuya Nakajima=nakajima@econ.osaka-cu.ac.jp
 Yasuhiro Nakamoto=nakamoto@ip.kyusan-u.ac.jp
 Alice O. Nakamura=alice.nakamura@ualberta.ca
 Emi Nakamura=enakamura@columbia.edu
 Masao Nakamura=masao.nakamura.yvr@gmail.com
 Ryohei Nakamura=ubbz0252@okayama-u.ac.jp
 Noritsugu Nakanishi=nakanishi@econ.kobe-u.ac.jp
 Eduardo Nakasone=eduardo@umd.edu
 Hiroyuki Nakata=hnakata@stanfordalumni.org
 Tomoaki Nakatani=naktom2@gmail.com
 Aadil Nakhoda=aadilnakhoda@gmail.com
 Kanda Naknoi=kanda.naknoi@uconn.edu
 Anton Nakov=anton.nakov@gmail.com
 Vu Hoang Nam=hoangnamftu@yahoo.com
 Anupam Nanda=a.nanda@reading.ac.uk
 Ramana Nanda=rnanda@hbs.edu
 Vikram Nanda=vnanda@business.rutgers.edu
 Alita Nandi=anandi@essex.ac.uk
 Tushar K. Nandi=nandi.tushar@gmail.com
 Boaz Nandwa=bnandwa@imf.org
 Nanjundaiah=cnnanjundaiah@yahoo.co.uk
 Tommaso Nannicini=tommaso.nannicini@unibocconi.it
 Orachos Napasintuwong=orachos.n@ku.ac.th
 Stefan Napel=stefan.napel@uni-bayreuth.de
 Loretta Napoleoni=loretta@lorettanapoleoni.org
 Mauro Napoletano=mauro.napoletano@ofce.sciences-po.fr
 Oreste Napolitano=napolitano@uniparthenope.it
 Hassan Naqvi=naqvi@skku.edu
 Nadeem Naqvi=nadnaq@hotmail.com
 Ruthira Naraidoo=ruthira.naraidoo@up.ac.za
 Badri G Narayanan=badrinarayanang@gmail.com
 Supreena Narayanan=supreenan@gmail.com
 Paresh Kumar Narayan=narayan@deakin.edu.au
 Seema Narayan=seema.narayan@rmit.edu.au
 Alexandre Narciso=an.eco@cbs.dk
 Gaia Narciso=narcisog@tcd.ie
 Chiara Nardi=chiara.nardi@univr.it
 Martina Nardon=mnardon@unive.it
 Alessandro Narduzzo=narduz@gmail.com
 Daiju Narita=daiju.narita@ifw-kiel.de
 Thibaut Marc Robert Alain Narme=kgr275@alumni.ku.dk
 Clare Allyson Narrod=cnarrod@umd.edu
 Rajneesh Narula=r.narula@reading.ac.uk
 Asim Nasar=aasimnasar@gmail.com
 Alvaro Nascimento=anascimento@porto.ucp.pt
 Hanan Naser=ecp10hsn@sheffield.ac.uk
 Ioannis Nasioulas=ioannisnasioulas@gmail.com
 Muhammad Nasir=nasirawan84@yahoo.com
 Rosniwati Nasir=rosniwati.nasir@nottingham.edu.my
 Zafar Mueen Nasir=zafarmueen@pide.org.pk
 James M. Nason=jmnason@ncsu.edu
 Nima Nasrollahi Shahri=nima_nasr@yahoo.com
 Rus'an Nasrudin=rusan.nasrudin@gmail.com
 Svein Olav Nås=son@rcn.no
 Carmen Nastase=carmenn@seap.usv.ro
 Mircea Nastase=mirceanastase2004@yahoo.com
 Stefanos A. Nastis=snastis@auth.gr
 Anna Naszodi=anna.naszodi@gmail.com
 Piergiovanna Natale=piergiovanna.natale@unimib.it
 Jean-Marc Natal=jnatal@imf.org
 Maria Manuela Santos Natário=m.natario@ipg.pt
 Dev Nathan=nathandev@hotmail.com
 Max Nathan=m.a.nathan@lse.ac.uk
 Hiranya Nath=eco_hkn@shsu.edu
 Sushmit Nath=sushmitnath@gmail.com
 Paolo Naticchioni=p.naticchioni@gmail.com
 Fidelina B. Natividad-Carlos=fidelina.carlos@upd.edu.ph
 Alberto Naudon=anaudon@bcentral.cl
 George Sami Naufal=gnaufal@aus.edu
 Celine Nauges=c.nauges@uq.edu.au
 Helen Tammela Naughton=helen.naughton@mso.umt.edu
 Dieter Nautz=dieter.nautz@fu-berlin.de
 Alejandro Martínez Nava=alex.nava.x@gmail.com
 K Navaneetham=nava@cds.ac.in
 Pietro Navarra=navarrap@lse.ac.uk
 Manuel Navarro-IbaÑez=mnavarro@ull.es
 Mikel Navarro=mnavarro@orkestra.deusto.es
 Noemí Navarro=navarro.prada@gmail.com
 María Navarro Paniagua=m.navarropaniagua@lancs.ac.uk
 Salvador Navarro=snavarr@uwo.ca
 Antonio Navas=a.navas@sheffield.ac.uk
 Javier F. Navas=jfernav@upo.es
 Patrick Navatte=patrick.navatte@univ-rennes1.fr
 Daniel Navia=dnavia@bde.es
 Guy Navon=navong@gmail.com
 David Navratil=dnavratil@csas.cz
 Sanjay K. Nawalkha=nawalkha@isenberg.umass.edu
 Ahmad Nawaz=ahmad.nawaz@wiwi.uni-goettingen.de
 Saima Nawaz=saima.nawaz@pide.org.pk
 Durre Nayab=nayab@pide.org.pk
 Prof. Purusottam Nayak=nehu_pnayak@yahoo.co.in
 Sabri Nayan=sabrinayan585@yahoo.com
 Alexey Naydenov=a.naydyonov@gmail.com
 Nikolay Trifonov Naydenov=niknayd@iki.bas.bg
 Robin Andrew Naylor=robin.naylor@warwick.ac.uk
 Laurence Nayman=laurence.nayman@cepii.fr
 Ashish Nayyar=nayyar.ashish@gmail.com
 Hina Nazli=hinanazli@idspak.com
 Samina Nazli=samina@pide.org.pk
 Eugenia Nazrullaeva=e.nazrullaeva@gmail.com
 Mthuli Ncube=m.ncube@afdb.org
 Michael O. A. Ndanshau=ndanshau@udsm.ac.tz
 Francis NDEM=fndem@yahoo.com
 Simon Wagura Ndiritu=simon.wagura@economics.gu.se
 Yves Francis ODIA NDONGO=franqodia@gmail.com
 Eleanya Kalu Nduka=eleanyanduka@yahoo.com
 Cornelia Neagu=neagu_cornelia@yahoo.com
 Larry D. Neal=lneal@illinois.edu
 Mark Neal=markbneal@gmail.com
 Timothy Neal=tjrneal@gmail.com
 Liviu Neamtu=liviu.neamtu@utgjiu.ro
 Kyriakos C. Neanidis=kyriakos.neanidis@manchester.ac.uk
 J. Peter Neary=peter.neary@economics.ox.ac.uk
 Antoine NEBOUT=nebout@greg-hec.com
 Thomas Nechyba=nechyba@duke.edu
 Miroslav Nedelchev=mnedelchev@hotmail.com
 Stefan Nedelea=stefan_nedelea@yahoo.com
 Ángel Enrique Neder=enrique.neder@eco.uncor.edu
 Peter Nedergaard=pne@ifs.ku.dk
 Urvi Neelakantan=urvi.neelakantan@rich.frb.org
 Harris Neeliah=ahiscons@gmail.com
 Sven Neelsen=neelsen@bmg.eur.nl
 Christopher Neely=neely@stls.frb.org
 Zvika Neeman=zvika@post.tau.ac.il
 Frank Neffke=frank_neffke@hks.harvard.edu
 Iliuță Costel Negricea (Iliuta Costel Negricea)=negricea@yahoo.com
 Mariano Negri=mariano.negri@jpmorgan.com
 Ioana Negru=ioana.negru@anglia.ac.uk
 Malika Neifar=malika.neifar@topnet.tn
 Christine Neill=cneill@wlu.ca
 William Neilson=wneilson@utk.edu
 Brent Neiman=brent.neiman@chicagobooth.edu
 Isabel Neira=isabel.neira@usc.es
 Julian Neira=j.neira@exeter.ac.uk
 Katharine S. Neiss=katharine.neiss@bankofengland.co.uk
 Christopher J. Nekarda=christopher.j.nekarda@frb.gov
 Lena Nekby=lena.nekby@ne.su.se
 Mehdi Nekhili=mehdi.nekhili@univ-reims.fr
 Denis Nekipelov=nekipelov@econ.berkeley.edu
 Milton Nektarios=nektar@unipi.gr
 Jan Nelissen=j.h.m.nelissen@uvt.nl
 Kevin Nell=knell@fep.up.pt
 Benjamin D. Nelson=benjamin.nelson@bankofengland.co.uk
 Carl Nelson=chnelson@illinois.edu
 Douglas Nelson=dnelson@tulane.edu
 Edward Nelson=edward.nelson@frb.gov
 Gerald Charles Nelson=nelson.gerald.c@gmail.com
 Jon P. Nelson=jpn@psu.edu
 Julie Nelson=julie.nelson@umb.edu
 Tim Nelson=tanelson@agl.com.au
 célestin chameni Nembua=chameni@yahoo.com
 Gregory F. Nemet=nemet@wisc.edu
 Silvia Nenci=silvia.nenci@uniroma3.it
 Tome Nenovski=nenovski@uacs.edu.mk
 Nikolay Nenovsky=nenovsky@gmail.com
 Michael Nentwich=mnent@oeaw.ac.at
 Mani Nepal=mani.nepal@bus.illinois.edu
 Rabindra Nepal=r.nepal@uq.edu.au
 Daniel Nepelski=daniel.nepelski@ec.europa.eu
 Gernot Nerb=nerb@ifo.de
 Andrea Neri=andrea.neri@bancaditalia.it
 Breno Pinheiro Neri=breno.neri@nyu.edu
 Claudia Neri=claudia.neri@unisg.ch
 Celso Pereira Neris Junior=cnerisjr@gmail.com
 Stefano Neri=stefano.neri@bancaditalia.it
 Marc Nerlove=mnerlove@arec.umd.edu
 Manfred Nermuth=manfred.nermuth@univie.ac.at
 Giovanni Nero=gio.nero@workmail.com
 Sebastiano Nerozzi=sebastiano.nerozzi@alice.it
 Birger Nerré=birger.nerre@giz.de
 Annamaria Nese=anese@unisa.it
 Travis Dean Nesmith=travis.d.nesmith@frb.gov
 Rabia Nessah=r.nessah@ieseg.fr
 Marianne Nessen=marianne.nessen@riksbank.se
 Erik Nesson=etnesson@bsu.edu
 Lionel Nesta=lionel.nesta@sciencespo.fr
 Kristina Vladimirovna Nesterova=christ-nest@mail.ru
 Danijel Nestic=dnestic@eizg.hr
 Joanna Nestorowicz=jnestorowicz@wne.uw.edu.pl
 Anastasia Nesvetailova=a.nesvetailova@city.ac.uk
 Antonio M. D. Neto=aneto.phd@fep.up.pt
 Aleksei Netsunajev=aleksei.netsunajev@fu-berlin.de
 José Luis da Silva Netto Junior=juniorluis@yahoo.com
 Rangel Cerceau Netto=cerceaup@hotmail.com
 Martin Netuka=netuka@c-mail.cz
 Nick Netzer=nick.netzer@econ.uzh.ch
 Doris Neuberger=doris.neuberger@uni-rostock.de
 Matthias Neuenkirch=neuenkirch@uni-trier.de
 John L. Neufeld=john_neufeld@uncg.edu
 Michael Neugart=neugart@vwl.tu-darmstadt.de
 Karsten Neuhoff=kneuhoff@diw.de
 Dimitri Neumann=cddneumann@gmail.com
 Dirk Neumann=dneumann@iza.org
 Michael Neumann=m.neumann@qmul.ac.uk
 Rebecca Neumann=rneumann@uwm.edu
 Thomas Neumann=mail@thomasneumann.net
 Uwe Neumann=neumann@rwi-essen.de
 Shoshana Neuman=neumans@mail.biu.ac.il
 David Neumark=dneumark@uci.edu
 Eric Neumayer=e.neumayer@lse.ac.uk
 Florian Neumeier=florian.neumeier@wiwi.uni-marburg.de
 Klaus Neusser=klaus.neusser@vwi.unibe.ch
 Ilja Neustadt=i.neustadt@londonmet.ac.uk
 Joao Carvalho Neves=jcneves@iseg.utl.pt
 Myrian Beatriz Eiras Das Neves=myrian.neves@bcb.gov.br
 Pedro Duarte Neves=pneves@bportugal.pt
 Ricardo Neves=ricardolimaneves@gmail.com
 Rick Nevin=ricknevin@verizon.net
 David M Newbery=dmgn@econ.cam.ac.uk
 David Allen Newburn=dnewburn@arec.umd.edu
 Elisa Newby=elisa.newby@bof.fi
 Richard Newell=richard.newell@duke.edu
 Joseph Newhouse=joseph_newhouse@harvard.edu
 Carol Newman=cnewman@tcd.ie
 Roger Benedict Newson=r.newson@imperial.ac.uk
 Bilin Neyapti=neyapti@bilkent.edu.tr
 Mariya Neycheva=mneicheva@abv.bg
 Abraham Neyman=aneyman@math.huji.ac.il
 Levent Neyse=leventn@gmail.com
 Hekuran Neziri=hekuranneziri@gmail.com
 Tidiane Ngaido=tngaido@hotmail.com
 Liwa Rachel Ngai=l.ngai@lse.ac.uk
 Harold Ngalawa=hngalawa@yahoo.co.uk
 Stewart Ngandu=stewartngandu@yahoo.com
 Jean-Pascal N. Nganou=jnganou@worldbank.org
 Beoy Kui Ng=bkng@sc.edu.my
 Chen Feng Ng=chen.ng@csulb.edu
 David Ng=dtn4@cornell.edu
 Edward H K Ng=edwardhkng@dren.biz
 Guyslain K. Ngeleza=ngelezagk@mcc.gov
 Fabien Ngendakuriyo=ngendafab@yahoo.fr
 Rama Lionel NGENZEBUKE=ngenzeramajlionel@yahoo.fr
 Francis Ng=francis.ng2013@gmail.com
 Pham Quang Ngoc=pham@merit.unu.edu
 Serena Ng=serena.ng@columbia.edu
 Tim Ng=engeetee@gmail.com
 Travis Ng=travisng@cuhk.edu.hk
 Georges Nguefack-Tsague=nguefacktsague@yahoo.fr
 Serge Constant N'guessan Bi Zambe=djinan5@yahoo.fr
 Anh Ngoc Nguyen=anhnguyenlancaster@yahoo.com
 Cuong H. Nguyen=cn5@hw.ac.uk
 Nguyen Viet Cuong=c_nguyenviet@yahoo.com
 Nguyen Minh Duc=nmduc@hcmuaf.edu.vn
 Giap V. Nguyen=giap.nguyen@ttu.edu.vn
 Ha Nguyen=hanguyen@worldbank.org
 Ha M. Nguyen=nguyenhm@colorado.edu
 Hoa Nguyen=hoa.nguyen@deakin.edu.au
 Hoa Bao Nguyen=nguye147@msu.edu
 Hoa Thi Minh Nguyen=hoa.nguyen@anu.edu.au
 Hong Thang Nguyen=dr.thangnh@gmail.com
 Huong Giang (Lily) Nguyen=lily.nguyen@latrobe.edu.au
 Huu Thanh Tam Nguyen=nguyentam9483@gmail.com
 Nguyen Viet Khoi=khoivnu@gmail.com
 Dany Nguyen-Luong=dany.nguyen-luong@iaurif.org
 Manh-Hung Nguyen=mhnguyen@toulouse.inra.fr
 Minh Cong Nguyen=congminh6@gmail.com
 Nguyen Minh Ha=ngmiha@yahoo.com
 Nhat Duc Nguyen=nhat.nguyenduc@vietsurvey.vn
 Pascal Nguyen=pascal.nguyen@neoma-bs.fr
 Quang Duc Nguyen=quangn@hawaii.edu
 Sang Nguyen=snguyen32@juno.com
 Tam Thanh Nguyen=tamnt@mpi.gov.vn
 Nguyen Duc Thanh=ndt105@gmail.com
 Long Nguyen-Thanh=thanhlong@poczta.onet.pl
 Huyen Nguyen-Thi-Thanh=huyen.nguyen_thi_thanh@univ-lemans.fr
 Tho Nguyen=ndqtho@gmail.com
 Truong Duc Nguyen=u4715963@anu.edu.au
 Tu Anh Nguyen=tuanh14@yahoo.com
 Ty Nhu Nguyen=nhutynguyen@gmail.com
 Phu Nguyen-Van=nguyen-van@unistra.fr
 Nguyen Van San=ngvsan@yahoo.fr
 Viet Hoang Nguyen=vietn@unimelb.edu.au
 Yew-Kwang Ng=ykng@ntu.edu.sg
 Abdou-Aziz NIANG=abdou-aziz.niang@u-bourgogne.fr
 Moustapha Niang=moustapha.niang@gredeg.cnrs.fr
 Ides Nicaise=ides.nicaise@hiva.kuleuven.be
 Mihai Nica=mihainica@yahoo.com
 Panaite NICA=panaite.nica@gmail.com
 Alberto Niccoli=a.niccoli@univpm.it
 Dalila Nicet - Chenaf=bnicet@yahoo.com
 Bogdan Nichifor=bogdan.nichifor@ub.ro
 Mirela Elena Nichita=mirela.nichita@cig.ase.ro
 Lauren Hersch Nicholas=lnichola@jhsph.edu
 Michael D. Nicholson=mdnichol@ucsd.edu
 Stephen Nickell=steve.nickell@nuffield.ox.ac.uk
 David Nickerson=dnickerson@roosevelt.edu
 Sebastian Nick=sebastian.nick@ewi.uni-koeln.de
 Gaetan J.A. Nicodeme=ganicode@ulb.ac.be
 Catia Nicodemo=catia.nicodemo@upf.edu
 Mariana NICOLAE-BALAN=mariana_prognoza@yahoo.com
 Claudia Mihaela NICOLAU=clau_n2004@yahoo.com
 Juan L. Nicolau=jl.nicolau@ua.es
 Mihaela Nicolau=mihaela1.nicolau@yahoo.com
 Cheti Nicoletti=cheti.nicoletti@york.ac.uk
 Giuseppe Nicoletti=giuseppe.nicoletti@oecd.org
 Esteban A. Nicolini=esteban.nicolini@gmail.com
 Giovanna Nicolini=giovanna.nicolini@unimi.it
 Juan Pablo Nicolini=juanpa@utdt.edu
 Rosella Nicolini=rosella.nicolini@uab.cat
 Francesco Nicolli=francesco.nicolli@unife.it
 Antonio Nicolo'=antonio.nicolo@manchester.ac.uk
 Marco Nicolosi=nicolosi.energy@gmail.com
 Nicula=niculavirgil@yahoo.com
 Muriel Niederle=niederle@stanford.edu
 Frank Niehaus=frank.niehaus@pkv.de
 Huihua Nie=niehh@ruc.edu.cn
 Jun Nie=jun.nie@kc.frb.org
 Sebastian Nielen=nielen@wiwi.uni-wuppertal.de
 Bo Bernhard Nielsen=bn.smg@cbs.dk
 Caren Yinxia G. Nielsen=caren_yinxia.guo_nielsen@nek.lu.se
 Eric R. Nielsen=nielsen@uchicago.edu
 Helena Skyt Nielsen=hnielsen@econ.au.dk
 Max Nielsen=max@foi.dk
 Morten Ørregaard Nielsen=mon@econ.queensu.ca
 Robert B. Nielsen=rnielsen@uga.edu
 Søren Bo Nielsen=sbn.eco@cbs.dk
 Torben Heien Nielsen=thn@econ.ku.dk
 Ulf Nielsson=un.fi@cbs.dk
 Stefan Niemann=sniem@essex.ac.uk
 Jonas Niemeyer=jonas.niemeyer@riksbank.se
 Benjamin Chih-Chien Nien=f9361001@mail.dyu.edu.tw
 Dirk Niepelt=dirk.niepelt.work.subs@gmail.com
 Verena Niepel=wondratschek@zew.de
 Pu-yan NIE=pynie2002@hotmail.com
 Eva Niesten=e.m.m.i.niesten@uu.nl
 Sebastián Nieto-Parra=sebastian.nietoparra@oecd.org
 Mauricio Nieto Potes=mnieto1907@gmail.com
 Sandra Nieto=snieto@ub.edu
 Ricardo Nieva=rnievaperu@hotmail.com
 Annamaria Nifo=nifo@unisannio.it
 Sergey Nigai=nigai@kof.ethz.ch
 Valentina Nigro=valentina.nigro@bancaditalia.it
 Trino-Manuel Ñíguez=t.m.niguez@wmin.ac.uk
 Yuko Nikaido=nikaido@cc.musashi.ac.jp
 Nikos Nikiforakis=n.nikiforakis@gmail.com
 Marina Nikiforow=nikiforow@gif.uni-hannover.de
 Marc Nikitin=marc.nikitin@univ-orleans.fr
 Maxim Nikitin=mnikitin@hse.ru
 Yakov Yu. Nikitin=yanikit47@mail.ru
 Christina Nikitopoulos-Sklibosios=christina.nikitopoulos@uts.edu.au
 Susan Ziba Niknami=susan.niknami@sofi.su.se
 Vigen Nikogosian=vnikogosian@e-bridge.com
 Maria Nikolaidi=nikolmar@econ.uoa.gr
 Eftychia Nikolaidou=efi.nikolaidou@uct.ac.za
 Dimitrios Nikolaou=dnikola@ilstu.edu
 Milan Nikolic=milan@montenet.com
 Konstantinos Nikolopoulos=kostas@fortank.com
 Kalin Ognianov Nikolov=kalin.nikolov@ecb.int
 Zdenka Nikolovska=nikolovska@uacs.edu.mk
 Radoslawa Nikolowa=r.nikolowa@qmul.ac.uk
 Hassan Nikookar=hassan.nikoukar@gmail.com
 Hesam Nikopour=hessamnik@yahoo.com
 Farhad Nili=f.nili@cbi.ir
 Delia Nilles=delia.nilles@unil.ch
 Jeffrey H. Nilsen=nilseninsuisse@hotmail.com
 Øivind Anti Nilsen=oivind.nilsen@nhh.no
 Tore Nilssen=tore.nilssen@econ.uio.no
 Therese Nilsson=therese.nilsson@nek.lu.se
 Tomas Nilsson=tomas.nilsson@alumni.purdue.edu
 Kristoffer P. Nimark=knimark@crei.cat
 Alain-Désiré Nimubona=animubon@uwaterloo.ca
 Cathy Ning=qning@ryerson.ca
 Lutao Ning=l.ning@qmul.ac.uk
 Augusto Ninni=augusto.ninni@unipr.it
 Jorge Niño=jorge.nino@uai.cl
 Diana Patricia Niño-Muñoz=diana.nino@usa.edu.co
 Miguel Angel Niño-Zarazúa=miguel@wider.unu.edu
 Alejandro Nin Pratt=a.ninpratt@cgiar.org
 Jorge E. Niosi=niosi.jorge@uqam.ca
 Makoto Nirei=nirei@iir.hit-u.ac.jp
 Shawn Ni=nix@missouri.edu
 Keigo Nishida=knishida@fukuoka-u.ac.jp
 Mitsukuni Nishida=nishida@jhu.edu
 Katsumasa Nishide=knishide@ynu.ac.jp
 Hiroshi NISHI=nishi@hannan-u.ac.jp
 Kazuo Nishimura=nishimura@kier.kyoto-u.ac.jp
 Shuichiro Nishioka=shuichiro.nishioka@mail.wvu.edu
 Shuhei Nishitateno=shuhei0828@kwansei.ac.jp
 Masato Nishiwaki=mstnishi@gmail.com
 Hiroyuki Nishiyama=nisiyama@econ.u-hyogo.ac.jp
 Shinichi Nishiyama=shinichi.nishiyama@cbo.gov
 Robert F. Nishman=nishmaro@sdsx.moh.gov.on.ca
 Roberto Nisticò=roberto.nistico@unina.it
 Salvatore Nisticò=snistico@luiss.it
 Sergio Nisticò=s.nistico@unicas.it
 Costel Nistor=costel_nistor_fse@yahoo.com
 Puiu NISTOREANU=puiu.nistoreanu@com.ase.ro
 Volker Nitsch=nitsch@vwl.tu-darmstadt.de
 Jonathan Nitzan=nitzan@yorku.ca
 Shmuel Nitzan=nitzans@mail.biu.ac.il
 Lawrence Harvey Nitz=lnitz@hawaii.edu
 Linlin Niu=linlin.niu@gmail.com
 Yongzhi Niu=bdniu@budget.state.ny.us
 Satu Nivalainen=satu.nivalainen@gmail.com
 John Nixon=john.nixon15@btinternet.com
 Sebastian Nix=sebastian.nix@wzb.eu
 Yang Ni=niyang@sjtu.edu.cn
 Tanima Niyogi Sinha Roy=tanimansr@gmail.com
 Ephrem Niyongabo=ephremniyongabo@yahoo.fr
 Olena Y. Nizalova=nizalova@kse.org.ua
 Denys Nizalov=nizalov@kse.org.ua
 Joseph D. Njau=jdnjau@sph.emory.edu
 Angelica Espiritu Njuguna=asnm_njuguna@yahoo.com
 Guy Blaise Ngassam Nkamleu=b.nkamleu@afdb.org
 Anayo Dominic Nkamnebe=nkamnebe@yahoo.com
 Jean-Marie Nkongolo-Bakenda=bakenda@accesscomm.ca
 Ephraim Maduhu Nkonya=e.nkonya@cgiar.org
 Tharcisse NKUNZIMANA=tnkunzimana@yahoo.com
 Joëlle Noailly=noailly@cpb.nl
 Haitham Nobanee=haitham.nobanee@adu.ac.ae
 Bob Nobay=a.nobay@lse.ac.uk
 Andrea Nobili=andrea.nobili@bancaditalia.it
 Sandrine Noblet=noblet@univ-corse.fr
 Fabrizio Noboa=fnoboa@uio.satnet.net
 Antonella Nocco=antonella.nocco@unisalento.it
 Diego Nocetti=dnocetti@clarkson.edu
 Volker Nocke=nocke@uni-mannheim.de
 Akihiko Noda=noda@sanken.keio.ac.jp
 Gabriela Nodari=gabriela.nodari@univr.it
 Karl-Heinz Noehrbass=karl-heinz.noehrbass@bmf.bund.de
 Pierre Noel=globalenergypolicy@gmail.com
 Thomas H. Noe=thomas.noe@sbs.ox.ac.uk
 Ricardo Nogales=rnogales@upb.edu
 Gwenaëlle NOGATCHEWSKY=nogatchewsky@voila.fr
 Reginaldo Pinto Nogueira, Jr.=reginaldo.nogueira@ibmecmg.br
 Luiz Paulo Ferreira Nogueról=luiznoguerol@unb.br
 Pilar Nogues-Marco=mnogues@clio.uc3m.es
 Hiroatsu Nohara=hiroatsu.nohara@univ-amu.fr
 Anne Nolan=annolan@tcd.ie
 Brian Thomas Nolan=brian.nolan@ucd.ie
 Charles Nolan=charles.nolan@glasgow.ac.uk
 Marcus Noland=mnoland@petersoninstitute.org
 Robert Noland=rnoland@rutgers.edu
 James Francis Nolan=james.nolan@usask.ca
 Georg Nöldeke=georg.noeldeke@unibas.ch
 Patrick J. Nolen=pjnolen@essex.ac.uk
 Franklin Noll=nollhc@msn.com
 Roger G. Noll=rnoll@stanford.edu
 Ingmar Nolte=i.nolte@lancaster.ac.uk
 Sandra Nolte (Lechner)=s.nolte@lancaster.ac.uk
 Gustavo Nombela=gnombela@pdi.ucm.es
 Koji Nomura=nomura.koji@gmail.com
 Tomokazu NOMURA=nomura@econ.kobe-u.ac.jp
 Marielle Non=mariellenon@gmail.com
 Sakkarin Nonthapot=kikoyya@yahoo.co.th
 Farhad Noorbakhsh=f.noorbakhsh@lbss.gla.ac.uk
 Niels Noorderhaven=n.g.noorderhaven@uvt.nl
 Jawwad Noor=jnoor@bu.edu
 Junaid Ahmed Noor=noorjunaid@gmail.com
 Irfan Nooruddin=nooruddin.3@osu.edu
 Bart Nooteboom=bart.nooteboom@gmail.com
 Hugo Ñopo=hugon@iadb.org
 Pehr-Johan Norbäck=pehr-johan.norback@ifn.se
 Helge A. Nordahl=helgenordahl@gmail.com
 Katarina Nordblom=katarina.nordblom@economics.gu.se
 William D. Nordhaus=william.nordhaus@yale.edu
 Martin Nordin=martin.nordin@nek.lu.se
 Christophe J. Nordman=nordman@dial.prd.fr
 Mark Nord=marknord@ers.usda.gov
 Milagros Nores=milagros.nores@gmail.com
 Antonio E. Noriega=anoriega@banxico.org.mx
 Oyvind Norli=oyvind.norli@bi.no
 Michel Normandin=michel.normandin@hec.ca
 George Norman=george.norman@tufts.edu
 Neville R Norman=n.norman@unimelb.edu.au
 Hans-Theo Normann=normann@dice.uni-duesseldorf.de
 Peter Norman=normanp@email.unc.edu
 Richard Peter Norman=richard.norman@chere.uts.edu.au
 Mary Anne Normile=mnormile@ers.usda.gov
 Julia Cristina Caminha-Noronha=juliaccn@yahoo.com.br
 Stefan C. Norrbin=snorrbin@coss.fsu.edu
 Patricia E. Norris=norrisp@msu.edu
 John Randolph Norsworthy=randy@norsworthy.net
 Bailey Norwood=bailey.norwood@gmail.com
 Hiromi Nosaka=hnosaka@ipcku.kansai-u.ac.jp
 Yves Nosbusch=y.nosbusch@lse.ac.uk
 Florian Noseleit=f.noseleit@rug.nl
 Manabu Nose=mnose@imf.org
 Daniele Nosenzo=daniele.nosenzo@nottingham.ac.uk
 Linda Nøstbakken=linda.nostbakken@nhh.no
 Fungisai Nota=fungisai.nota@wartburg.edu
 Jorge Notaro=jnotaro@netgate.com.uy
 Alessandro Notarpietro=alessandro.notarpietro@bancaditalia.it
 Heryanto=dr_heryanto@yahoo.com
 Sergio Noto=elefante@univr.it
 Ourania Notta=ournotta@farm.teithe.gr
 Geranda Notten=gnotten@uottawa.ca
 Stefan Notz=stefan.notz@econ.uzh.ch
 Jorge Pablo Nougués=jorgepablonougues@hotmail.com
 Myriam Nourry=myriam_nourry@yahoo.fr
 Abdul G. Noury=agn2@nyu.edu
 Jiri Novak=novakji@fsv.cuni.cz
 Matjaž Novak=matjaz.novak@fm-kp.si
 Alfonso Novales=anovales@ccee.ucm.es
 Marco Novarese=novarese@jp.unipmn.it
 Edouard Novatorov, Sr.=enovatorov@hse.ru
 Filip Novotný=filip.novotny@cnb.cz
 Jan Novotny=jnovotny@cerge-ei.cz
 Josef Novotný=pepinov@centrum.cz
 Dennis Novy=d.novy@warwick.ac.uk
 Andrzej Nowak=a.nowak@wmie.uz.zgora.pl
 Sylwia Nowak=snowak@imf.org
 Witold Nowiński=witold.nowinski@gmail.com
 Klaus Nowotny=klaus.nowotny@sbg.ac.at
 Nelson Noya=nelsonn@cinve.org.uy
 Ilan Noy=noy@hawaii.edu
 Christian Nsiah=cnsiah@bw.edu
 Clarda Ange Nsouadi=clarda.nsouadi@lameta.univ-montp1.fr
 Collins G. Ntim=cgyakari@yahoo.com
 Mireille Ntsama Etoundi=ntsama@gmail.com
 Francesco Nucci=francesco.nucci@uniroma1.it
 Massimiliano Nuccio=massimiliano.nuccio@gmail.com
 Federico Nucera=fnucera@luiss.it
 Stephan Nuesch=stephan.nuesch@isu.uzh.ch
 Alcina Nunes=alcina@ipb.pt
 Celso Luís Pereira Nunes=clpnunes@uma.pt
 Francisco J. Nunes=fnunes@iseg.utl.pt
 Isabel L. Nunes=imn@fct.unl.pt
 Luis C. Nunes=lcnunes@fe.unl.pt
 Paulo A. L. D. Nunes=paulo.augusto.lourenco.nunes@gmail.com
 Paulo Macas Nunes=macas@ubi.pt
 Luis Felipe Vital Nunes Pereira=luis.fpereira@catolica.edu.br
 Sérgio Paulo Leal Nunes=spnunes@ipt.pt
 Sofia Nunes=sofiacgnnunes@gmail.com
 Juan Anibal Nuñez Carrasco=janunez@uma.es
 Núñez Romero-Balmas=gnromero@ugr.es
 Fernando Núñez Hernández=fnunezh@us.es
 Imanol Núñez=imanol.nunez@unavarra.es
 Laura Marta Nuñez Letamendia=laura.nunez@ie.edu
 Marina Núñez=mnunez@ub.edu
 Matias Nuñez=matias.nunez@u-cergy.fr
 Juan A. Nuñez-Serrano=juanandres.nunnez@uam.es
 Jose Javier Nuñez-Velazquez=josej.nunez@uah.es
 John M. Nunley=nunley.john@uwlax.edu
 Salvatore Nunnari=snunnari@columbia.edu
 Nathan Nunn=nnunn@fas.harvard.edu
 Galo Nuño Barrau=galonunobarrau@gmail.com
 Luca Nunziata=luca.nunziata@unipd.it
 Oskar Nupia=onupia@uniandes.edu.co
 Julinda Nuri=j.nuri@surrey.ac.uk
 Sanna Nurmikko=s.p.nurmikko@soton.ac.uk
 Elif Nuroğlu=nuroglu@tau.edu.tr
 Eva Nurwita=eva.nurwita@fe.unpad.ac.id
 Nunung Nuryartono=nuryartono@yahoo.com
 Florian Marcel Nuta=floriann@univ-danubius.ro
 John Nuttall=jnuttall@uwo.ca
 William James Nuttall=william.nuttall@open.ac.uk
 Alessandro Nuvolari=alessandro.nuvolari@sssup.it
 Ifeanyi Ndubuto Nwachukwu=ifnwachukwu@yahoo.com
 Uche Macjulius Nwankwo=focusmacj@yahoo.com
 PROF Godwin Chukwudum Nwaobi=gcnwaobi@quanterb.org
 Mathew N. Nyamwange=mnyamwange@gmail.com
 Peter Mikael Nyberg=peter.nyberg@hse.fi
 Sten Nyberg=sten.nyberg@ne.su.se
 Martin Nybom=martin.nybom@sofi.su.se
 Karine Nyborg=karine.nyborg@econ.uio.no
 Kjell G. Nyborg=kjell.nyborg@bf.uzh.ch
 Arne Nygaard=arne.nygaard@mh.no
 Ole Henning Nyhus=ole.nyhus@sof.ntnu.no
 Oleksii Kostiantynovych Nykytenko=richok@ua.fm
 Ingmar Nyman=ingmar.nyman@hunter.cuny.edu
 John Nyman=nyman001@umn.edu
 Soren Nymark=srnymark@hotmail.com
 Ragnar Nymoen=ragnar.nymoen@econ.uio.no
