 Ana Xavier=ana.xavier@ec.europa.eu
 Anastasios Xepapadeas=xepapad@aueb.gr
 Chong Xiang=cxiang@purdue.edu
 Jun Xiang=junxiang@rutgers.edu
 Tao Xiang=txiang@mail.neu.edu.cn
 Erte Xiao=exiao@andrew.cmu.edu
 Jingliang Xiao=charles.jl.xiao@gmail.com
 Junji Xiao=junjixiao@fudan.edu.cn
 Zhao Xiaojun=zhaoxiaojun@pku.edu.cn
 Qin Xiao=cqxiao06@yahoo.com.sg
 Wei Xiao=wxiao@binghamton.edu
 Yu Xiao=xiaoyu@plan.cv.titech.ac.jp
 Zhiguo Xiao=zhiguo_xiao@fudan.edu.cn
 夏庆杰 (Qingjie Xia)=qingjie.xia@pku.edu.cn
 Irene Xiarchos=imxiarchos@gmail.com
 Daniel Danxia Xie [谢丹夏] (Daniel Danxia Xie)=dxie@uchicago.edu
 Huan Xie=huanxie@alcor.concordia.ca
 Li Xie=li.xie@dur.ac.uk
 Xin Xie=xxie3000@163.com
 Yu Xie=yuxie@umich.edu
 Yuanyuan Xie=yx518@york.ac.uk
 Ramon Xifré=ramon.xifre@esci.upf.edu
 Domingo Pérez Ximénez-de-Embún=dpxe@unizar.es
 Baogui Xin=xin@tju.edu.cn
 Chunbing Xing=xingchb@hotmail.com
 Weibo Xing=xingweibo@gmail.com
 Xian Xin=xinxian@cau.edu.cn
 Bo Xiong=boxiong@ucdavis.edu
 Siyang Xiong=xiong.econ@gmail.com
 Wei Xiong=wxiong@princeton.edu
 Dacheng Xiu=dacheng.xiu@chicagobooth.edu
 Bing Xu=b.xu@hw.ac.uk
 Jianpo XUE=jpxue@ruc.edu.cn
 Licun Xue=licun.xue@mcgill.ca
 Fang Xu=fang.xu@reading.ac.uk
 Guo Xu=g.xu2@lse.ac.uk
 Haiqing Xu=h.xu@austin.utexas.edu
 Hangtian Xu=hangtianxu@gmail.com
 Jianwei Xu=xujianwei@gmail.com
 Juanyi Xu=jennyxu@ust.hk
 Ke-Li Xu=keli.xu@econmail.tamu.edu
 Kuan Xu=kuan.xu@dal.ca
 Lihe Xu=xuleehe@gmail.com
 Lixin Colin Xu=lixin.colin.xu@gmail.com
 Mingxin Xu=mxu2@uncc.edu
 Wei Xu=wxu@scor.com
 Xinpeng Xu=afxxu@polyu.edu.hk
 Xinzhong Xu=xuxz@gsm.pku.edu.cn
 Daniel Yi Xu=daniel.xu@duke.edu
 Yongdeng Xu=xuyongdeng@hotmail.com
 Yongsheng Xu=yxu3@gsu.edu
 Zhenhui Xu=zhenhui.xu@gcsu.edu
 Zhiwei Xu=xuzhiwei09@gmail.com
 Zhiying Xu=xuzhiyin@msu.edu
 Tomoyoshi Yabu=tyabu@fbc.keio.ac.jp
 Mohd Rusli Yacob=mrusli@env.upm.edu.my
 Enrique Yacuzzi=ey@cema.edu.ar
 Danny Yagan=yagan@fas.harvard.edu
 Takeshi Yagihashi=tyagihas@odu.edu
 Milton Yago=m.yago@leedsmet.ac.uk
 Yue Yaguchi=yyaguchi@ner.takushoku-u.ac.jp
 Abdelkarim YAHYAOUI=yahyaoui.abdelkarim@voila.fr
 Yossi Yakhin=yossi.yakhin@boi.org.il
 Yorbol Yakhshilikov=yerboly@gmail.com
 Akira Yakita=yakita@econ.nagoya-cu.ac.jp
 Andrei A. Yakovlev=y_andrei@mail.ru
 Pavel A. Yakovlev=pyakov01@gmail.com
 Abdullah YALAMA=abdullah.yalama@gmail.com
 Todor Yalamov=todor.yalamov@online.bg
 Cihan YALCIN=cihan.yalcin@tcmb.gov.tr
 Yeliz Yalcin=yyeliz@gazi.edu.tr
 Altuğ Yalçıntaş=altug.yalcintas@politics.ankara.edu.tr
 Alem Hagos Yallwe,=alemhagos20032002@yahoo.com
 Gaston Isaias Yalonetzky=g.yalonetzky@leeds.ac.uk
 A. Talha Yalta=yalta@etu.edu.tr
 Gustavo Yamada=yamada_ga@up.edu.pe
 Katsunori Yamada=kyamada@kindai.ac.jp
 Takeshi Yamada=takeshiyamada@cal.berkeley.edu
 Tomoaki Yamada=tyamada@meiji.ac.jp
 Hisaki Yamaga=yamaga@kwansei.ac.jp
 Tatsufumi Yamagata=tatsufumi_yamagata@ide.go.jp
 Katsuhiro Yamaguchi=yamaguchi@pp.u-tokyo.ac.jp
 Isamu Yamamoto=yamamoto@fbc.keio.ac.jp
 Kazuhiro Yamamoto=yamamoto@econ.osaka-u.ac.jp
 Ryuichi Yamamoto=ryuichi@nccu.edu.tw
 Shugo Yamamoto=shugo-y@yamaguchi-u.ac.jp
 Yohei Yamamoto=yohei.yamamoto@econ.hit-u.ac.jp
 Yuki Yamamoto=yamayuki@hiroshima-u.ac.jp
 Norihiko Yamano=yamano.norihiko@gmail.com
 Takashi Yamano=t.yamano@irri.org
 Steven Yamarik=steve.yamarik@csulb.edu
 Nobu Yamashita=n.yamashita@latrobe.edu.au
 Futoshi Yamauchi=fyamauchi@worldbank.org
 Satoshi Yamazaki=satoshi.yamazaki@utas.edu.au
 Nobuyoshi Yamori=yamori@rieb.kobe-u.ac.jp
 David Yanagizawa-Drott=david_yanagizawa-drott@harvard.edu
 Akihiko Yanase=yanase@intcul.tohoku.ac.jp
 Beiling Yan=beiling.yan@statcan.gc.ca
 Magomet Yandiev=mag2097@mail.ru
 Eric Yan=fulgent945@hotmail.com
 Cesar Yañez=cesar.yanez@ub.edu
 Guillermo José Yanez=contacto@guillermo.cl
 Monica Yanez Pagans=myanezpagans@worldbank.org
 Patricia Yanez-Pagans=yanezpagans@wisc.edu
 Alan X. Yang=alan.yang@ca.ibm.com
 Bo Yang=bo.yang@surrey.ac.uk
 Chengyu Yang=cyang@bnu.edu.cn
 Dean Yang=deanyang@umich.edu
 Donghoon Yang=dhyang@sogang.ac.kr
 Doo Yong Yang=yangdy@khu.ac.kr
 Fang Yang=fyang@albany.edu
 Hongliang Yang=h.yang.03@cantab.net
 Hongqiang Yang=yhqnfu@gmail.com
 Huanxing Yang=yang.1041@osu.edu
 Jian Yang=jian.yang@ucdenver.edu
 Jianxia Yang=goabroadxia@163.com
 Jiawen Yang=jwyang@gwu.edu
 Jing Yang=jing.yang@bis.org
 Jingjing Yang=jingjingy@unr.edu
 Joon-Mo Yang=yangjm@yonsei.ac.kr
 Juan Yang=yangjuan@bnu.edu.cn
 Jui-Chung Yang=jcyang1225@gmail.com
 Li Yang=l.yang@unsw.edu.au
 Lijian Yang=yanglijian@suda.edu.cn
 Lu Yang=kudeyang@gmail.com
 Lucun Yang=lucun_yang@hotmail.co.uk
 Michael Shuo Yang=michael.yang@frontier-economics.com
 Nathan Yang=nathan.yang@yale.edu
 Philip Yang=yang@aoek.uni-hannover.de
 Qing Gong Yang=qinggong.yang@gmail.com
 Seung-Ryong Yang=sryang@korea.ac.kr
 Sheng-Yung Yang=shengyang@nchu.edu.tw
 Shu-Chun S. Yang=syang@imf.org
 Xuewei YANG=xwyang@nju.edu.cn
 Yibai Yang=yibai.yang@hotmail.com
 Yi-Nung Yang=yinung.cycu@gmail.com
 Yi-You Yang=yyyang@mail.au.edu.tw
 Yong Yang=yong.yang@sussex.ac.uk
 Yongheng Yang=yhyang@tsinghua.edu.cn
 Yongzhong Yang=yangyongzhong116@163.com
 Zhenlin Yang=zlyang@smu.edu.sg
 Zhenzeng Yang=yang8898@gmail.com
 Ho-don Yan=hdyan@fcu.edu.tw
 Hong Yan=yanh@moore.sc.edu
 Halit Yanıkkaya=halityanikkaya@yahoo.com
 Ji Yan=yanj@appstate.edu
 Jia Yan=jiay@wsu.edu
 Kit Ming Isabel Yan=efyan@cityu.edu.hk
 Vladimir Yankov=vladimir.l.yankov@frb.gov
 Li Yan=li.yan@uqo.ca
 Elena Yanovskaya=eyanov@emi.nw.ru
 Se Yan=seyan@gsm.pku.edu.cn
 Shu Yan=syan@moore.sc.edu
 Zheng Yan=zhengyan@xmcu.cn
 Zhipeng Yan=zyan@njit.edu
 Fang Yao=fang.yao@rbnz.govt.nz
 Jean-Marie K. YAO=jean-marie.yao@ensae.org
 Richard Tolentino Yao=richard.yao@scionresearch.com
 Song Yao=s-yao@kellogg.northwestern.edu
 Wen Yao=yaow@sem.tsinghua.edu.cn
 Wenying Yao=wenying.yao@utas.edu.au
 Zhiyong Yao=yzy@fudan.edu.cn
 Amir Yaron=yaron@wharton.upenn.edu
 Yavuz Yasar=yyasar@du.edu
 Eran Yashiv=yashiv@post.tau.ac.il
 Evgeny G. Yasin=yassin@hse.ru
 Gordey Yastrebov=g.yastrebov@hse.ru
 Yosuke Yasuda=yosuke.yasuda@gmail.com
 Mariko Yasugi=yasugi@cc.kyoto-su.ac.jp
 Kengo Yasui=yasui@fc.ritsumei.ac.jp
 Masaya Yasuoka=yasuoka@kwansei.ac.jp
 Adonis Yatchew=yatchew@chass.utoronto.ca
 Anthony Yates=tony.yates@bristol.ac.uk
 Yuri Yatsenko=yyatsenko@hbu.edu
 Abdullah Yavas=ayavas@bus.wisc.edu
 Hilmi Erdogan Yayla=h_yayla@hotmail.com
 Münür Yayla=myayla@bddk.org.tr
 Myra Yazbeck=m.yazbeck@uq.edu.au
 Ege Yazgan=eyazgan@bilgi.edu.tr
 Hakki Yazici=hakkiyazici@sabanciuniv.edu
 Mehmet YAZICI=myazici@cankaya.edu.tr
 Bing YE=colinyebing@126.com
 Au Shion Yee=shion.yee@gmail.com
 Kenton K. Yee=kenton@alum.mit.edu
 Chun-Hsien Yeh=chyeh@econ.sinica.edu.tw
 Sonia Yeh=slyeh@ucdavis.edu
 Erinc Yeldan=yeldane@bilkent.edu.tr
 Lixin Ye=ye.45@osu.edu
 Clement Yelou=clement.yelou@statcan.gc.ca
 Aaron Yelowitz=aaron@uky.edu
 Maoliang Ye=maoliang_ye@ksgphd.harvard.edu
 Ruslan G. Yemtsov=ryemtsov@worldbank.org
 Duygu Yengin=duygu.yengin@adelaide.edu.au
 Onur Yeni=onur.yeni08@gmail.com
 Melissa M. Yeoh=myeoh@berry.edu
 TEY (John) Yeong-Sheng=tyeong.sheng@gmail.com
 David Larry Yermack=dyermack@stern.nyu.edu
 Filiz Yesilyurt=afiliz@pau.edu.tr
 Muhammet Ensar Yesilyurt=meyyurt@pau.edu.tr
 Pınar Ayşe Yeşin=pinar.yesin@snb.ch
 Mustafa Yeter=yeter@zew.de
 I. H. Yetkiner=hakan.yetkiner@ieu.edu.tr
 James Yetman=james.yetman@bis.org
 Danny Yeung=danny.yeung-1@uts.edu.au
 Siew Ling Yew=siew.ling.yew@monash.edu
 Xiaoxia Ye=wisesummer@gmail.com
 Anthony Marvin Yezer=yezer@gwu.edu
 Jolanda Eline Ygosse Battisti=jolanda.ygosse.battisti@fgv.br
 Dr. Vasoontara Yiengprugsawan=vasoontara.yieng@anu.edu.au
 Taner Yigit=tyigit@bilkent.edu.tr
 Jianxin Yi=yijx@scnu.edu.cn
 易君健 (Junjian Yi)=junjian@uchicago.edu
 Veli Yilanci=veliyilanci@gmail.com
 Okan Yilankaya=oyilankaya@ku.edu.tr
 Levent Yildiran=levent.yildiran@boun.edu.tr
 Semih Yildirim=yildirim@yorku.ca
 Julide Yildirim=jyildir@hotmail.com
 Nuri YILDIRIM=nuri.yildirim@izmir.edu.tr
 Halis Murat Yildiz=hyildiz@ryerson.ca
 Muhamet Yildiz=myildiz@mit.edu
 Murat Yildizoglu=yildi@u-bordeaux4.fr
 Özgür Yildiz=o.yildiz@mailbox.tu-berlin.de
 Cengiz Yilmaz=cengiz.yilmaz@boun.edu.tr
 Tansel Yilmazer=yilmazer.2@osu.edu
 Kamil Yilmaz=kyilmaz@ku.edu.tr
 Sakir Devrim Yilmaz=sakir.yilmaz@manchester.ac.uk
 Fengbao Yin=hemuxiao@hotmail.com
 John S. Ying=jying@udel.edu
 Olalekan Dauda Yinusa=yinusaolalekan@yahoo.com
 Xiaopeng Yin=xyin@uibe.edu.cn
 Yong Yin=yyin@buffalo.edu
 Yuliang Yin=imyyl@163.com
 Funda Yirmibesoglu=funday@itu.edu.tr
 Sang-Seung Yi=ssyi@snu.ac.kr
 Shlomo Yitzhaki=shlomo.yitzhaki@huji.ac.il
 Ertugrul Yıldırım=ertugruly@beun.edu.tr
 Gökhan Yılmaz=gokhan.yilmaz@tcmb.gov.tr
 Özgür Yılmaz=ozyilmaz@ku.edu.tr
 Jonathan Keith Yoder=yoder@wsu.edu
 THIERRY Urbain YOGO=yogout@gmail.com
 Emre Yoldas=emre.yoldas@frb.gov
 Alexis Yong=yong_as@up.edu.pe
 Byoung Hark Yoo=harkyoo@ssu.ac.kr
 Hong Il Yoo=h.i.yoo@durham.ac.uk
 Kwang-Yeol Yoo=jaesuyoo@naver.com
 Joanne Kannan Yoong=jyoong@rand.org
 Jae-Ho Yoon=jhyoon@posri.re.kr
 Kiho Yoon=kiho@korea.ac.kr
 Kyung Hwan Yoon=k.yoon@uws.edu.au
 Young-Ro Yoon=yoonyr@wayne.edu
 Seung Han Yoo=shyoo@korea.ac.kr
 Vilimir Yordanov=research@vjord.com
 Barış K. Yörük=byoruk@albany.edu
 Mehmet Yorukoglu=mehmet.yorukoglu@tcmb.gov.tr
 Tanju Yorulmazer=tanju.yorulmazer@ny.frb.org
 Jiro Yoshida=jiro@psu.edu
 Yuichiro Yoshida=yuichiro@hiroshima-u.ac.jp
 Yushi Yoshida=yushi.yoshida@biwako.shiga-u.ac.jp
 Naoki Yoshihara=yosihara@ier.hit-u.ac.jp
 Joe Akira Yoshino=joeyoshino@gmail.com
 Yutaka Yoshino=yyoshino@worldbank.org
 Jing You=jing.you@ruc.edu.cn
 Javed Younas=jyounas@aus.edu
 Zahid Irshad Younas=zahid1132_gcu@yahoo.com
 Andrew Thomas Young=andrew.young@mail.wvu.edu
 Chester Edwin Young, Jr.=ceyoung@ers.usda.gov
 Eric R. Young=ey2d@virginia.edu
 Stephen D. Younger=sdy1@cornell.edu
 Garry Young=garry.young@bankofengland.co.uk
 H. Peyton Young=peyton.young@economics.ox.ac.uk
 Michael Young=mike.young@adelaide.edu.au
 Michael S. Young=mikero1@mac.com
 Robert A. Young=young@uwo.ca
 Abdul Majid Yousfani=yousfani64@yahoo.com
 Ouidad Yousfi=ouidad.yousfi@univ-montp2.fr
 Mohd Hassan Youssef=mohd_youssef@aucegypt.edu
 Ahmed Sadek Yousuf=ahmed.sadek87@gmail.com
 Wen You=wenyou@vt.edu
 Gerard Ypma=gerardypma@hotmail.com
 Huiping Yuan=hpyuan@xmu.edu.cn
 Mingwei Yuan=mingwei.yuan@ge.com
 Yan YUAN=yanyuan.tamu@gmail.com
 Yu Yuan=yyuan@saif.sjtu.edu.cn
 Yufei Yuan=yyuanwise@gmail.com
 Bingxin Yu=b.yu@cgiar.org
 Mustafa Eray Yucel=eray.yucel@gmail.com
 Fatih YÜCEL=fatihyucel@nigde.edu.tr
 Hüseyin Mualla Yüceol=hyuceol@hotmail.com
 Michio Yuda=yudamich@mecl.chukyo-u.ac.jp
 Donsyah Yudistira=donsyah@hotmail.com
 Heng Yue=yueheng@gsm.pku.edu.cn
 Eric Jinsan Yu=ericjinsan.yu@queensu.ca
 Yang Yue=shananyueyang@gmail.com
 Ge YU=hssgy@leeds.ac.uk
 Hai-Chin Yu=haichin@cycu.edu.tw
 Jeff Jiewei Yu=jieweiyu@cox.smu.edu
 Jian Yu=yujianjh@gmail.com
 Jianyu YU=yujianyu@swufe.edu.cn
 Jihai Yu=jihai.yu@gmail.com
 Jun Yu=yujun@smu.edu.sg
 Jung-Suk Yu=jungsuk.yu@gmail.com
 Kam Yu=kam.yu@lakeheadu.ca
 Kazuhiro Yuki=yuki@econ.kyoto-u.ac.jp
 Canan Yuksel=canan.yuksel@tcmb.gov.tr
 Lean Yu=yulean@amss.ac.cn
 Li Yu=yuli.cufe@gmail.com
 Linhui Yu=leon.yulh@gmail.com
 Miaojie Yu=mjyu@ccer.edu.cn
 Min-Teh Yu=mtyu@pu.edu.tw
 Hayong Yun=hy2003@columbia.edu
 Kwan Koo Yun=yun@albany.edu
 Myeong-Su Yun=msyun@tulane.edu
 Sungho Yun=uwyunsh@hanyang.ac.kr
 Tack Yun=tackyun@snu.ac.kr
 Philip L.H. Yu=plhyu@hkucc.hku.hk
 Anna V. Yurko=ayurko@hse.ru
 Emel Yurt=yurt@yildiz.edu.tr
 B. Burcin Yurtoglu=burcin.yurtoglu@whu.edu
 Run Yu=run@hawaii.edu
 Shu Yu=s.yu@rug.nl
 Zulkornain B. Yusop=zulkornain@putra.upm.edu.my
 Arief Anshory Yusuf=arief.yusuf@fe.unpad.ac.id
 Sulaimon Aremu Yusuf=yusufsulaimonaremu@gmail.com
 于同奎 (Tongkui Yu)=yutongkui@yahoo.com.cn
 Wei-Choun Yu=wyu@winona.edu
 Wusheng Yu=wusheng@foi.dk
 Xiaohua Yu=xyu@gwdg.de
 Yan Yu=yanyu@ust.hk
 Yihua Yu=yihua.yu@ruc.edu.cn
 Zhihao Yu=zhihao_yu@carleton.ca
 Zhihong Yu=zhihong.yu@nottingham.ac.uk
 Anne Yvrande-Billon=yvrande@univ-paris1.fr
 Aiora Zabala=aiora.zabala@gmail.com
 Jon Mikel Zabala Iturriagagoitia=jmzabala@deusto.es
 Antoni Zabalza=antonio.zabalza@uv.es
 Oxana Zabelina=ovzabelina@sfedu.ru
 Jeffrey Zabel=jeff.zabel@tufts.edu
 Edgardo Zablotsky=eez@cema.edu.ar
 Alexandra Karin Zaby=alexandra.zaby@uni-tuebingen.de
 Giulia Zacchia=giulia.zacchia@gmail.com
 Marios Zachariadis=zachariadis@ucy.ac.cy
 Eleftherios Zacharias=ezachar@aueb.gr
 Magdalena Zachłod-Jelec=magdalena.zachlod@gmail.com
 Georg Zachmann=gzachmann@gmail.com
 Anatolii Olexandrovich Zadoia=zadoya@duep.edu
 Jorge Enrique Zafrilla=jorge.zafrilla@uclm.es
 Andrea Zaghini=zaghini@yahoo.com
 Martin Zagler=martin.zagler+repec@gmail.com
 Branislav Zagoršek=bzagorsek@gmail.com
 Jay L. Zagorsky=zagorsky.1@osu.edu
 Razvan ZAHARIA=razvan.zaharia@gmail.com
 Rodica Milena Zaharia=milena_zaharia@yahoo.com
 Mor Zahavi=mor.zahavi@gmail.com
 Fadi Zaher=zaherfadi@hotmail.com
 Andres Zahler=andres.zahler@udp.cl
 Steven Zahniser=zahniser@ers.usda.gov
 Valentin Zahrnt=vzahrnt@hotmail.com
 Stanislav Alexandrovich Zaichenko=szaichenko@hse.ru
 Asghar Zaidi=zaidi@euro.centre.org
 Rida Zaidi=ridazaidi@gmail.com
 Adriana Zait=azait@uaic.ro
 Luminita Zait=zait.luminita@yahoo.com
 Tristan Zajonc=tristan_zajonc@hksphd.harvard.edu
 Intan Zanariah Zakaria=intan@iium.edu.my
 Roman Zakharenko=r.zakharenko@gmail.com
 Victor Zakharov, Sr.=mcvictor@mail.ru
 Chahir Zaki=chahir.zaki@feps.edu.eg
 Nadia Zakir=nadiazakir.pide@gmail.com
 Rezida Zakirova=r.zakirova@gmail.com
 Jean-Michel Zakoian=zakoian@ensae.fr
 Paul J. Zak=paul@pauljzak.com
 Egon Zakrajsek=egon.zakrajsek@frb.gov
 Yogendrasinh Chhatrasinh Zala=yczala@yahoo.co.in
 Jovan Zamac=jovan.zamac@nek.uu.se
 Asad Zaman=asadzaman@alum.mit.edu
 Constantin Zaman=czaman@noos.fr
 Gheorghe Zaman=gheorghezaman@ien.ro
 Md Monowaruz Zaman=monowar01@yahoo.com
 Dr. Noor Zaman=nzaman@kfu.edu.sa
 Stefano Zambelli=stefano.zambelli@unitn.it
 Andres Zambrano=azambrano@ucla.edu
 Joshua David Zambrano=jzyehoshua1@yahoo.com
 Patricia Zambrano=p.zambrano@cgiar.org
 Giovanni M Zambruno=giovanni.zambruno@unimib.it
 J. Zambujal-Oliveira=j.zambujal.oliveira@ist.utl.pt
 Shmuel Zamir=shmuelzamir@gmail.com
 Oleg Zamkov=ozamkov@hse.ru
 Bernarda Zamora=bernardazamora@gmail.com
 Luca Zamparelli=luca.zamparelli@uniroma1.it
 Vasiliki Zampeta=vicky.zampeta@gmail.com
 Fabrizio Zampolli=fabrizio.zampolli@bis.org
 Skerdilajda Zanaj=skerdilajda.zanaj@uni.lu
 Maurizio Zanardi=m.zanardi@lancaster.ac.uk
 Luca Zanderighi=luca.zanderighi@unimi.it
 Fernando Zanella=f.zanella@uaeu.ac.ae
 Giulio Zanella=giulio.zanella@unibo.it
 Emilio Zanetti Chini=emilio.zanetti.chini@uniroma2.it
 Francesco Zanetti=francesco.zanetti@economics.ox.ac.uk
 Antonello Zanfei=antonello.zanfei@uniurb.it
 Ernesto Zangari=ernesto.zangari@ec.europa.eu
 Alexandros Zangelidis=a.zangelidis@abdn.ac.uk
 Hamid Zangeneh=hzangeneh@mail.widener.edu
 Paolo Zanghieri=paolo.zanghieri@gmail.com
 Israel Zang=israelza@mta.ac.il
 Adelino Zanini=a.zanini@univpm.it
 Nadir Zanini=zanini.n@cambridgeassessment.org.uk
 Luca Zanin=luca.zanin@studio.unibo.it
 Christian Zankiewicz=czankiewicz@diw.de
 Raffaele Zanoli=zanoli@agrecon.univpm.it
 Francesca Zantomio=francesca.zantomio@unive.it
 Nejia Zaouali=nejia.zaouali@eco.u-cergy.fr
 Jan Zapal=j.zapal@gmail.com
 Vera Zaporozhets=vzaporoz@toulouse.inra.fr
 Carlo Zappia=zappia@unisi.it
 Cristina A. Zarate=cristinazarate18@hotmail.com
 Anabel Zárate-Marco=azarate@unizar.es
 Roman Andres Zarate=ra.zarate22@uniandes.edu.co
 Jesús M. Zaratiegui=jmzarati@unav.es
 Carlos E. J. M. Zarazaga=carlos.zarazaga@dal.frb.org
 Adam M. Zaretsky=zaretsky@stls.frb.org
 Michael Zarichnyi=mzar@litech.lviv.ua
 Anna Zarkada-Fraser=azarkada@aueb.gr
 Odi Mihaela Zarnescu, Sr.=odimihaela@yahoo.com
 Jay Zarnikau=jayz@mail.utexas.edu
 Grigoris Zarotiadis=gzarotia@econ.auth.gr
 Sotirios Zartaloudis=s.zartaloudis@lse.ac.uk
 Rebecca Zarutskie=rebecca.zarutskie@frb.gov
 José Manuel Zarzuelo=josemanuel.zarzuelo@ehu.es
 Liudmila Zasimova=lzasimova@hse.ru
 Anna Zasova=anna@biceps.org
 Klaus G. Zauner=klaus.zauner@city.ac.uk
 Veronika Zavacka=veronika.zavacka@graduateinstitute.ch
 Tibor Zavadil=tibor.zavadil@nbs.sk
 Madeline Zavodny=mzavodny@agnesscott.edu
 Alice Zawacki=alice.m.zawacki@census.gov
 Marcin Zawada=zawada@zim.pcz.pl
 Aldona Zawojska=aldona_zawojska@sggw.pl
 Jeffrey Zax=zax@colorado.edu
 Alexander Andreevich Zaytsev=zaytsev@mse-msu.ru
 Alberto Zazzaro=a.zazzaro@univpm.it
 Alexandra Zbuchea=alexandra.zbuchea@facultateademanagement.ro
 Aleksandra ZDZIENICKA=azdzienicka@imf.org
 David Zeballos=dzeballos@bcb.gob.bo
 Richard Zeckhauser=richard_zeckhauser@harvard.edu
 Luis Felipe Zegarra=lfzegarrab@pucp.edu.pe
 Sylvain Henri Zeghni=sylvain.zeghni@u-pem.fr
 Christian Zehnder=christian.zehnder@unil.ch
 Rodrigo Mariath Zeidan=rodrigo.zeidan@fdc.org.br
 Achim Zeileis=achim.zeileis@r-project.org
 Joseph Zeira=mszeira@mscc.huji.ac.il
 Stephen Zeldes=spz1@columbia.edu
 Tomáš Želinský=tomas.zelinsky@tuke.sk
 Manfred Zeller=manfred.zeller@uni-hohenheim.de
 Roberto Zelli=roberto.zelli@uniroma1.it
 Holger Zemanek=zemanek@wifa.uni-leipzig.de
 Petr Zemcik=petr.zemcik@cerge-ei.cz
 Michaël ZEMMOUR=michael.zemmour@univ-lille1.fr
 Alena Zemplinerova=alena.zemplinerova@cerge-ei.cz
 Stepan Zemtsov=spzemtsov@gmail.com
 Chenhang Zeng=cz_sdu@163.com
 Dao-Zhi Zeng=zeng@se.is.tohoku.ac.jp
 Todd Zenger=zenger@wustl.edu
 Ünal Zenginobuz=zenginob@boun.edu.tr
 Jinli Zeng=ecszjl@nus.edu.sg
 Ning Zeng=tningzeng@jnu.edu.cn
 Songlin Zeng=songlin.zeng@essec.edu
 Tian Zeng=zeng_tian@yahoo.com
 Zhixiong Zeng=zhixiong.zeng@monash.edu
 Stavros A. Zenios=zenios.stavros@ucy.ac.cy
 Christina Zenker=christina.zenker@zu.ac.ae
 Nikolay A. Zenkevich=zenkevich@gsom.pu.ru
 Yves Zenou=yves.zenou@ne.su.se
 Andreas Zenthöfer=a.f.zenthofer@uvt.nl
 Eduardo Zepeda=ezm.unes@gmail.com
 Paolo Zeppini=p.zeppini@uva.nl
 Dainis Zeps=dainize@mii.lu.lv
 Adama ZERBO=adamazerbo@yahoo.fr
 Dawit Zerom=dzerom@fullerton.edu
 Mariana Zerpa=mzerpa@iecon.ccee.edu.uy
 Panagiotis Dimitrios Zervopoulos=pzervopoulos@hotmail.com
 Anastasia Zervou=azervou@econmail.tamu.edu
 Muhammad Zeshan=muh.zeshan@gmail.com
 Pavel Zetek=zetekpavel@centrum.cz
 David Zetland=dzetland@gmail.com
 Jeromin Zettelmeyer=jzettelmeyer@gmail.com
 Stefan Zeugner=stefan.zeugner@ec.europa.eu
 Mauricio Zevallos=amadeus@ime.unicamp.br
 Tugba Zeydanli=tzeydanli@gmail.com
 Ayaz Zeynalov=azerayaz@gmail.com
 Irem Zeyneloglu=izeyneloglu@gsu.edu.tr
 Alberto Zezza=azezza@worldbank.org
 Xiaozhong Zhai=xiaozhongzhai@webspeed.dk
 Bing Zhang=zhangb@nju.edu.cn
 Bohui Zhang=bohui.zhang@unsw.edu.au
 Boyang Zhang=bz95@cornell.edu
 Cathy M. Zhang=cmzhang@purdue.edu
 Chengsi Zhang=zhangcs@ruc.edu.cn
 Chuanchuan Zhang=ccz.zhang@gmail.com
 Dandan Zhang=ddzhang@nsd.edu.cn
 Donghang Zhang=zhang@moore.sc.edu
 Haiping Zhang=hpzhang@smu.edu.sg
 Hanzhe Zhang=hanzhe@uchicago.edu
 Haoyu Zhang=haoyu.zhang@sydney.edu.au
 Zhang Hongru=zhanghongru@hotmail.co.uk
 Jian Zhang=jian32@gmail.com
 Jiangfeng Zhang=jzhang@adb.org
 Jiankang Zhang=jiankang_zhang@carleton.ca
 Jianlin Zhang=zhangjianlin@sim.edu.sg
 Jie Zhang=ecszj@nus.edu.sg
 Jing Zhang=j.zhang@nottingham.ac.uk
 Jing Zhang=jzhangzn@gmail.com
 Jingjing Zhang=jingjing.zhang@uzh.ch
 Juanjuan Zhang=jjzhang@mit.edu
 Jun Zhang=zhangjun@econ.queensu.ca
 Junfu Zhang=juzhang@clarku.edu
 Junhuan Zhang=junhuan.zhang@kcl.ac.uk
 Junjie Zhang=junjiezhang@ucsd.edu
 Junyi Zhang=zjy@hiroshima-u.ac.jp
 Juyong Zhang=environeconomics@sina.com
 Kun Zhang=kevin.zhang.09@mail.wbs.ac.uk
 Lei Zhang=l.zhang@warwick.ac.uk
 Lei Zhang=zlei89@gmail.com
 Lei Zhang=sdzbzl@gmail.com
 Liandong Zhang=liandong.zhang@cityu.edu.hk
 Liqin Zhang=liq-zh@263.net
 Longmei Zhang=lzhang2@imf.org
 Lu Zhang=zhanglu@fisher.osu.edu
 Min Zhang=maggie.zhang@utoronto.ca
 Ming Zhang=zhangming@cass.org.cn
 Nan Zhang=nz3m@virginia.edu
 Qiang Zhang=qzhang100@gmail.com
 Qiao Zhang=qzhang@unistra.fr
 Shengxing Zhang=oo7zsx@gmail.com
 Shunming Zhang=szhang@ruc.edu.cn
 Shuoxun Hellen Zhang=shuoxun@swufe.edu.cn
 Sisi Zhang=sisi.zhang@gmail.com
 S. Sarah Zhang=s.sarahzhang@gmail.com
 tao Zhang=taozhang7608@hotmail.com
 Tao Zhang=taozhangcema@gmail.com
 Tianle Zhang=tianlezhang@ln.edu.hk
 Ting Zhang=tingzhangphd@gmail.com
 Tong Zhang=tongzhang@swufe.edu.cn
 Tongbin Zhang=ztbhewitt@126.com
 Vanessa Yanhua ZHANG=yanhuazh@gmail.com
 Wei Zhang=w.zhang@cgiar.org
 Wei Bin Zhang=bandao8551@163.com
 张 卫彬 (wei-bin zhang)=wbz1@apu.ac.jp
 Weiguo Zhang=zhangweiguo@sdu.edu.cn
 Weina Zhang=weina@nus.edu.sg
 Weiying Zhang=wyzhang@gsm.pku.edu.cn
 Xiao-Bing Zhang=xbzhmail@gmail.com
 Xiaobo Zhang=x.zhang@cgiar.org
 Xibin Zhang=xibin.zhang@monash.edu
 Xufei Zhang=x.zhang@mdx.ac.uk
 Yahong Zhang=yzhang@bankofcanada.ca
 Ye Zhang=zhang65@iupui.edu
 Yifan Zhang=yifan.zhang@ln.edu.hk
 Yin Zhang=y.x.zhang@dundee.ac.uk
 Y. Jane Zhang=janezhang@ust.hk
 Yongchao Zhang=yongchao@mail.shufe.edu.cn
 Yongjing Zhang=yongjing.zhang@uottawa.ca
 张跃军 (Yue-Jun Zhang)=zyjmis@126.com
 Yuzhe Zhang=zhangeager@gmail.com
 Zhaoyong Zhang=zhaoyong.zhang@ecu.edu.au
 Zhenxuan Zhang=zhenxuan.zhang@gmail.com
 Zhichao Zhang=zhichao.zhang@durham.ac.uk
 Zhipeng Zhang=zhipengz.gsb@gmail.com
 ZhongXiang Zhang=zxz@fudan.edu.cn
 Bo Zhao=bo.robert.zhao@gmail.com
 Bo Zhao=bo.zhao@bos.frb.org
 Daxuan Zhao=zhaodx@ihpc.a-star.edu.sg
 Jingang Zhao=j.zhao@usask.ca
 Jinhua Zhao=jzhao@msu.edu
 Kai Zhao=kai.zhao@uconn.edu
 Liang Zhao=zhaoliang1967@gmail.com
 Mingjun Zhao=zhao.115@osu.edu
 Rui Zhao=rui.zhao@blackrock.com
 Ruoyun (Lucy) Zhao=ruoyun.zhao@uts.edu.au
 Tianshu Zhao=tianshu.zhao@stir.ac.uk
 Xiaofeng ZHAO=zhao1198@sohu.com
 Xiliang Zhao=zhaoxiliang@gmail.com
 Xueyan Zhao=xueyan.zhao@monash.edu
 Yongchen Zhao=hzhao@albany.edu
 Yonggan Zhao=yonggan.zhao@dal.ca
 Zhibiao Zhao=zuz13@stat.psu.edu
 Zhong Zhao=mr.zhong.zhao@gmail.com
 Tao Zha=zmail@tzha.net
 Alexei Zhdanov=zhdanov33@gmail.com
 Vitaliy V. Zheka=vzheka@eerc.kiev.ua
 Anatoliy Zheleznyak=zheleznyak-tol@yandex.ru
 Oleksandr ZHEMOYDA=alzhemoyda@gmail.com
 Bingyong Zheng=bingyongzheng@gmail.com
 Haitao Zheng=zhenghaitao@buaa.edu.cn
 Huanhuan Zheng=huanhuan.zheng@york.ac.uk
 Jianghuai zheng=zhengjh@nju.edu.cn
 Jun Tie Zheng=tiejun.zheng@laposte.net
 Liang Zheng=lzheng@cufe.edu.cn
 Mingli Zheng=mlzheng@umac.mo
 Siqi Zheng=zhengsiqi@tsinghua.edu.cn
 Xian Zheng=jeremy.zheng@hotmail.com
 Xiao-Ping Zheng=zheng@ec.ritsumei.ac.jp
 Xinye Zheng=zhengxinye@ruc.edu.cn
 Yuqing Zheng=yuqzheng@rti.org
 Zhihao Zheng=zhihaozheng09@yahoo.com.cn
 Natalia Zhivan=jivan@bc.edu
 Hai Zhong=haizhong@cufe.edu.cn
 Ligang Zhong=zlg@swufe.edu.cn
 Ninghua ZHONG=ninghua.zhong@gmail.com
 Chen Zhou=c.zhou@dnb.nl
 Guofu Zhou=zhou@wustl.edu
 Haiou Zhou=haiou.zhou@gmail.com
 Hao Zhou=zhouh@pbcsf.tsinghua.edu.cn
 Jidong Zhou=jidong.zhou@stern.nyu.edu
 Jie Zhou=jzhou@bankofcanada.ca
 Li Zhou=li.zhou@ualberta.ca
 Ming Zhou=mzhou.act@gmail.com
 Minghai Zhou=minghai.zhou@nottingham.edu.cn
 Mingming Zhou=mzhou@uccs.edu
 周楠 (Nan Zhou)=nan_zhou@skolkovo.ru
 Peng Zhou=rocy_zhou@hotmail.com
 Ruilin Zhou=rzhou@psu.edu
 Shaojie Zhou=zhoushaojie@tsinghua.edu.cn
 Xiangyi Zhou=marton@mail.xjtu.edu.cn
 Xilin Zhou=xzhou10@gsu.edu
 Yan Zhou=yzhou@csus.edu
 Yiyi Zhou=yiyi.zhou@stonybrook.edu
 Chao Zhu=zhuchao@cueb.edu.cn
 Drew Zhu=bzhu@ualberta.ca
 Feng Zhu=feng.zhu@bis.org
 Guozhong John Zhu=gzhu@gsm.pku.edu.cn
 Jieming Zhu=rstzhujm@nus.edu.sg
 Junjun Zhu=stanleyjunjun@hotmail.com
 Ke Zhu=mazkxaa@gmail.com
 Valeriy Mykolayovych Zhuk, Sr.=v-zhuk@i.ua
 Fan Zhuo=zhuo@bu.edu
 Quan-tao Zhu=davidqtzhu@gmail.com
 Ekaterina Zhuravskaya=ekaterina.zhuravskaya@parisschoolofeconomics.eu
 Susan Chun Zhu=zhuc@msu.edu
 Tao Zhu=taozhu@ust.hk
 Tingju Zhu=t.zhu@cgiar.org
 Xiaodong Zhu=xzhu@chass.utoronto.ca
 Yanhui Zhu=yanhui.zhu@uwe.ac.uk
 Yu Zhu=y.zhu-5@kent.ac.uk
 Zhen Zhu=zzhu@uco.edu
 Zhenhua Zhu=kevin_zhu@otpp.com
 Bilal Zia=bzia@worldbank.org
 Ziad Abderrahmane=abderrahmane.ziad@unicaen.fr
 Uzma Zia=uzmazia06@gmail.com
 Lea Zicchino=lea.zicchino@prometeia.it
 Nicolas Robert Ziebarth=nrz2@cornell.edu
 Zacharias Ziegelhöfer=zacharias.ziegelhoefer@graduateinstitute.ch
 Michael Heinrich Ziegelmeyer=michael.ziegelmeyer@bcl.lu
 Björn Ziegenbalg=ziegenbalg@ifo.de
 Uwe Ziegenhagen=uwe@ziegenhagen.info
 Patrick Zier=patrickzier@gmx.de
 Thomas Ziesemer=t.ziesemer@maastrichtuniversity.nl
 Emily Norman Zietz=enorman@mtsu.edu
 Joachim Zietz=joachim.zietz@mtsu.edu
 Ante Zigman=ante.zigman@zg.t-com.hr
 Soledad Zignago=soledad.zignago@gmail.com
 Jean-Pierre Zigrand=j.p.zigrand@lse.ac.uk
 Vasileios Zikos=v.zikos@riped.utcc.ac.th
 David Zilberman=zilber11@berkeley.edu
 Roy Zilberman=r.zilberman@lancaster.ac.uk
 Fabrizio Zilibotti=fabrizio.zilibotti@econ.uzh.ch
 Ion Radu Zilişteanu=radu@consultanti.ro
 Arthur Louis Zillante=azillant@uncc.edu
 Blandine ZIMMER=zimmer@unistra.fr
 David John Zimmerman=david.j.zimmerman@williams.edu
 Gary Chris Zimmerman=gary.zimmerman@sf.frb.org
 Christian Zimmermann=zimmermann@stlouisfed.org
 Jean-Benoit Zimmermann=jean-benoit.zimmermann@univ-amu.fr
 Klaus F. Zimmermann=zimmermann@iza.org
 Martin Zimmermann=zeta@df.uba.ar
 Paul Zimmerman=paul.r.zimmerman@gmail.com
 Markus Zimmer=zimmer@ifo.de
 Luigi Zingales=luigi@chicagobooth.edu
 Kirill Zinkovsky=kzinkovsky@hse.ru
 Jonathan Zinman=jzinman@dartmouth.edu
 Maria Belen Zinni=belen.zinni@oecd.org
 Jesse Aaron Zinn=zinn@econ.ucsb.edu
 Natalia Zinovyeva=natalia.zinovyeva@cchs.csic.es
 Leandro Zipitría=leandro.zipitria@cienciassociales.edu.uy
 Julie Margaretta Zissimopoulos=zissimop@healthpolicy.usc.edu
 Benjamin C. Zissimos=b.zissimos@exeter.ac.uk
 Steffen Ziss=sziss@wlu.ca
 Habib Zitouna=habib.zitouna@essect.rnu.tn
 Eric Zitzewitz=eric.zitzewitz@dartmouth.edu
 Eric Zivot=ezivot@u.washington.edu
 Roberta Zizza=roberta.zizza@bancaditalia.it
 Andrei Zlate=andrei.zlate@frb.gov
 Zdeněk Zmeškal=zdenek.zmeskal@vsb.cz
 Roman Zmyślony=rzmyslony@op.pl
 Nuša Žnuderl=nznuderl@gmail.com
 Hosny Zoabi=hosnyz@post.tau.ac.il
 Roberto Zoboli=roberto.zoboli@unicatt.it
 George R. Zodrow=zodrow@rice.edu
 Ayman Zohry=azohry@zohry.com
 Marius Andrei Zoican=m.a.zoican@vu.nl
 Elena Zoido=ezoido@compasslexecon.com
 Claudio Zoli=claudio.zoli@univr.it
 Mariangela Zoli=zoli@sefemeq.uniroma2.it
 Judit Zoltan=judit.zoltan@usi.ch
 George Andrew Zombanakis=zompies5@otenet.gr
 Geert A. Zonnekeyn=geert.zonnekeyn@telenet.be
 Nicholas Zonzilos=nikos.zonzilos@otenet.gr
 Davor Zoričić=dzoricic@efzg.hr
 Aslan Zorlu=a.zorlu@uva.nl
 Peter Zorn=zorn@econ.uni-frankfurt.de
 Roberto Zotti=rzotti@unisa.it
 Chakib ZOUAGHI=chakib.zouaghi@live.ca
 Sondes Zouaghi=sondes.zouaghi@u-cergy.fr
 Benteng ZOU=benteng.zou@uni.lu
 Michel Zouboulakis=mzoub@econ.uth.gr
 Heng-Fu Zou (邹恒甫） (heng-fu zou)=hzoucema@gmail.com
 Messaoud ZOUIKRI=mzouikri@u-paris10.fr
 Floris Tobias Zoutman=fzoutman@gmail.com
 Ilija Ivan Zovko=zovko@santafe.edu
 Sarah Zubairy=szubairy@tamu.edu
 Nick Zubanov=zubanov@econ.uni-frankfurt.de
 Jovan Zubović=zubovicj@ikomline.net
 Robertas Zubrickas=robertas.zubrickas@econ.uzh.ch
 Eugenio Zucchelli=e.zucchelli@lancaster.ac.uk
 James Zuccollo=james.zuccollo@reform.co.uk
 Lynne Zucker=zucker@ucla.edu
 Sepp Zuckerstätter=sepp.zuckerstaetter@akwien.at
 Gabriel Zucman=zucman@berkeley.edu
 Galina Zudenkova=galina.zudenkova@gmail.com
 Anna A. Zudina=azudina@hse.ru
 Pavel Zufan=pavel.zufan@gmail.com
 Jaco Zuijderduijn=c.j.zuijderduijn@umail.leidenuniv.nl
 Bertrand Zuindeau=bertrand.zuindeau@univ-lille1.fr
 Christine Zulehner=zulehner@safe.uni-frankfurt.de
 Hernando Zuleta=hernando.zuleta@gmail.com
 Salyha Zulfiqar=salyha99@hotmail.com
 רועי זולטן (Ro'i Zultan)=zultan@bgu.ac.il
 Blanca Zuluaga=bzuluaga@icesi.edu.co
 Julio César Zuluaga=juliocesarzuluaga83@yahoo.com
 Maria Zumbuehl=m.zumbuehl@uni-bonn.de
 Catia Zumpano=zumpano@inea.it
 Martin Zumpe=martin.zumpe@u-bordeaux4.fr
 Carlos Alberto Zúniga González=czunigagonzales@gmail.com
 Sergio Zuniga=sz@ucn.cl
 Gloria Zúñiga y Postigo=ontogloria@gmail.com
 Andrew Zuppann=cazuppann@uh.edu
 Felipe Zurita=fzurita@uc.cl
 Maria Gabriela Zurita=maria.gabriela.zurita@gmail.com
 Michael Zürn=zuern@wzb.eu
 Asaf Zussman=azussman@mscc.huji.ac.il
 Noam Zussman=noamz@boi.gov.il
 Aneesh Zutshi=aneesh84@gmail.com
 Irina Zviadadze=irina.zviadadze@hhs.se
 Gijsbert Zwart=g.t.j.zwart@cpb.nl
 Josef Zweimüller=josef.zweimueller@econ.uzh.ch
 Martina Zweimüller=martina.zweimueller@jku.at
 Rami Zwick=ramiz@ucr.edu
 Thomas Zwick=thomas.zwick@uni-wuerzburg.de
 Remco Zwinkels=zwinkels@ese.eur.nl
 Benjamin Zycher=benjamin.zycher@aei.org
 Yanos Zylberberg=yzylberberg@crei.cat
 Eduardo Zylberstajn=eduardo.zylberstajn@fgv.br
 Adam Zylbersztejn=adam.zylbersztejn@malix.univ-paris1.fr
 Robert Zymek=robert.zymek@ed.ac.uk
