 Beatrix Paal=professorpaal@gmail.com
 Harry J Paarsch=hjpaarsch@gmail.com
 Federico Pablo Martí=federico.pablo@uah.es
 Maria del P. Pablo-Romero=mpablorom@us.es
 Omar Paccagnella=omar.paccagnella@unipd.it
 Giuseppe Pace=giuseppe.pace@issm.cnr.it
 Andrea Pacella=andrea.pacella@unisannio.it
 Graziella Pacelli=g.pacelli@univpm.it
 Lia Pacelli=lia.pacelli@unito.it
 Noemi Pace=n.pace@unive.it
 Diana Pacheco Barzallo=diana.pacheco@unine.ch
 Gail Pacheco=gail.pacheco@aut.ac.nz
 Penélope Pacheco López=pp284@kent.ac.uk
 Luis Pacheco=luisp@upt.pt
 Luigi Paciello=luigi.paciello@eief.it
 Daniele Pacifico=danielepacifico@yahoo.it
 Raffaele Paci=paci@unica.it
 Mikko Packalen=packalen@uwaterloo.ca
 Johann Packendorff=johann.packendorff@indek.kth.se
 Cayetano W. Paderanga, Jr.=cayetano_jr.paderanga@upd.edu.ph
 Laura Padilla Angulo=laura.padilla@get-mail.fr
 Emilio Padilla=emilio.padilla@uab.es
 Carmen Padin Fabeiro=padin@uvigo.es
 Camillo Padoa-Schioppa=camillo@alum.mit.edu
 Fabio Padovano=fabio.padovano@univ-rennes1.fr
 David Padron=dpadron@ull.es
 Noemi Padron Fumero=npadron@ull.es
 Mario Padula=mpadula@unive.it
 Paolo Paesani=paolo.paesani@uniroma2.it
 Joerg Paetzold=joerg.paetzold@sbg.ac.at
 Juan Paez-Farrell=j.paez-farrell@sheffield.ac.uk
 Adrian Rodney Pagan=adrian.pagan@sydney.edu.au
 Elisa Pagani=elisa.pagani@univr.it
 Marco Pagano=marco.pagano@unina.it
 Patrizio Pagano=patrizio.pagano@bancaditalia.it
 Ugo Pagano=pagano@unisi.it
 Ricardo Pagan Rodriguez=rpr@uma.es
 Jonathan R. Page=jrpage@hawaii.edu
 Michaela Pagel=mpagel@econ.berkeley.edu
 Marianne Elizabeth Page=mepage@ucdavis.edu
 Henri F. Pagès=henri.pages@banque-france.fr
 Stefano Pagiola=spagiola@worldbank.org
 Agustina Selvi Paglayan=paglayan@stanford.edu
 Marcello Pagnini=marcello.pagnini@bancaditalia.it
 Marco Pagnozzi=pagnozzi@unina.it
 Johannes Paha=johannes.paha@wirtschaft.uni-giessen.de
 André Pahnke=pahnke@ifm-bonn.org
 Marko Pahor=marko.pahor@ef.uni-lj.si
 Paola Paiardini=ppaiardini@luiss.it
 Myungho Paik=m-paik@northwestern.edu
 Ariane Pailhé=pailhe@ined.fr
 Rodrigo Paillacar=rodrigo.paillacar@gmail.com
 Davy Paindaveine=dpaindav@ulb.ac.be
 Nigel Pain=nigel.pain@oecd.org
 Joana Vaz Pais=jpais@iseg.utl.pt
 Adriano Nascimento da Paixão=anpaixao@gmail.com
 Laszlo Paizs=paizs@econ.core.hu
 Javier Pajares=pajares@insisoc.org
 Mika Pajarinen=mika.pajarinen@etla.fi
 Stephane Pajot=percolationeteconomie@gmail.com
 Catherine Ruth Pakaluk=catherine.pakaluk@avemaria.edu
 Ariel Pakes=apakes@fas.harvard.edu
 Nadezda Victorovna Pakhomova=pak-nadezda@yandex.ru
 Michael Pakko=mrpakko@ualr.edu
 Jose Palacin=jose.palacin@unece.org
 Ignacio Palacios-Huerta=i.palacios-huerta@lse.ac.uk
 Robert Joseph Palacios=rpalacios@worldbank.org
 Ali PALALI=alipalali1@gmail.com
 Nicole Kathrin Palan=nicole.palan@uni-graz.at
 Alessandro Palandri=alessandro.palandri@gmail.com
 Thangavel Palanivel=t.palanivel@undp.org
 Stefan Palan=stefan.palan@uni-graz.at
 Filip Palda=filip.palda@enap.ca
 Debashis Pal=debashis.pal@uc.edu
 Giulio Palermo=palermo@eco.unibs.it
 Arsen Palestini=arsen.palestini@uniroma1.it
 Antonio Palestrini=ants.pal@gmail.com
 Irina Paley=irina.paley@occ.treas.gov
 Theodore Palivos=tpalivos@aueb.gr
 Stephane Pallage=pallage.stephane@uqam.ca
 Andrea Pallavicini=andrea.pallavicini@gmail.com
 Athanasios A. Pallis=apallis@aegean.gr
 Alessandro Palma=alessandro.palma@uniroma3.it
 Maria Luisa Palma Martos=mpalma@us.es
 Christopher Palmberg=christopher.palmberg@tekes.fi
 Johanna Palmberg=johanna.palmberg@indek.kth.se
 Eduardo Mauch Palmeira, Sr.=profpalmeira@gmail.com
 Mårten Palme=marten.palme@ne.su.se
 Charles Edward Palmer=c.palmer1@lse.ac.uk
 Teresa Palmer Tous=teresa.palmer@uib.es
 Tapio Palokangas=tapio.palokangas@helsinki.fi
 Arturo Palomba=arturo.palomba@unina2.it
 Giulio Palomba=g.palomba@univpm.it
 Edgardo Palombini=epalombini@gmail.com
 Ennio Alessandro Palombizio=eap@cogeco.ca
 Francisco Palomino=fpal@umich.edu
 Jesús Peiró-Palomino=peiroj@uji.es
 Alberto Paloni=a.paloni@lbss.gla.ac.uk
 Maritta Paloviita=maritta.paloviita@bof.fi
 Rama Pal=ramajoglekar128@gmail.com
 Rupayan Pal=rupayanpal@gmail.com
 Sarmistha Pal=s.pal@surrey.ac.uk
 Soubarna Pal=sbssp1@hotmail.com
 Antonella Palumbo=palumb.a@uniroma3.it
 Giuliana Palumbo=giuliana.palumbo@bancaditalia.it
 Elisenda Paluzie=epaluzie@ub.edu
 Fabio Pammolli=f.pammolli@imtlucca.it
 Oliver Pamp=o.pamp@jmc-berlin.org
 Teoman Pamukçu=pamukcu@metu.edu.tr
 Sevket Pamuk=s.pamuk@lse.ac.uk
 Luca Panaccione=luca.panaccione@uniroma2.it
 Judith Panadés=judith.panades@uab.es
 Arvind Panagariya=ap2231@columbia.edu
 Stavros Panageas=spanagea@chicagobooth.edu
 Theodore Panagiotidis=tpanag@uom.gr
 Stylianos Panagiotou=panagiotou.s@gmail.com
 Andreas Panagopoulos=andreas.panagopoulos@gmail.com
 Iulian Panait=iulian.panait@gmail.com
 Cheng Pan=pancheng1874@gmail.com
 Francesca Pancotto=francesca.pancotto@unimore.it
 Architesh Panda=architesh@gmail.com
 Bibhudutta Panda=bpanda@morris.umn.edu
 Prasant Kumar Panda=pkp.pondyedu@gmail.com
 Vinod Chandra Pande=vcpande_2000@yahoo.com
 Adya Prasad Pandey=adyappandey@gmail.com
 Alok Kumar Pandey=pandey.alok@rediffmail.com
 Aviral Pandey=aviral.iegindia@gmail.com
 Krishan Kumar Pandey=krishan.pandey@gmail.com
 Radhika Pandey=radhesp@gmail.com
 Rita Pandey=rita@nipfp.org.in
 Shivesh Pandey=shiveshpandey@gmail.com
 Ram Pandit=ram.pandit@uwa.edu.au
 Lauren Pandolfelli=lpandolfelli@gmail.com
 Kiran Pandya=kpcapricorn@yahoo.com
 Irena Pandza Bajs=ipandza@efzg.hr
 Ionut Valentin PANEA=ionut_panea@yahoo.com
 Fabrizio Panebianco=fabrizio.panebianco@psemail.eu
 Ida Claudia Panetta=ida.panetta@uniroma1.it
 PhiriInnocent Pangapanga=phiriinnocent@gmail.com
 Felicity Pang=felicity.pang@monash.edu
 Gaobo Pang=gaobo.pang@towerswatson.com
 Jiaren Pang=pangjr@sem.tsinghua.edu.cn
 Ke Pang=kpang@wlu.ca
 Andrei Yu. Panibratov=panibratov@gsom.pu.ru
 Demian Tupac Panigo=panigo@gmail.com
 潘杰 (Jay Pan)=panjie.jay@gmail.com
 Timo Panke=timo.panke@ewi.uni-koeln.de
 Katarzyna (Kate) Pankowska=katepankowska@gmail.com
 Lei Pan=panlei0411@gmail.com
 Mingming Pan=mpan@nmsu.edu
 David J. Pannell=david.pannell@uwa.edu.au
 Ekaterini Panopoulou=apano@unipi.gr
 Georgios A. Panos=georgios.panos@stir.ac.uk
 Vasia Panousi=vasia.panousi@frb.gov
 Fabrizio Panozzo=f.panozzo@unive.it
 Paolo M. Panteghini=panteghi@eco.unibs.it
 Pantelis Pantelidis=pantel@unipi.gr
 Theologos Pantelidis=pantelidis@uom.gr
 Dimitri Paolini=dpaolini@uniss.it
 Francesco Paolucci=francesco.paolucci@anu.edu.au
 George A. Papachristou=gpapahr@econ.auth.gr
 Stephanos Papadamou=stefpap3@yahoo.com
 Konstantinos Papadatos=kostaspp8@yahoo.gr
 Theophilos Papadimitriou=papadi24@gmail.com
 Athanasios Papadopoulos=appapa@econ.soc.uoc.gr
 Georgios Papadopoulos=g.papadopoulos@uea.ac.uk
 Konstantinos G. Papadopoulos=kpap@econ.auth.gr
 Savas Papadopoulos=spapado@ierd.duth.gr
 Niki Papadopoulou=nikipapadopoulou@centralbank.gov.cy
 Enrica Papa=enpapa@unina.it
 Chris Papageorgiou=cpapageorgiou@imf.org
 Dimitris Papageorgiou=dpapag@aueb.gr
 George John Papageorgiou=gjpap@otenet.gr
 Theofanis Papageorgiou=papageorgioutheofanis@gmail.com
 Yorgos Yanni Papageorgiou=yorgos@mcmaster.ca
 Erasmo Papagni=erasmo.papagni@unina2.it
 Christos Papahristodoulou=christos.papahristodoulou@mdh.se
 Elias Papaioannou=papaioannou.elias@gmail.com
 Sotiris Papaioannou=sopa@kepe.gr
 Athanasios Papakonstantinou=ap@athpap.net
 Evangelia Papanagiotou=epapana@aegean.gr
 Dimitris Papanikolaou=d-papanikolaou@kellogg.northwestern.edu
 Nikolaos I. Papanikolaou=n.papanikolaou@sussex.ac.uk
 Shushanik Papanyan=shushanikp@gmail.com
 Dimitrios Papaoikonomou=dpapaoikonomou@bankofgreece.gr
 Nikos C. Papapostolou=n.papapostolou@city.ac.uk
 Nicholas Paparoidamis=n.paparoidamis@ieseg.fr
 Eleni Papathanasopoulou=elpa@pml.ac.uk
 Andreas Duus Pape=apape@binghamton.edu
 David Papell=dpapell@uh.edu
 Monika Papież=papiezm@uek.krakow.pl
 Luca Papi=l.papi@univpm.it
 Leslie E. Papke=papke@msu.edu
 Georgia Papoutsi=gpapoutsi@gmail.com
 Evangelia Pappa=evangelia.pappa@yahoo.com
 Evi Paraskevi Pappa=evi.pappa@eui.eu
 Kerry L. Papps=k.l.papps@bath.ac.uk
 Alain Paquet=paquet.alain@uqam.ca
 Sohail Ajmal Paracha=paracha.sohail@gmail.com
 Jairo J. Parada=jparadac@uninorte.edu.co
 Julián David Parada=juliandpb@gmail.com
 Ferdinand Javien Paraguas=ferdzparaguas@yahoo.com
 Guillermo Paraje=guillermo.paraje@uai.cl
 Juan Luis Paramio Salcines=juanluis.paramio@uam.es
 Bernard Paranque=paranque@bparanque.com
 Alain Paraponaris=alain.paraponaris@inserm.fr
 Evita Paraskevopoulou=eparaske@emp.uc3m.es
 Jaai Parasnis=jaai.parasnis@monash.edu
 Osiris Parcero=osirisjorge.parcero@gmail.com
 Raphaël Parchet=raphael.parchet@usi.ch
 James E. Parco=jim.parco@coloradocollege.edu
 Xulio Pardellas de Blas=xulio@uvigo.es
 Philip G. Pardey=ppardey@umn.edu
 Cristian Pardo=cpardo@sju.edu
 Clara Ines Pardo Martinez=cipmusa@yahoo.com
 Oliver Pardo=o.e.pardo-reinoso@lse.ac.uk
 Sophie Pardo=sophie.pardo@univ-nantes.fr
 Dusan Paredes=dparedes@ucn.cl
 Joan Paredes=joan.paredes@ecb.europa.eu
 Ricardo D. Paredes=rparedes@ing.puc.cl
 Carmelo Pierpaolo Parello=carmelo.parello@uniroma1.it
 Antoine PARENT=antoine.parent@sciencespo-lyon.fr
 Daniel Parent=daniel.parent@hec.ca
 Paulo M.D.C. Parente=p.m.parente@exeter.ac.uk
 Stephen Parente=parente@illinois.edu
 Steve Parente=sparente@umn.edu
 Angela Parenti=aparenti@ec.unipi.it
 Mathieu Parenti=mathieu.parenti@uclouvain.be
 Marcos Pompeu Pareto=mppareto@bu.edu
 Vittorio Emmanuel Pareto, IV=vepareto@gmail.com
 Christos Pargianas=christos.pargianas@scranton.edu
 Robert Parham=robert.parham@simon.rochester.edu
 Gilles Parienté=gilles.pariente@univ-tlse1.fr
 William Parienté=william.pariente@uclouvain.be
 Elena Parilina=elena.parilina@gmail.com
 Rasyad A. Parinduri=rasyad.parinduri@nottingham.edu.my
 Sergei Parinov=sparinov@cemi.rssi.ru
 Daniela Parisi=daniela.parisi@unicatt.it
 Franco Parisi=fparisi@unab.cl
 Lavinia Parisi=laparisi@unisa.it
 Maria Laura Parisi=parisi@eco.unibs.it
 Lucia Parisio=lucia.parisio@unimib.it
 Albert Park=albertpark@ust.hk
 Beum Jo Park=bjpark@dankook.ac.kr
 Cheolbeom Park=cbpark_kjs@korea.ac.kr
 Cyn-Young Park=cypark@adb.org
 Donghyun Park=dpark@adb.org
 Barnett Richard Parker=docbrparker@aol.com
 David Parker=david.parker@cranfield.ac.uk
 Doug Parker=doug.parker@ucop.edu
 Elliott Parker=elliottp@unr.edu
 Simon C. Parker=sparker@ivey.uwo.ca
 Susan Parker=susan.parker@cide.edu
 Thomas Parker=tmparker@uwaterloo.ca
 Alexander V. Parkhomenko=alex.parkhomenko@par-ma.com
 Gregory Malcolm Parkhurst=gregoryparkhurst@weber.edu
 Michael Parkin=mparkin@uwo.ca
 Innwon Park=iwpark@korea.ac.kr
 Joon Y. Park=joon@indiana.edu
 Jooyoun Park=jpark8@kent.edu
 JungJae Park=ecspj@nus.edu.sg
 Jungsoo Park=jspark@sogang.ac.kr
 Kichool Park=kichool.park@samsung.com
 Ki Young Park=kypark@yonsei.ac.kr
 Minjung Park=mpark@haas.berkeley.edu
 박상수 (Sang Soo Park)=esesp.park@gmail.com
 Soo-Bin Park=soobinpark@rogers.com
 Robert Parks=bparks@artsci.wustl.edu
 Timothy A. Park=tapark@ers.usda.gov
 Woong Yong Park=wypark@hku.hk
 Yongjin Park=ypark@conncoll.edu
 Young Joon Park=yjpark@szpku.edu.cn
 Sarah Parlane=sarah.parlane@ucd.ie
 Alexis Parmentier=alexis.parmentier@univ-reunion.fr
 Johan Parmler=johan.parmler@kvalitetsindex.se
 Neeraj Parnami=neerajparnami@gmail.com
 Miia Parnaudeau=mparnaudeau@escem.fr
 Syeda Naushin Parnini=parnini12@gmail.com
 Carlos Parodi=parodi_caj@up.edu.pe
 Giuliana Parodi=parodi@unich.it
 Arno Parolini=arno.parolini@uibk.ac.at
 Leonidas Paroussos=paroussos@gmail.com
 Juan Carlos Parra-Alvarez=jparra@creates.au.dk
 Sergio Parra Cely=parra.sergio@javeriana.edu.co
 Eric Parrado=eric.parrado@uai.cl
 Ramiro Parrado=ramiro.parrado@feem.it
 Juan Carlos Parra=jparraosorio@worldbank.org
 Carlos Parra-López=carlos.parra@juntadeandalucia.es
 Julián A. Parra-Polanía=jparrapo@banrep.gov.co
 Adela Parra Romero=fujico_lee@yahoo.com
 Paola Parravicini=paola.parravicini@unimi.it
 Mario Davide Parrilli=m.d.parrilli@orkestra.deusto.es
 Alessandro Parrini=parrini.ale@gmail.com
 Fernando Parro=fernando.j.parro@frb.gov
 Pierpaolo Parrotta=p.parrotta@maastrichtuniversity.nl
 Ian Parry=iparry@imf.org
 Petr Parshakov=pparshakov@hse.ru
 David Parsley=david.parsley@vanderbilt.edu
 Aleksandra Parteka=aparteka@zie.pg.gda.pl
 Friska Parulian=fparulian@imf.org
 Mahbub Parvez=mparvez@daffodilvarsity.edu.bd
 Naima Parvin=naimaparvin2@gmail.com
 Raluca Parvulescu=r.parvulescu@ieseg.fr
 Guzay Pasaoglu=guzaypasaoglu@gmail.com
 Razvan C. Pascalau=rpasc001@plattsburgh.edu
 Gabriela Carmen Pascariu=gcpas@uaic.ro
 Cyril Pasche=cyril.pasche@unige.ch
 Markus Pasche=markus.pasche@uni-jena.de
 Raphael Paschke=paschke@uni-mannheim.de
 Sean Pascoe=sean.pascoe@csiro.au
 Bartolomé Pascual-Fuster=tomeu.pascual@uib.es
 Marta Pascual=marta.pascual@unican.es
 Unai Pascual=up211@cam.ac.uk
 Andrea Pascucci=pascucci@dm.unibo.it
 Stefano Pascucci=stefano.pascucci@wur.nl
 Farooq Pasha=farooq.pasha.bc@gmail.com
 Panos Pashardes=p.pashardes@ucy.ac.cy
 Svetlana Pashchenko=sap9v@virginia.edu
 Giacomo Pasini=giacomo.pasini@unive.it
 Corrado Pasquali=cpasquali@unite.it
 Joan Pasqual Rocabert=joan.pasqual.rocabert@uab.es
 Silvia Pasqua=silvia.pasqua@unito.it
 Leo Pasquazzi=leo.pasquazzi@unimib.it
 Gurnain Kaur Pasricha=gpasricha@bankofcanada.ca
 Constadina Passa=constadina.passa@gmail.com
 Luca Passalacqua=luca.passalacqua@uniroma1.it
 Francesco Passarelli=francesco.passarelli@unibocconi.it
 Ana Margarida Passos=ana.passos@iscte.pt
 Jose Passos=passos@iseg.utl.pt
 Marcelo de Oliveira Passos=profpassos@uol.com.br
 Ernesto Pasten=ernesto.pasten@tse-fr.eu
 Carmen Adina Pastiu=carmenpastiu@yahoo.com
 Gema Pastor-Agustin=gpastor@unizar.es
 Francesco Pastore=francesco.pastore@unina2.it
 Mario Pastore=mariohpastore@gmail.com
 Elena Pastorino=epastori@umn.edu
 Lubos Pastor=lubos.pastor@chicagobooth.edu
 Guillaume Pastureau=pastureau.guillaume@gmail.com
 Carl A. Pasurka, Jr.=pasurka.carl@epa.gov
 Laura Patache=laura.patache@spiruharet.ro
 Roberta Patalano=roberta.patalano@uniparthenope.it
 Yupin Patara=yupin.patara@sasin.edu
 Jennifer G Pate=joffenberg@lmu.edu
 Amrish Patel=amrish.patel@economics.gu.se
 Darshak Patel=dpatel45@utm.edu
 K. K. Patel=kkpatel7@yahoo.com
 Vihang Mahendra Patel=vihang.patel@yahoo.com
 Robert Pater=rpater@wsiz.rzeszow.pl
 Durgesh Chandra Pathak=pathakdc@gmail.com
 M'd Shams Tabrize Pathan=tabreezsp@yahoo.com
 Ambika Prasad Pati=apatiau@yahoo.com
 Jorge E. Patiño=jpatinoq@eafit.edu.co
 Ila Patnaik=ilapatnaik@gmail.com
 Manasa Patnam=manasa.patnam@ensae.fr
 David Paton=david.paton@nottingham.ac.uk
 Kraiyos Patrawart=kraiyos@qlf.or.th
 Robert H. Patrick=rpatrick@rutgers.edu
 Harry Patrinos=hpatrinos@worldbank.org
 Tomás Patrocínio=patrocinio.tomas@gmail.com
 Pier Paolo Patrucco=pierpaolo.patrucco@unito.it
 Bogdan Patrut=bogdan@edusoft.ro
 Nikolaos A. Patsopoulos=npatsop@cc.uoi.gr
 Manoranjan Pattanayak=mpattanayak@gmail.com
 Subhrendu Kishore Pattanayak=subhrendu.pattanayak@duke.edu
 Francesco Pattarin=francesco.pattarin@unimore.it
 Sebastiano Patti=spatti@unict.it
 Pierpaolo Pattitoni=pierpaolo.pattitoni@unibo.it
 Andrew Patton=andrew.patton@duke.edu
 Roberto Patuelli=roberto.patuelli@unibo.it
 Lise Patureau=lise.patureau@univ-lille1.fr
 Concepció Patxot=cio.patxot@ub.edu
 Holger Patzelt=patzelt@econ.mpg.de
 Ramesh Chandra Paudel=rameshpaudel@hotmail.com
 Krishna Paudyal=krishna.paudyal@strath.ac.uk
 Bénédique Paul=benedique.paul@uniq.edu.ht
 Giorgio Pauletto=pauletto@stanfordalumni.org
 LACOUR Pauline=pauline.lacour@upmf-grenoble.fr
 Muthucattu Thomas Paul=thomas.paul@usp.ac.fj
 Edilson Paulo=e.paulo@uol.com.br
 Margarida Ramires Paulos=margarida.ramires@gmail.com
 Rajkumar Paulrajan=raniha@yahoo.com
 Bernard E. Paulré=paulre@univ-paris1.fr
 Rodney Joseph Paul=rpaul01@syr.edu
 Satya Paul=s.paul@uws.edu.au
 Shampa Paul=shampa.paul147@gmail.com
 Sunil Paul=sunilpaul29@gmail.com
 Suresh L. Paul=sureshlazaruspaul@gmail.com
 Tapas Kumar Paul=paulju16@gmail.com
 Alari Paulus=apaulus@essex.ac.uk
 Moritz Paulus=moritz.paulus@web.de
 Varun Paul=varun.paul@bankofengland.co.uk
 Carmen Beatrice Pauna=pauna.carmen@gmx.at
 Laura Adriana Paun (Baditoiu)=laura.paun@mail.com
 Paun Cristian=cpaun@ase.ro
 Carmen Paunescu=carmen.paunescu@fabiz.ase.ro
 Alida Paunic=alida.paunic@inet.hr
 Caroline Paunov=caroline.paunov@oecd.org
 Thilo Pausch=thilo.pausch@bundesbank.de
 Xavier Pautrel=xavier.pautrel@univ-nantes.fr
 Laurent L. Pauwels=laurent.pauwels@sydney.edu.au
 Marina Pavan=pavan@uji.es
 Ronni Pavan=ronni.pavan@rhul.ac.uk
 Robert Pavasuthipaisit=rpavasute@live.com
 Nina Pavcnik=nina.pavcnik@dartmouth.edu
 Florin Marius Pavelescu=pavelescu.florin@yahoo.com
 Piermassimo Pavese=piermassimo.pavese@agenziaterritorio.it
 Δημήτρης Παυλόπουλος (DIMITRIS PAVLOPOULOS)=d.pavlopoulos@vu.nl
 ROSSITSA RANGELOVA PAVLOVA/Росица Рангелова Павлова (ROSSITSA RANGELOVA PAVLOVA)=r.rangelova@iki.bas.bg
 Valentina Andriivna Pavlova=pavlova@duep.edu
 Gregory Pavlov=gpavlov@uwo.ca
 Dmitry Pavlyuk=dmitry.pavlyuk@tsi.lv
 Nicola Pavoni=pavoni.nicola@gmail.com
 Sasiwimon Warunsiri Paweenawat=sasiwimon.warunsiri@gmail.com
 Christina Pawlowitsch=christina.pawlowitsch@ens.fr
 Małgorzata Pawłowska=malgorzata.pawlowska@nbp.pl
 Ivan Paya=i.paya@lancaster.ac.uk
 Dann Payares Ayola=dayola@uninorte.edu.co
 A. Abigail Payne=paynea@mcmaster.ca
 Diane Payne=diane.payne@ucd.ie
 James E. Payne=jepayne@uno.edu
 Richard Payne=richard.payne@city.ac.uk
 Pasquale Pazienza=p.pazienza@unifg.it
 Khairul Hanim Pazim=k_hanim@ums.edu.my
 Jorge Augusto Paz=pazj@unsa.edu.ar
 Consuelo Pazó=cpazo@uvigo.es
 Corina Maria Paz Teran=cpaz@herrera.unt.edu.ar
 Matteo Pazzona=mpazzona@ucn.cl
 Duraisamy P=pduraisamy@hotmail.com
 Richard Wilson Peach=richard.peach@ny.frb.org
 Douglas Kenneth Pearce=doug_pearce@ncsu.edu
 Joseph Gerson Pearlman=joseph.pearlman.1@city.ac.uk
 Neil Pearson=pearson2@uiuc.edu
 Peter J G Pearson=pearsonpj@cardiff.ac.uk
 Nicolas Pécastaing=nicolas.pecastaing@univ-pau.fr
 Francesco Pecci=francesco.pecci@univr.it
 Gerald Pech=gp@geraldpech.net
 Lambros Pechlivanos=lpech@aueb.gr
 Susanne Pech=susanne.pech@jku.at
 James Peck=peck.33@osu.edu
 Jamie Peck=jamie.peck@ubc.ca
 Marco Pecoraro=marco.pecoraro@unine.ch
 Paul Pecorino=ppecorin@cba.ua.edu
 Roberto Pedace=rpedace@scrippscollege.edu
 Chandra Sekhar Pedamallu=pcs.murali@gmail.com
 Luis Enrique Pedauga=pedauga@ugr.es
 Michael Pedersen=mpederse@bcentral.cl
 Thomas Quistgaard Pedersen=tqpedersen@creates.au.dk
 Trond Einar Pedersen=tep@forskningsradet.no
 Carla Pederzini=carla.pederzini@uia.mx
 Chiara Pederzoli=chiara.pederzoli@unimib.it
 Valerien Olivier Pede=v.pede@irri.org
 Carlos Eduardo Pedreira=pedreira@ufrj.br
 Andrés Pedreño=ape@ua.es
 Jose Antonio Pedrosa Garcia=jose.pedrosa@aya.yale.edu
 Marco Pedrotti=marco.pedrotti.1@gmail.com
 Joe Peek=joe.peek@bos.frb.org
 Gert Peersman=gert.peersman@ugent.be
 Stefanie Peer=speer@wu.ac.at
 Carine Peeters=carine.peeters@ulb.ac.be
 Dominique Peeters=dominique.peeters@uclouvain.be
 Marga Peeters=huber@tinamargapeeters.eu
 Ronald Peeters=r.peeters@maastrichtuniversity.nl
 Thomas Peeters=thomas.peeters@uantwerpen.be
 Peter Peetz=peetz@giga-hamburg.de
 Anna Pegels=anna.pegels@die-gdi.de
 Fulvio Pegoraro=fulvio.pegoraro@banque-france.fr
 Denis PEGUIN=denis.peguin@univ-amu.fr
 Anne PEGUIN-FEISSOLLE=anne.peguin@univ-amu.fr
 Gernot Pehnelt=info@globecon.org
 Andreas Peichl=peichl@zew.de
 Ingrid PEIGNIER=ingrid.peignier@cirano.qc.ca
 裴建锁 (Jiansuo Pei)=jiansuo.pei@gmail.com
 Patricia Peinado=patricia.peinado@ehu.es
 John Douglas Peirson=jdp1@kent.ac.uk
 Fernanda Paula Mora Peixe=fmp@uevora.pt
 Mirjana Pejić Bach=mirjana.pejicbach@gmail.com
 Chuen-Khee Pek=pekchuenkhee@gmail.com
 Dilek Pekdemir=dpekdemir@yahoo.com
 Sari Pekkala Kerr=sari.pekkala@gmail.com
 Jose Tomas Pelaez=jtpelaez@javerianacali.edu.co
 Matteo Maria Pelagatti=matteo.pelagatti@unimib.it
 Theodore Pelagidis=pelagidi@unipi.gr
 Corina Pelau=corinapelau@yahoo.com
 Daniel Traian Pele=danpele@ase.ro
 Dan Peled=dpeled@econ.haifa.ac.il
 Bezalel Peleg=pelegba@math.huji.ac.il
 Jérôme Pelenc=jerome.pelenc@gmail.com
 Renato Pelessoni=renato.pelessoni@econ.units.it
 Andrei Pelin=andrei.pelin@gmail.com
 Aurore Pélissier=pelissier.aurore@gmail.com
 Loriana Pelizzon=loriana.pelizzon@unive.it
 Panu Pelkonen=p.o.pelkonen@sussex.ac.uk
 Guido Pellegrini=guido.pellegrini@uniroma1.it
 José Luis Pellegrini=jopelleg@fcecon.unr.edu.ar
 Letizia Pellegrini=letizia.pellegrini@univr.it
 Gabriele Pellegrino=gabriele-pellegrino@hotmail.it
 Paola Pellegrino=pellegrinopaola@libero.it
 Simone Pellegrino=spellegrino@gmail.com
 Gábor Pellényi=pellenyig@mnb.hu
 Denis Pelletier=denis_pelletier@ncsu.edu
 Danilo Pelletiere=dpelleti@gmu.edu
 Marco Pelliccia=m.pelliccia@mail.bbk.ac.uk
 Martino Pelli=martino.pelli@usherbrooke.ca
 Elisabetta Pellini=e.pellini@surrey.ac.uk
 Paolo Pellizzari=paolop@unive.it
 Alessandra Pelloni=alessandrapelloni@hotmail.com
 Gianluigi Pelloni=gianluigi.pelloni@gmail.com
 Gregory Pelnar=pelnar@lexecon.com
 Antoon Pelsser=a.pelsser@maastrichtuniversity.nl
 Leila Peltier - Ben Aoun=leila.ben-aoun@statec.etat.lu
 Tuomas Antero Peltonen=tuomas.peltonen@ecb.int
 Frederic Peltrault=frederic.peltrault@dauphine.fr
 Sam Peltzman=samp@uchicago.edu
 Adriana Peluffo=apeluffo@iecon.ccee.edu.uy
 Eugenio Peluso=eugenio.peluso@univr.it
 Mariano Peluso=mariano@marianopeluso.com
 Joseph Pelzman=jpelz@gwu.edu
 Diemuth E. Pemsl=dpemsl@gmx.net
 Ronald Jefferson Peña Aldazabal=rjeffersonp@hotmail.com
 Yolanda Pena-Boquete=y.penaboquete@uvigo.es
 Tonatiuh Pena Centeno=tonatiuh.pena.centeno@gmail.com
 Rodrigo Andrés de Souza Peñaloza=penaloza@unb.br
 Thierry Pénard=thierry.penard@univ-rennes1.fr
 María Fabiana Penas=m.penas@uvt.nl
 Julien Penasse=penasse@crans.org
 Ximena Peña=xpena@uniandes.edu.co
 John Leonard Pender=jpender@ers.usda.gov
 Michael Peneder=michael.peneder@wifo.ac.at
 Amy (Chen) Peng=apeng@ryerson.ca
 Chao Peng=economicsforyou@hotmail.com
 Cheng-Hau Peng=chpon@mail.fju.edu.tw
 Shin-Kun Peng=speng@econ.sinica.edu.tw
 Xiujian Peng=xiujian.peng@vu.edu.au
 Julien Pénin=penin@unistra.fr
 Luca Pennacchio=luca.pennacchio@gmail.com
 Christiano Modesto Penna=cmp@caen.ufc.br
 David A. Penn=dpenn@mtsu.edu
 Dieter Pennerstorfer=dieter.pennerstorfer@wifo.ac.at
 Daniele Pennesi=daniele.pennesi@u-cergy.fr
 Jeffrey Penney=penneyj@econ.queensu.ca
 Enrico Pennings=pennings@few.eur.nl
 Joost M.E. Pennings=joost.pennings@maastrichtuniversity.nl
 Anthony N. Pennington-Cross=anthony.pennington-cross@marquette.edu
 Alexis Penot=penot@gate.cnrs.fr
 Eric Penot=penot@cirad.fr
 Luca Pensieroso=luca.pensieroso@uclouvain.be
 Antonio Penta=apenta@ssc.wisc.edu
 Eric Pentecost=e.j.pentecost@lboro.ac.uk
 Jean-Sébastien Pentecôte=jean-sebastien.pentecote@unicaen.fr
 Lynne Pepall=lynne.pepall@tufts.edu
 Ioanna Sapfo Pepelasis=ioannasapfopepelasis@gmail.com
 Guido Pepermans=guido.pepermans@kuleuven.be
 Dominique Pépin=dominique.pepin@univ-poitiers.fr
 John V. Pepper=jvp3m@virginia.edu
 Franco Peracchi=franco.peracchi@uniroma2.it
 Vito Peragine=peragine.vito@gmail.com
 Sonja Melissa Perakis=perakiss@msu.edu
 Federico Perali=federico.perali@univr.it
 Adrian Peralta-Alva=aperaltaalva@gmail.com
 Susana Peralta=peralta@novasbe.pt
 Marco Percoco=marco.percoco@unibocconi.it
 Ari A. Perdana=ari.perdana@gmail.com
 Jordi Perdiguero=jordi.perdiguero@uab.cat
 Jorge Andrès Perdomo Calvo=jor-perd@uniandes.edu.co
 Andrés Perea=a.perea@maastrichtuniversity.nl
 Javier Pereda=javier.pereda@bcrp.gob.pe
 Alfredo Marvao Pereira=pereira770@aol.com
 Ana Pereira=arnpereira@bportugal.pt
 Carlos Pereira=carlos.pereira@fgv.br
 Luiz Awazu Pereira da Silva=luiz.apereira@bcb.gov.br
 Joao Paulo Cabral Pereira=joaopereira9@gmail.com
 Manuel Coutinho Pereira=mpereira@bportugal.pt
 Mauricio Pereira=mauriciopereiraf@gmail.com
 Orlando Petiz Pereira=orlandop@eeg.uminho.pt
 Paulo Jorge Pereira=pjpereira@fep.up.pt
 Paulo Trigo Pereira=ppereira@iseg.utl.pt
 Rafael Henrique Moraes Pereira=rafael.pereira@ipea.gov.br
 Renato N. Pereira=rnper@ualg.pt
 Robert Pereira=rpereira@vfmc.vic.gov.au
 Sandra Cristina Pereira=spereira@escs.ipl.pt
 Vitor Manuel Morais Pereira=vmpereira@iscal.ipl.pt
 Wellington Pereira=wdspereira@yahoo.com.br
 Xesús Pereira=xesus.pereira@usc.es
 Ana Carolina Pereira Zoghbi=zoghbi80@yahoo.com.br
 Jose Pereirinha=pereirin@iseg.utl.pt
 Oleksandr Perekhozhuk=perekhozhuk@iamo.de
 Josep Perelló=josep.perello@ub.edu
 Sergio Perelman=sergio.perelman@ulg.ac.be
 George Perendia=artilogica@btconnect.com
 Fernando Perera-Tallo=fperera@ull.es
 Joel Peress=joel.peress@insead.edu
 Stéphanie PERES=stephanie.peres@agro-bordeaux.fr
 Pietro F. Peretto=peretto@econ.duke.edu
 Yuri Perevalov=yuperev@yahoo.com
 Teodosio Perez-Amaral=teodosio@ccee.ucm.es
 Francisco Perez Bermejo=franciscoperez@kpmg.es
 Javier Perez Burgos=japebu@gmail.com
 Esteban Perez Caldentey=esteban.perez@cepal.org
 David Perez-Castrillo=david.perez@uab.es
 Coralie Perez=coralie.perez@univ-paris1.fr
 Fernando Pérez de Gracia=fgracia@unav.es
 Eduardo Perez-Richet=eduardo.perez@polytechnique.edu
 Fernando José Pérez Forero=fernando.perez@bcrp.gob.pe
 Francisco Perez=francisco.perez@ivie.es
 Jesús Claudio Pérez Gálvez=dt1pegaj@uco.es
 Javier J. Pérez García=javierperez@bde.es
 Julian Perez Garcia=julian.perez@uam.es
 Leonel Ramón Pérez-Hernández=lperez@quijote.ugto.mx
 José García Pérez=jgarcia@ual.es
 Gabriel Pérez Lance=ghpl@ucema.edu.ar
 Leonardo Pio Perez=leonardo.perez@bcb.gov.br
 Levi Perez=lperez@uniovi.es
 Ana Pérez-Luño=anaperezluno@upo.es
 Marcos Fabricio Perez=mperez@wlu.ca
 Jesús Pérez-Mayo=jperez@unex.es
 Arturo Perez Mendoza=arturo.perez@itesm.mx
 Pedro Jose Perez=pedro.j.perez@uv.es
 Jorge Eduardo Pérez Pérez=jorge_perez@brown.edu
 Rafaela Perez=rmperezs@ccee.ucm.es
 David Perez-Reyna=perez236@umn.edu
 Jessica Helen Pérez-Reynosa=jessicap@ns.uca.edu.ni
 Rigoberto Pérez=rigo@uniovi.es
 Jorge V. Pérez-Rodríguez=jvperez@dmc.ulpgc.es
 Hector Perez Saiz=hperezsaiz@bankofcanada.ca
 Fidel Perez Sebastian=fidel.perez.sebastian@gmail.com
 Stephen Perez=sjperez@csus.edu
 Francisco José Pérez torres, Sr.=francjperezt@gmail.com
 Ricardo Perez-Truglia=rtruglia@fas.harvard.edu
 Gerson Javier Pérez Valbuena=gjavierperezv@gmail.com
 Jhonatan Perez Villalobos=jperezvi@banrep.gov.co
 Yannick Perez=yannick.perez@u-psud.fr
 Amelia Pérez Zabaleta=aperez@cee.uned.es
 Andrés Peri=geduc@anep.edu.uy
 Filippo Maria Pericoli=filippo.pericoli@yahoo.it
 Marcello Pericoli=marcello.pericoli@bancaditalia.it
 Nicolas Peridy=nicolas.peridy@univ-tln.fr
 Giovanni Peri=gperi@ucdavis.edu
 Anaïs Périlleux=anais.perilleux@uclouvain.be
 Michele Perilli=mlperilli@gmail.com
 Grischa Sebastian Perino=grischa.perino@wiso.uni-hamburg.de
 Josep E. Peris=peris@ua.es
 Stavros Peristiani=steve.peristiani@ny.frb.org
 Markus Perkmann=markus.perkmann@gmx.net
 Jesse Perla=jesseperla@gmail.com
 José Francisco Perles Ribes=jose.perles@ua.es
 Marcelo Perlin=marceloperlin@gmail.com
 Samuel Mordecai Perlo-Freeman=perlo-freeman@sipri.org
 Risti Permani=risti.permani@adelaide.edu.au
 Cira Perna=perna@unisa.it
 Ernesto M. Pernia=ernestompernia@gmail.com
 Fernando Salgueiro Perobelli=fernando.perobelli@ufjf.edu.br
 Mathieu Perona=mathieu.perona@normalesup.org
 Chiara Peroni=chiara.peroni@statec.etat.lu
 Olivier PERON=olivier.peron@univ-pau.fr
 Javier Perote=perote@usal.es
 Juan Perote-Pena=jperote@unizar.es
 Enrico Perotti=e.c.perotti@uva.nl
 Roberto Perotti=roberto.perotti@unibocconi.it
 Stylianos Perrakis=sperrakis@jmsb.concordia.ca
 Jonathan Perraton=j.perraton@sheffield.ac.uk
 Jean-Louis PERRAULT=jean-louis.perrault@univ-rennes1.fr
 Adriaan Perrels=adriaan.perrels@fmi.fi
 Alessandra Perri=alessandra.perri@unive.it
 Chiara Perricone=chiara.perricone@gmail.com
 Philippe Perrier-Cornet=perrierp@supagro.inra.fr
 Fabrizio Perri=fperri@umn.edu
 Faustine Perrin=faustine.perrin@unistra.fr
 Richard Perrin=rperrin@unl.edu
 Tim Perri=perritj@gmail.com
 Benoit Perron=benoit.perron@umontreal.ca
 Emanuele Perrone=e_perrone@alice.it
 Giuseppe Perrone=g.perrone@unitus.it
 Marc Perronnin=perronnin@irdes.fr
 Pierre Perron=perron@bu.edu
 Anne Perrot=aperrot@mapp-economics.com
 Irene Perrote=irene.perrote@urjc.es
 Radhika Bhuyan Perrot=radhikap@mistra.org.za
 Serge PERROT=serge.perrot@dauphine.fr
 Janet E. Perry=janet.perry@wdc.usda.gov
 Len Perry=len.perry@uts.edu.au
 Motty Perry=m.m.perry@warwick.ac.uk
 Vanessa Gail Perry=vperry@gwu.edu
 Joseph Persky=jpersky@uic.edu
 Maria Persson=maria.persson@nek.lu.se
 Torsten Persson=torsten.persson@iies.su.se
 Damiaan Persyn=damiaan.persyn@ec.europa.eu
 Marcela Perticara=mperticara@uahurtado.cl
 Paolo Pertile=paolo.pertile@univr.it
 Cristiano Perugini=cristiano.perugini@unipg.it
 Anita Radman Peša=apesa@unizd.hr
 Ossi Pesämaa=ossi.pesamaa@bth.se
 M Hashem Pesaran=pesaran@usc.edu
 Elena Pesavento=epesave@emory.edu
 Andrea Pescatori=apescatori@imf.org
 Giovanni Pesce=giovanni_pesce@alice.it
 Marialaura Pesce=marialaura.pesce@unina.it
 Martin Pesendorfer=m.pesendorfer@lse.ac.uk
 Wolfgang Pesendorfer=pesendor@princeton.edu
 Raffaele Pesenti=pesenti@unive.it
 Radmilo Pesic=radmilo@sbb.rs
 Michael F. Pesko=mip2037@med.cornell.edu
 Huascar Fialho Pessali=pessali@ufpr.br
 Argentino Pessoa=apessoa@fep.up.pt
 Sofia Pessoa e Costa=sofia.pessoaecosta@uclouvain.be
 Nico Pestel=pestel@iza.org
 Pierre Pestieau=p.pestieau@ulg.ac.be
 Jeffrey Petchey=j.petchey@curtin.edu.au
 Emmanuel Peterle=emmanuel.peterle@univ-rennes1.fr
 William Peterman=william.peterman@gmail.com
 Amos C. Peters=amos.peters@uct.ac.za
 Bettina Peters=b.peters@zew.de
 H. Elizabeth Peters=ep22@cornell.edu
 Bruce Clayton Petersen=petersen@artsci.wustl.edu
 D'Ann Michele Petersen=dann.petersen@dal.frb.org
 Hans-Georg Petersen=hgpeter@rz.uni-potsdam.de
 Kenneth B. Petersen=arbitrageeconomics@yahoo.com
 Luba Petersen=lubap@sfu.ca
 Mitchell Petersen=mpetersen@northwestern.edu
 Tom Petersen=tomp@infra.kth.se
 Jean-Philippe Peters=jppeters@deloitte.lu
 Jörg Peters=peters@rwi-essen.de
 Michael Peters=peters@econ.ubc.ca
 Brian Peterson=petb@bankofcanada.ca
 Derek A. Peterson=derek_a_peterson@yahoo.com
 Jeffrey Mark Peterson=jpeters@ksu.edu
 Sonja Peterson=sonja.peterson@ifw-kiel.de
 Ryan Heath Peters=petersry@wharton.upenn.edu
 Joël Petey=joel.petey@unistra.fr
 Pethig=pethig@vwl.wiwi.uni-siegen.de
 Gianni Petino, Jr.=petinog@unict.it
 Emmanuel Petit=epetit@u-bordeaux4.fr
 Olivier PETIT=opetitfr@yahoo.fr
 Pascal Petit=pascal.petit@univ-paris13.fr
 Pascale PETIT=pascale.petit@univ-evry.fr
 Vladimir Petkov=vladimir.petkov@vuw.ac.nz
 Dimitris Petmezas=d.petmezas@surrey.ac.uk
 Carmelo Petraglia=carmelo.petraglia@unibas.it
 Emmanuel Petrakis=petrakis@econ.soc.uoc.gr
 Iaroslav Petrakov=yacherny@ukr.net
 Jeremy Petranka=petranka@email.unc.edu
 Ivan Petrella=i.petrella@bbk.ac.uk
 Despina Petreska=despina.petreska@financethink.mk
 Marjan Petreski=marjan.petreski@uacs.edu.mk
 Alessandro Petretto=alessandro.petretto@unifi.it
 Martin Petrick=petrick@iamo.de
 Dennis James Petrie=dennis.petrie@unimelb.edu.au
 Murray Petrie=mpetrie@ihug.co.nz
 Ragan Petrie=rpetrie1@gmu.edu
 Martin H. Petri=mpetri@imf.org
 Peter A. Petri=ppetri@brandeis.edu
 Daniel R. Petrolia=petrolia@agecon.msstate.edu
 Fotios Petropoulos=f.petropoulos@lancaster.ac.uk
 Dimitra Petropoulou=d.petropoulou@sussex.ac.uk
 Nicolas Petrosky-Nadeau=npn@cmu.edu
 Anastasia Petrou=apetrou@uop.gr
 Pavlos Petroulas=ppetroulas@bankofgreece.gr
 Kameliia Petrova=kpetr001@plattsburgh.edu
 Petia G. Petrova=petrova@bc.edu
 Alberto Rodolfo Petrucci=albpetru@luiss.it
 Robert John Petrunia=rpetruni@lakeheadu.ca
 Bohdan Petrushchak=b.petrushchak@gmail.com
 Athanasios Petsakos=t_petsakos@yahoo.gr
 Paolo Pettenati=p.pettenati@univpm.it
 Davide Pettenella=davide.pettenella@unipd.it
 Davide Pettenuzzo=dpettenu@brandeis.edu
 Jan Pettersson=jan.pettersson@nek.uu.se
 Per Pettersson-Lidbom=pp@ne.su.se
 Anna Pettini=pettini@unifi.it
 Yuri Pettinicchi=ypetti@unive.it
 Christian Peukert=christian.peukert@uzh.ch
 Jose-Luis Peydro=jose.peydro@gmail.com
 Urs C. Peyer=urs.peyer@insead.edu
 Kyle Peyton=kyle.peyton@unimelb.edu.au
 Paul Pezanis-Christou=paul.pezanis-christou@adelaide.edu.au
 Anne PEZET=anne.pezet@dauphine.fr
 John C. V. Pezzey=jack.pezzey@anu.edu.au
 Silvia Pezzini=silvia.pezzini@bankofengland.co.uk
 Mario Pezzino=mario.pezzino@manchester.ac.uk
 Luciano Pezzolo=pezzolo@unive.it
 Michael Pfaffermayr=michael.pfaffermayr@uibk.ac.at
 Lisa Pfahl=pfahl@hu-berlin.de
 Damjan Pfajfar=d.pfajfar@uvt.nl
 Gerard Pfann=g.pfann@maastrichtuniversity.nl
 Wade Donald Pfau=wadepfau@gmail.com
 Christian Pfeifer=pfeifer@leuphana.de
 Harald Pfeifer=harald.pfeifer@bibb.de
 Christoph Peter Pfeiffer=christoph_pfeiffer@yahoo.de
 Friedhelm Pfeiffer=pfeiffer@zew.de
 Marie Pfiffelmann=m.pfiffelmann@unistra.fr
 Christian Pfister=christian.pfister@banque-france.fr
 Ulrich Pfister=pfister@uni-muenster.de
 Carolin E. Pflueger=carolin.pflueger@sauder.ubc.ca
 Waldemar Pfoertsch=wapinfo@pfoertsch.de
 Klaus Pforr=klaus.pforr@gesis.org
 Tobias Pfutze=tpfutze@oberlin.edu
 Cong Si Pham=cpham@deakin.edu.au
 Hung Thai Pham=hungpt@neu.edu.vn
 Ngoc-Sang Pham=pns.pham@gmail.com
 Thi Hong Hanh PHAM=hanh.phamhong@gmail.com
 Thi Kim Cuong PHAM=kim.pham@unistra.fr
 Tra Thi Thu Pham=ptttra@hcmiu.edu.vn
 Thu Phuong Pham=thuphuong.pham@utas.edu.au
 Van Pham=van_pham@baylor.edu
 Diep Ngoc Phan=phand@beloit.edu
 Louis Phaneuf=phaneuf.louis@uqam.ca
 Sock-Yong Phang=syphang@smu.edu.sg
 Phillip H. Phan=pphans@gmail.com
 Phan Anh Tuấn (Tuan Anh Phan)=phantuan8@gmail.com
 Alexander Philipov=aphilipo@gmu.edu
 Dionisis Philippas=dionisis.philippas@essca.fr
 Nikolaos Philippas=philipas@unipi.gr
 Thomas PHILIPPON=tphilipp@stern.nyu.edu
 Apostolis Philippopoulos=aphil@aueb.gr
 Tassilo Philippovich=tassilo.philippovich@uibk.ac.at
 Tomas Philipson=t-philipson@uchicago.edu
 Ben Guy Phillips=ben.phillips@natsem.canberra.edu.au
 David Cameron Phillips=phillipsd@hope.edu
 Gordon M. Phillips=gordon.phillips@marshall.usc.edu
 Kerk Phillips=kerk_phillips@byu.edu
 Michelle Andrea Phillips=michellephillips@ufl.edu
 Peter C. B. Phillips=peter.phillips@yale.edu
 Richard D. Phillips=rphillips@gsu.edu
 Robert Phillips=rphil@gwu.edu
 Ronnie J. Phillips=ron@ronniejphillips.com
 Euan Phimister=e.phimister@abdn.ac.uk
 Alain Pholo Bala=apholo@uj.ac.za
 Yorgos N. Photis=yphotis@uth.gr
 Kate Phylaktis=k.phylaktis@city.ac.uk
 Davide Piacentino=davide.piacentino@unipa.it
 Massimiliano Piacenza=massimiliano.piacenza@unito.it
 Matías Piaggio=mpiaggio@iecon.ccee.edu.uy
 Maria Noel Pi Alperin=marianoel.pialperin@ceps.lu
 Dominique Pianelli=dominique.pianelli@cepii.fr
 Daniele Pianeselli=daniele.pianeselli@bancaditalia.it
 Giorgina Piani=giorgina@decon.edu.uy
 Andrea Piano Mortari=piano.mortari@economia.uniroma2.it
 Mario Pianta=mario.pianta@uniurb.it
 Mongkut Piantanakulchai=mongkutp@gmail.com
 Krzysztof Maciej Piasecki=k.piasecki@ue.poznan.pl
 Gwenael Piaser=gwenael.piaser@ipag.fr
 Dawid Piątek=dawid.piatek@ue.poznan.pl
 Marcin Piątkowski=mpiatek@kozminski.edu.pl
 Marco Piatti=m.piatti@qut.edu.au
 Daniel Piazolo=daniel.piazolo@googlemail.com
 Roberto Piazza=roberto.piazza@bancaditalia.it
 Monika Piazzesi=piazzesi@stanford.edu
 Nathalie Picard=nathalie.picard@u-cergy.fr
 Pierre M. Picard=pierre.picard@uni.lu
 Robert Picard=picard@netbox.com
 Marco Picariello=marco.picariello@le.infn.it
 Andres J. Picazo-Tadeo=andres.j.picazo@uv.es
 Matteo Picchio=matteopicchio@gmail.com
 Salvatore Piccolo=salvapiccolo@gmail.com
 Lise Pichette=lpichette@banqueducanada.ca
 Alois Pichler=alois.pichler@univie.ac.at
 Paul Pichler=paul.pichler@oenb.at
 Stefan Pichler=pichler@kof.ethz.ch
 Gabriela Cornelia Piciu=gabriela_piciu@yahoo.com
 Daniel Pick=dpick@ers.usda.gov
 Andrew C. Pickering=andrew.pickering@york.ac.uk
 Gabriel Picone=gpicone@usf.edu
 Mark Robert Picton=mark.picton@buseco.monash.edu.au
 Anne Morrison Piehl=apiehl@economics.rutgers.edu
 Paul Jay Pieper=pjpieper@uic.edu
 Justin R. Pierce=justin.r.pierce@frb.gov
 Raylene M. Pierce-Maberly=rpierce@deakin.edu.au
 Alessandro Piergallini=alessandro.piergallini@uniroma2.it
 Fabio Pieri=fabio.pieri@uv.es
 Luca Pieroni=lpieroni@unipg.it
 Allan Pierra Conde=apierra@yahoo.com
 Olivier Pierrard=olivier.pierrard@bcl.lu
 Gastón Pierri=pierr080@umn.edu
 Giovanni Piersanti=piersanti@unite.it
 Richard G. Pierse=richard.pierse@yahoo.com
 Anamaria Pieschacon=apiescha@stanford.edu
 Gina Christelle Pieters=gpieters@trinity.edu
 Rik Pieters=pieters@uvt.nl
 Raoul Pietersz=raoul@pietersz.org
 Laurent Piet=laurent.piet@rennes.inra.fr
 Tito Pietra=tito.pietra@unibo.it
 Carlo Pietrobelli=carlop@iadb.org
 Michal Pietrzak=pietrzak@umk.pl
 Maria Chiara Pievatolo=pievatolo@dsp.unipi.it
 Nadia F. Piffaretti=npiffaretti@worldbank.org
 Claudio Piga=claudio.piga@gmail.com
 Gustavo Piga=gustavo.piga@uniroma2.it
 Jeremy Piger=jpiger@uoregon.edu
 Ashley Piggins=ashley.piggins@nuigalway.ie
 John Piggott=j.piggott@unsw.edu.au
 Claudia Pigini=c.pigini@univpm.it
 Francesco Pigliaru=pigliaru@unica.it
 Giuseppe Pignataro=giuseppe.pignataro@unibo.it
 Norberto Pignatti=n.pignatti@iset.ge
 Facundo Piguillem=facundo.piguillem@gmail.com
 Josep Pijoan-Mas=pijoan@cemfi.es
 Thomas Piketty=piketty@ens.fr
 Dirk Pilat=dirk.pilat@oecd.org
 Mariola Pilatowska=mariola.pilatowska@umk.pl
 Vijayan Pillai=drpillai@yahoo.com
 Rajesh K. Pillania=r_pillania@yahoo.com
 Julien Pillot=julien.pillot@gredeg.cnrs.fr
 André Francisco Pilon=gaiarine@usp.br
 Luciano Pilotti=luciano.pilotti@unimi.it
 Giandomenico Piluso=piluso@unisi.it
 Nicolas Piluso=nicolas.piluso@iut-tlse3.fr
 Fernando Lobo Pimentel=fpimentel@bportugal.pt
 José Carlos González Pimienta=c.pimienta@unsw.edu.au
 Álvaro M. Pina=ampina@iseg.utl.pt
 Gilson Manuel Gomes Pina=gmgpina@eeg.uminho.pt
 Abuzer Pinar=abuzer.pinar@harran.edu.tr
 Mehmet Pinar=mehmet.pinar@edgehill.ac.uk
 Magali Pinat=mpinat@worldbank.org
 Pablo Pincheira=ppinchei@bcentral.cl
 Jonathan James Pincus=jjpincus@gmail.com
 Julio Pindado=pindado@usal.es
 Robert S. Pindyck=rpindyck@mit.edu
 Jose Pineda=jose.pineda@undp.org
 Pilar Piñeiro García=otremo@uvigo.es
 John Fraser Pinfold=j.f.pinfold@massey.ac.nz
 Jonathan Pingle=jpingle@verizon.net
 Mark Pingle=pingle@unr.edu
 Alessandro de Orlando Maia Pinheiro=alessandro.pinheiro@ibge.gov.br
 Ricardo Pinheiro-Alves=ricalv2003@yahoo.co.uk
 Antonio Cipriano Pinheiro=acap@uevora.pt
 Bruno Rodrigues Pinheiro, Sr.=brpinheiro@yahoo.com.br
 Diogo Pinheiro=dpinheiro@brooklyn.cuny.edu
 Maximiano Pinheiro=mpinheiro@bportugal.pt
 Roberto Benjamin Pinheiro=roberto.pinheiro@colorado.edu
 Carlos Pinho=cpinho@ua.pt
 Joana Pinho=jpinho@fep.up.pt
 Maria Manuel Pinho=mpinho@fep.up.pt
 Vicente Pinilla=vpinilla@unizar.es
 Paolo Pini=pnipla@unife.it
 Joshua C. Pinkston=josh.pinkston@louisville.edu
 Andrea Pinna=andrea.pinna@unibz.it
 Anna Maria Pinna=ampinna@unica.it
 Riccardo Pinna=riccardo.pinna@unica.it
 Sara Pinoli=sarapinoli@yahoo.it
 Paolo Pinotti=paolo.pinotti@unibocconi.it
 Paolo Pin=paolo.pin@unisi.it
 Jean Pinquet=jean.pinquet@polytechnique.edu
 Mihaela Iulia Pintea=pinteam@fiu.edu
 Ágnes Pintér=pinteragnes@gmail.com
 Miklós Pintér=miklos.pinter@uni-corvinus.hu
 Bruno José Marques Pinto=bruno@brunopinto.org
 Cristine Campos de Xavier Pinto=cristine.pinto@fgv.br
 Eduardo Costa Pinto=eduardopintobr@yahoo.com.br
 Hugo Pinto=hpinto@ualg.pt
 Santiago Miguel Pinto=santiago.pinto@rich.frb.org
 Juan Pintos-Clapés=jpc@uvigo.es
 Patrick Pintus=patrick.pintus@univ-amu.fr
 Florina Pinzaru=florina.pinzaru@facultateademanagement.ro
 Leny M Pinzon=lenypinzon@gmail.com
 Amedeo Stefano Piolatto=piolatto@gmail.com
 Marc Piopiunik=piopiunik@ifo.de
 Edward W. Piotrowski=qmgames@gmail.com
 Marco Piovesan=marco.piovesan@econ.ku.dk
 Onsurang Pipatchaipoom Norrbin=onorrbin@fsu.edu
 Alan T. Piper=alan.piper@uni-flensburg.de
 Mateusz Pipień=eepipien@cyf-kr.edu.pl
 Vito Pipitone=vito.pipitone@cnr.it
 Michael Pippenger=mkpippenger@alaska.edu
 Ingo Pippow=ingo2004@pippow.de
 Natalia Scotto Piqueira=natalia.piqueira@brattle.com
 Matloob Piracha=m.e.piracha@kent.ac.uk
 Patrizio Piraino=patrizio.piraino@uct.ac.za
 Gianfranco Piras=gpiras@mac.com
 Cesaltina Pacheco Pires=cpires@uevora.pt
 Jose Claudio Linhares Pires=joseclaudiop@verizon.net
 Viktor Pirmana=victorfirmana@yahoo.com
 Giuseppe Piroli=pirolig@gmail.com
 Francesco Pirone=frpirone@unina.it
 Alain PIROTTE=apirotte@aol.com
 Hugues E. Pirotte Speder=hugues.pirotte@ulb.ac.be
 Tommaso Pirotti=tommaso.pirotti@unimore.it
 Dante Monique Pirouz=dpirouz04@gsm.uci.edu
 Inske Pirschel=inske.pirschel@ifw-kiel.de
 Jukka Pirttilä=jukka.pirttila@uta.fi
 Elena Pisani=elena.pisani@unipd.it
 Jean Pisani-Ferry=jean.pisaniferry@gmail.com
 Massimiliano Pisani=massimiliano.pisani@gmail.com
 Michael J. Pisani=m.pisani@cmich.edu
 Lucia Piscitello=lucia.piscitello@polimi.it
 Grigory Pishchulov=grigory.pishchulov@udo.edu
 Erhan Pişkin=erhanpiskin@akdeniz.edu.tr
 Gilles Pison=pison@ined.fr
 Christopher A Pissarides=c.pissarides@lse.ac.uk
 Luigi Pistaferri=pista@stanford.edu
 Alfredo Pistelli=apistell@bcentral.cl
 Nicolas Pistolesi=nicolas.pistolesi@univ-tlse1.fr
 Barbara Pistoresi=barbara.pistoresi@unimore.it
 Jean-Yves Pitarakis=j.pitarakis@soton.ac.uk
 Christos Pitelis=c.pitelis@jbs.cam.ac.uk
 Hans Pitlik=hans.pitlik@wifo.ac.at
 M. Grazia Pittau=grazia.pittau@uniroma1.it
 Ingo Alexander Pitterle=pitterle@un.org
 Rosanna Pittiglio=r.pittiglio@unifg.it
 Nikitas Pittis=npittis@unipi.gr
 Russell Pittman=russell.pittman@usdoj.gov
 Mark M. Pitt=mark_pitt@brown.edu
 Melinda Pitts=melinda.pitts@atl.frb.org
 Mariacristina Piva=mariacristina.piva@unicatt.it
 Marcus Pivato=marcuspivato@gmail.com
 Georgina Vanesa Pizzolitto=gpizzolitto@yahoo.com.ar
 Fabio Pizzutilo=fabio.pizzutilo@uniba.it
 Giorgio Pizzutto=giorgio.pizzutto@unimi.it
 Gábor P.Kiss=kissg@mnb.hu
 Frank Place=f.place@cgiar.org
 Laetitia Placido=laetitia.placido@univ-paris1.fr
 Anke C. Plagnol=anke.plagnol.1@city.ac.uk
 Jens Plahte=jens@plahte.info
 Vasilios Plakandaras=billplakandaras@gmail.com
 Christophe Planas=christophe.planas@jrc.it
 Frédéric PLANCHET=fred@planchet.net
 Patrick Plane=p.plane@u-clermont1.fr
 Michael Plante=michael.plante@dal.frb.org
 L. Christopher Plantier=chris.plantier@ici.org
 Auke Plantinga=a.plantinga@rug.nl
 David Pla-Santamaria=dplasan@esp.upv.es
 Robert Alain Plasman=rplasma@ulb.ac.be
 Joseph E. Plasmans=plasmans@uvt.nl
 Hilke Plassmann=hilke.plassmann@insead.edu
 Marco Platania=marco.platania@unict.it
 Leobardo Plata Pérez=lplata@uaslp.mx
 Carl G. Plat=cplat@yahoo.com
 Eckhard Platen=eckhard.platen@uts.edu.au
 Silvia Platoni=silvia.platoni@unicatt.it
 Jean-Philippe Platteau=jean-philippe.platteau@fundp.ac.be
 Daniel Platz=platz@un.org
 Beatriz Plaza=beatriz.plaza@ehu.es
 Sonia Plaza=splaza@worldbank.org
 Monica Plechero=mplechero@gmail.com
 Miana Plesca=miplesca@uoguelph.ca
 Joachim Plesch=joachim.plesch@uni-konstanz.de
 Evgenij Pliseckij=epliseckij@hse.ru
 Florian Ploeckl=florian.ploeckl@adelaide.edu.au
 Charles I. Plosser=charles.plosser@phil.frb.org
 Matthew Charles Plosser=matthew.plosser@ny.frb.org
 Adam Ploszaj=a.ploszaj@uw.edu.pl
 Michael Robert Plotzke=mplotzke@wustl.edu
 Andre Plourde=andre_plourde@carleton.ca
 Erik Plug=e.j.s.plug@uva.nl
 Michael G. Plummer=mplummer@jhubc.it
 Anne Plunket=anne.plunket@univ-lorraine.fr
 Yuliya Plyakha=yuliya.plyakha@uni.lu
 Dorina Poanta=dorina.poanta@ufb.ro
 Diana-Mihaela Pociovalisteanu=diana.pociovalisteanu@gmail.com
 Sougata Poddar=spoddar@aut.ac.nz
 Kaire Põder=kaire.poder@ttu.ee
 Marion Podesta=marion.podesta@univ-savoie.fr
 Silvia Podetti=s.podetti@ds.unifi.it
 Jan M. Podivinsky=jmp@soton.ac.uk
 Mark Podolskij=mpodolskij@creates.au.dk
 Richard Podpiera=richard.podpiera@seznam.cz
 Geert Poels=geert.poels@ugent.be
 Eva E. Poen=e.poen@exeter.ac.uk
 Friedrich Poeschel=friedrich.poeschel@googlemail.com
 Josef Poeschl=josef.s.poeschl@gmail.com
 Sara Poggesi=poggesi@economia.uniroma2.it
 Ambra Poggi=ambra.poggi@unimib.it
 Sanjib Pohit=spohit@nistads.res.in
 Matti Pohjola=matti.pohjola@aalto.fi
 Winfried Pohlmeier=winfried.pohlmeier@uni-konstanz.de
 Ion Pohoata=pion@uaic.ro
 Céline Poilly=celine.poilly@unil.ch
 Gwénaëlle Poilpot-Rocaboy=gwenaelle.poilpot-rocaboy@univ-ubs.fr
 François Poinas=francois.poinas@tse-fr.eu
 Evelyne Poincelot=evelyne.poincelot@u-bourgogne.fr
 Philippe Poinsot=philippe.poinsot@univ-paris1.fr
 Charlotte Pointon=pointonca@cardiff.ac.uk
 Bernard Poirine=bernard.poirine@upf.pf
 Aurélien Poissonnier=aurelien.poissonnier@insee.fr
 Michel Poitevin=michel.poitevin@umontreal.ca
 Geoffrey Poitras=poitras@sfu.ca
 Elena Pokatovich=epokatovich@hse.ru
 Jan Pokrivcak=jpokrivcak@yahoo.com
 Artur Pokropek=artur.pokropek@gmail.com
 Sašo Polanec=saso.polanec@ef.uni-lj.si
 Sandra Polanía-Reyes=spolaniareyes@unisi.it
 Jiří Polanský=jpolansky@csas.cz
 Özgür Polat=zgrplt@hotmail.com
 Sezgin Polat=sezginpolat@gmail.com
 Tandogan Polat=tandogan.polat@tcmb.gov.tr
 Javier Polavieja=javier.polavieja@uc3m.es
 Mattias K Polborn=polborn@uiuc.edu
 Oleg Poldin=opoldin@hse.ru
 Franzi Poldy=franzi.poldy@csiro.au
 Herakles Polemarchakis=h.polemarchakis@warwick.ac.uk
 Michael Leonidas Polemis=mpolemis@epant.gr
 Frederico Poley Martins Ferreira=poley@hotmail.com
 Linnea Ann Polgreen=linnea-polgreen@uiowa.edu
 Cain Polidano=cainp@unimelb.edu.au
 Vassilis Polimenis=polimenis@econ.auth.gr
 A. Mitchell Polinsky=polinsky@stanford.edu
 Veronica Polin=veronica.polin@univr.it
 Matthew Polisson=matthew.polisson@le.ac.uk
 Ricardo Politi=ricardo.politi@ufabc.edu.br
 Andreas Polk=polk@hwr-berlin.de
 Valery Polkovnichenko=polkovn@utdallas.edu
 Catherine POLLAK=catherine.pollak@sante.gouv.fr
 Robert A. Pollak=pollak@wustl.edu
 David Pollard=d.j.pollard@leedsmet.ac.uk
 Patricia Pollard=patricia.pollard@treasury.gov
 Angiola Pollastri=angiola.pollastri@unimib.it
 William J. Polley=wj-polley@wiu.edu
 Günther Pöll=guenther.poell@jku.at
 Chiara Pollio=chiara.pollio@gmail.com
 Michael Gerald Pollitt=m.pollitt@jbs.cam.ac.uk
 Peter Pollmeier=10pepo@wiwi.uni-muenster.de
 David Stephen Pollock=stephen_pollock@sigmapi.u-net.com
 Rufus Pollock=rufus.pollock@okfn.org
 Antoneta Polo=neta_polo@yahoo.com
 Philippe Polome=polome@gate.cnrs.fr
 Michele Polo=michele.polo@unibocconi.it
 Helen Poltimae=helen.poltimae@ut.ee
 Maksym Polyakov=maksym.polyakov@uwa.edu.au
 Alexandros Polycarpou=polycarpou@ucy.ac.cy
 Angelo Polydoro=polydoro@gmail.com
 Carlos Pombo=cpombo@uniandes.edu.co
 Aude Pommeret=aude.pommeret@unil.ch
 Sébastien Pommier=sebastien.pommier@univ-rennes1.fr
 Fabrizio Pompei=fabrizio.pompei@unipg.it
 Aldo Fernando Ponce=aldo.ponce@cide.edu
 Carlos J. Ponce=cjponcebruera@gmail.com
 Carmen Ponce=cponce@grade.org.pe
 Jorge PONCE=jponce@bcu.gub.uy
 Sandra Poncet=sandra.poncet@univ-paris1.fr
 Gina Poncini=gina.poncini@unimi.it
 Eduard Ponds=eduard.ponds@apg.nl
 Roderik Ponds=roderikponds@hotmail.com
 Roland Pongou=rpongou@uottawa.ca
 Grzegorz Poniatowski=grzegorz.poniatowski@case-research.eu
 Delma Binti Poniman=delma@utm.my
 Clara Ponsati=clara.ponsati@iae.csic.es
 Emilie PONS=emilie.pons@sciences-po.org
 Gabriel Pons=gpr@sfi.dk
 Jean-Pierre Ponssard=jean-pierre.ponssard@polytechnique.edu
 José Pedro Pontes=ppontes@iseg.utl.pt
 Gregory Ponthiere=gregory.ponthiere@ens.fr
 Sophie Ponthieux=sophie.ponthieux@insee.fr
 Jacopo Ponticelli=jacopo.ponticelli@chicagobooth.edu
 Dario Pontiggia=d.pontiggia@nup.ac.cy
 Giovanni Ponti=giuba@ua.es
 Dimitrios Pontikakis=dimitrios.pontikakis@gmail.com
 Victor Pontines=vpontines@adbi.org
 Ferruccio Ponzano=fponzano@sp.unipmn.it
 Giacomo A. M. Ponzetto=gponzetto@crei.cat
 Michela Ponzo=michela.ponzo@unina.it
 William Poole=gswpoole@sprintmail.com
 Wai-Ching Poon=wcpoon25@yahoo.com
 Catalin C. Popa=catalin.popa@hotmail.com
 Ioan Popa=ioan.popa.rei@gmail.com
 Ciprian Marcel Pop=marcel.pop@econ.ubbcluj.ro
 Ioana Crina Pop Cohut=ipop@uoradea.ro
 Cristiana Lucretia Pop=crispotir@yahoo.com
 Jeffery Pope=jeff.pope@cbs.curtin.edu.au
 Cristian Popescu=cristiancpopescu@yahoo.com
 Dumitru Dan Popescu=dandpopescu@yahoo.com
 Ioana Cecilia Popescu=ioana.popescu@mk.ase.ro
 Ramona Florina POPESCU=rf.popescu@yahoo.com
 Marcos Poplawski-Ribeiro=mpoplawskiribeiro@imf.org
 Gurleen Popli=g.popli@sheffield.ac.uk
 Alexander Popov=alexander.popov@ecb.europa.eu
 Vera Popova=popova@econ.mpg.de
 Ioana Popovici=ioana.popovici@nova.edu
 Milenko Popovic=cis.um@t-com.me
 Sergey V. Popov=sergeyvpopov@gmail.com
 Vladimir Popov=vpopov@nes.ru
 Monica Ioana Pop-Silaghi=monica.pop@econ.ubbcluj.ro
 Ponpoje Porapakkarm=ponpojep@umac.mo
 Francesco Porcelli=fporcelli78@gmail.com
 Daniele Porcheddu=daniele@uniss.it
 Sylvaine Poret=sylvaine.poret@ivry.inra.fr
 Donatella Porrini=donatella.porrini@unisalento.it
 Alexandre Alves Porsse, Sr.=porsse@gmail.com
 Marcio Telles Portal=mtportal@unisinos.br
 Pier Luigi Porta=pierluigi.porta@unimib.it
 Miguel Portela=mangelo@eeg.uminho.pt
 Brian Portelli=brian.portelli.mail@gmail.com
 Catherine Porter=catherine.porter@hw.ac.uk
 Lynda Anne Porter=l.porter@bath.ac.uk
 Richard Portes=rportes@london.edu
 Franck Portier=franck.portier@tse-fr.eu
 Yolanda Portilla=yportill@yahoo.com
 Claus Pörtner=cportner@seattleu.edu
 António Portugal Duarte=portugal@fe.uc.pt
 Alberto Portugal-Perez=aportugalperez@worldbank.org
 Arturo C. Porzecanski=aporzeca@american.edu
 Carlos Esteban Posada=carlos.posada.p@gmail.com
 Markus Poschke=markus.poschke@mcgill.ca
 Jenny Poschmann=jenny.poschmann@uni-jena.de
 Martin Posch=martin.posch@meduniwien.ac.at
 Olaf Posch=olaf.posch@uni-hamburg.de
 Peter N. Posch=pposch@uni-ulm.de
 Petra Posedel=pposedel@zsem.hr
 Adam S. Posen=aposen@piie.com
 Richard A. Posner=richard_posner@ca7.uscourts.gov
 Alex Possajennikov=alex.possajennikov@nottingham.ac.uk
 Daniel Possenriede=d.possenriede@uu.nl
 Alberto Posso=alberto.posso@rmit.edu.au
 Christian Manuel Posso=cpossosu@gmail.com
 Bayu Taufiq Possumah=btaufiq@gmail.com
 Luminita Postelnicu=luminita.postelnicu@ulb.ac.be
 Fabien Postel-Vinay=f.postel-vinay@ucl.ac.uk
 Erik Post=post.erik@gmail.com
 Andrew Postlewaite=apostlew@econ.upenn.edu
 Peter Postl=p.postl@bath.ac.uk
 Thierry Post=thierrypost@hotmail.com
 Thomas Post=t.post@maastrichtuniversity.nl
 Elena Potapchik=epotapchik@hse.ru
 Jarosław POTERAJ=poteraj@gmail.com
 James Poterba=poterba@mit.edu
 David Pothier=dpothier@diw.de
 Bianca Maria POTI=b.poti@ceris.cnr.it
 Valerio Potì=valerio.poti@dcu.ie
 Niklas Potrafke=potrafke@ifo.de
 Benedikt M Pötscher=benedikt.poetscher@univie.ac.at
 Simon Potter=simon.potter@ny.frb.org
 Marc Potters=marc.potters@science-finance.fr
 Jason Potts=jason.potts@rmit.edu.au
 Jagdish Poudel=jzp0046@auburn.edu
 Rahmatallah Poudineh=rahmatallah.poudineh@durham.ac.uk
 Jean-Christophe Poudou=jpoudou@univ-montp1.fr
 Jean Guillaume Poulain=jean-guillaume.poulain@banque-france.fr
 Konstantinos Pouliakas=konstantinos.pouliakas@cedefop.europa.eu
 Sebastien Pouliot=pouliot@iastate.edu
 Anders Poulsen=a.poulsen@uea.ac.uk
 Lauge Skovgaard Poulsen=l.n.poulsen@lse.ac.uk
 Odile Poulsen=o.poulsen@uea.ac.uk
 Panayiotis M. Pourpourides=pourpouridesp@cardiff.ac.uk
 Marc Pourroy=mpourroy@gmail.com
 Jean-Christophe Poutineau=jean-christophe.poutineau@univ-rennes1.fr
 Panu Poutvaara=poutvaara@ifo.de
 Guillaume POUYANNE=pouyanne@u-bordeaux4.fr
 Paul Povel=povel@uh.edu
 Laura Povoledo=laura.povoledo@uwe.ac.uk
 Nattavudh Powdthavee=n.powdthavee@lse.ac.uk
 Owen Raymond Powell=opowell+work@gmail.com
 Dominic Power=dominic.power@kultgeog.uu.se
 Mauricio Power=power_lm@up.edu.pe
 Daniel Powers=dpowers@austin.utexas.edu
 Elizabeth T. Powers=epowers@illinois.edu
 Simon Power=simon_power@carleton.ca
 Michael R. Powers=powers@sem.tsinghua.edu.cn
 Rachel A J Pownall (Campbell)=r.pownall@maastrichtuniversity.nl
 Susan Pozo=susan.pozo@wmich.edu
 Dario Pozzoli=dpozzoli@asb.dk
 Alberto Franco Pozzolo=pozzolo@unimol.it
 Martin Prachowny=martinp@econ.queensu.ca
 Marcin Pawel Pracz=marcin.pracz@interia.pl
 Albino Prada Blanco=aprada@uvigo.es
 Juan David Prada Sarmiento=jdprada@u.northwestern.edu
 Sergio I. Prada=siprada@proesa.org.co
 Jacqueline Pradel=pradelj@univ-paris1.fr
 Jaya Prakash Pradhan=pradhanjayaprakash@gmail.com
 Kailash C. Pradhan=kailasheco@gmail.com
 Kanhu Charan Pradhan=kcpradhan@cprindia.org
 Menno Prasad Pradhan=mpradhan@feweb.vu.nl
 Raj Kishor Pradhan=rajkishor81@gmail.com
 Samir Ranjan Pradhan=pradhan.samir75@gmail.com
 Pierre-Charles M. Pradier=pierre-charles.pradier@univ-paris1.fr
 Rimawan Pradiptyo=rimawan@gadjahmada.edu
 Eleuterio F S Prado=eleuter@usp.br
 Jose Mauricio Prado, Jr.=mp.eco@cbs.dk
 Tito Dimas Pradono=pradono.tito@fe.unpad.ac.id
 Camilo Prado-Roman=cpradoroman@gmail.com
 Leandro Prados de la Escosura=leandro.prados.delaescosura@uc3m.es
 Barbara Praetorius=bpraetorius@gmx.de
 Ioannis Chrysostomos Pragidis=gpragkid@ierd.duth.gr
 P. Anand Babu=prakashamanand@yahoo.com
 Geetha Rani Prakasam=geethselva@gmail.com
 Arun J. Prakash=prakasha@fiu.edu
 Brahm Prakash=brahm@pldtdsl.net
 Nishith Prakash=nishith.prakash@uconn.edu
 Ilya Prakhov=ipra@inbox.ru
 Dr. Surapati Pramanik=sura_pati@yahoo.co.in
 Doris Prammer=doris.prammer@gmx.at
 Marcus Pramor=pramor@ifk-cfs.de
 Nicolas PRAQUIN=nicolas.praquin@u-psud.fr
 Giovanni Prarolo=giovanni.prarolo@unibo.it
 Biman Chand Prasad=prasad_bc@usp.ac.fj
 Eswar Prasad=eswar.prasad@cornell.edu
 Kislaya Prasad=kprasad@rhsmith.umd.edu
 Suraj Prasad=suraj.prasad@sydney.edu.au
 bernard Pras=bernard.pras@dauphine.fr
 A Prasetyantoko=prasetyantoko@gmail.com
 Henriette Prast=h.m.prast@uvt.nl
 Dedy Dwi Prastyo=prastyod@hu-berlin.de
 Sangeeta Pratap=sangeeta.pratap@hunter.cuny.edu
 Georges Prat=glprat@free.fr
 Julien Prat=julien.prat@ensae.fr
 Wahyu Ario Pratomo=wahyu@usu.ac.id
 Jonathan Pratschke=jpratschke@unisa.it
 María Asunción Prats=mprats@um.es
 Ionela Cristina Pravat=crisspra@yahoo.com
 Lenka Přečková=preckova@opf.slu.cz
 Gabriela Predosanu=gpredosanu@incsmps.ro
 Arkadi Predtetchinski=a.predtetchinski@maastrichtuniversity.nl
 Raphaële Préget=preget@supagro.inra.fr
 Sören Preibusch=soren.preibusch@cl.cam.ac.uk
 Gamini Premaratne=gamini.premaratne@ubd.edu.bn
 David Prentice=d.prentice@latrobe.edu.au
 Andrea Filippo Presbitero=a.presbitero@univpm.it
 Edward Simpson Prescott=edward.prescott@rich.frb.org
 Ernst Presman=presman@cemi.rssi.ru
 Kerstin Press (fm Wolter)=kerstin.press@gmail.com
 Bruce Preston=bruce.preston@monash.edu
 Ian Peter Preston=i.preston@ucl.ac.uk
 Ross S Preston=rpreston@storm.ca
 Rosita Pretaroli=pretaroli@unimc.it
 Klaus Prettner=klaus.prettner@wiwi.uni-goettingen.de
 Martha Judith Prevezer=m.j.prevezer@qmul.ac.uk
 Claudius Preville=cpreville@gmail.com
 Curtis R. Price=crprice1@usi.edu
 Gregory Price=gprice@morehouse.edu
 Joseph Price=joe_price@byu.edu
 Joshua A. Price=japrice@uta.edu
 Michael K. Price=mprice25@gsu.edu
 Simon Price=s.g.price@city.ac.uk
 James E. Prieger=james.prieger@pepperdine.edu
 Christoph Priesmeier=christoph.priesmeier@bmf.bund.de
 Michael J. Pries=mpries@nd.edu
 Corwin Priest=corwinpriest@gmail.com
 Richard Priestley=richard.priestley@bi.no
 Mercedes Prieto-Alaiz=prietoal@eaee.uva.es
 Esteban Prieto=esteban.prieto@bundesbank.de
 Juan Prieto-Rodriguez=juanprieto@uniovi.es
 Manuela Prieto-Rodríguez=mprirod@upo.es
 William Orlando Prieto=william_prt@yahoo.com
 Fabien Prieur=prieur@supagro.inra.fr
 Jean-Luc Prigent=jean-luc.prigent@u-cergy.fr
 Annalisa Primi=annalisa.primi@oecd.org
 Giorgio Primiceri=g-primiceri@northwestern.edu
 Jeffrey T. Prince=jeffprin@indiana.edu
 Michael Princ=mp.princ@seznam.cz
 Diego Prior=diego.prior@uab.es
 Alexander V. Prishchepov=prishchepov@gmail.com
 Richard Paul Prisinzano=richard.prisinzano@do.treas.gov
 Jonathan Pritchett=jprit@tulane.edu
 Lant Pritchett=lant_pritchett@hks.harvard.edu
 Fabio Privileggi=fabio.privileggi@unito.it
 Anhar Fauzan Priyono=fauzan@fe.unpad.ac.id
 Vivien Procher=procher@uni-wuppertal.de
 Mariusz Próchniak=mproch@sgh.waw.pl
 Igor Vieira Procópio=igorvprocopio@gmail.com
 Wendy Proctor=wendy.proctor@gmail.com
 Ruxandra Prodan=rprodan@uh.edu
 Isabel Proença=isabelp@iseg.utl.pt
 Antonios Proestakis=aproestakis@ugr.es
 Adriano Profeta=adriano@adriano-profeta.de
 Paola Profeta=paola.profeta@unibocconi.it
 Tommaso Proietti=tommaso.proietti@uniroma2.it
 Marcel Prokopczuk=marcel.prokopczuk@zu.de
 Jacek Prokop=jacek.prokop@sgh.waw.pl
 Michel Prombo=michel.prombo@statec.etat.lu
 Todd Andrew Prono=tprono@american.edu
 Chiara Daniela Pronzato=chiaradaniela.pronzato@unito.it
 Liliana Nikolaevna Proskuryakova=lproskuryakova@hse.ru
 Lorenzo Prosperi=lorenzo.prosperi@tse-fr.eu
 Francesco Prota=francesco.prota@uniba.it
 Eugenio Proto=e.proto@warwick.ac.uk
 Mattheos K. Protopapas=mantzos.protopapas@hotmail.com
 Camelia Protopopescu=camelia.protopopescu@inserm.fr
 Steven Proud=steven.proud@bris.ac.uk
 Victoria Prowse=vlp33@cornell.edu
 Gerald J. Pruckner=gerald.pruckner@jku.at
 Maja Prudzienica=maja.prudzienica@ue.wroc.pl
 Jens Prüfer=j.prufer@uvt.nl
 Patricia Prufer=p.prufer@uvt.nl
 Seth Pruitt=seth.j.pruitt@frb.gov
 Stephen W. Pruitt=pruittst@umkc.edu
 Suthawan Prukumpai=suthawan.pruk@gmail.com
 Thomas J. Prusa=prusa@econ.rutgers.edu
 Wojtek Przepiorka=wojtek.przepiorka@sociology.ox.ac.uk
 Jan Przystupa=jan.przystupa@nbp.pl
 George Psacharopoulos=gpsach@rcn.com
 Demetrios Psaltopoulos=dempsa@upatras.gr
 Zacharias Psaradakis=z.psaradakis@bbk.ac.uk
 Maria PSILLAKI=psillaki@unipi.gr
 Srinivasan P=srinivasaneco@gmail.com
 Chin-Hong Puah=chpuah@feb.unimas.my
 Luis A. Puch=lpuch@ccee.ucm.es
 Stefano Puddu=stefano.puddu@unine.ch
 Frédéric Puech=frederic.puech@gmail.com
 Gilles Puel=gilles.puel@univ-tlse2.fr
 Esteban Puentes=epuentes@fen.uchile.cl
 Fernando Pueyo=fpueyo@unizar.es
 Diego Puga=diego.puga@cemfi.es
 Amedeo Pugliese=amedeo.pugliese@unina.it
 Maurizio Pugno=m.pugno@unicas.it
 Benjamin Wild Pugsley=benjamin.pugsley@gmail.com
 Silvia Puiu=silviapuiu@yahoo.com
 Pau Salvador Pujolas=pau@pujolasfons.com
 Francesc Pujol=fpujol@unav.es
 Jairo Hernando Pulecio Franco=jairopuleciofranco@yahoo.es
 Jose David Pulido=jdpulidop@unal.edu.co
 Antonio Pulido San Roman=antonio.pulido@uam.es
 Manuela Pulina=mpulina@uniss.it
 Pietro Pulina=ppulina@uniss.it
 Steven L. Puller=puller@econmail.tamu.edu
 Madhavi Pundit=mpundit@adb.org
 Maria Teresa Punzi=punzi@bc.edu
 Antonio Punzo=antonio.punzo@unict.it
 Giovanni Walter Puopolo=giovanni.puopolo@unibocconi.it
 Valeria Pupo=valeria.pupo@unical.it
 Clemens Dieter Puppe=clemens.puppe@kit.edu
 Victor Lorin Purcarea=victor.purcarea@gmail.com
 Ionut Purica=puricai@yahoo.com
 Victoria Purice=victoria.purice@ugent.be
 Francesco Purificato=francesco.purificato2@unina.it
 Jyotsna Puri=jpuri@3ieimpact.org
 Muhamad Purnagunawan=mpurnagunawan@gmail.com
 Dr. Pallav Purohit=pallav1976@yahoo.co.in
 Toralf Pusch=toralf-pusch@boeckler.de
 Helen Pushkarskaya=helen.pushkarskaya@yale.edu
 Tatiana A. Pustovalova=pustovalova_t@gsom.pu.ru
 Louis Putterman=louis_putterman@brown.edu
 Claudio Castelo Branco Puty=dep.claudioputy@camara.gov.br
 Damien PUY=damien.puy@eui.eu
 M. Socorro Puy=mps@uma.es
 Daniela Puzzello=dpuzzell@indiana.edu
 Laura Puzzello=laura.puzzello@monash.edu
 Andreas Pyka=a.pyka@uni-hohenheim.de
 Артем Геннадьевич Пылин (Artem Gennad'evich Pylin)=artem-pylin@yandex.ru
 Vladimir Pyrlik=vnpyrlik@hse.ru
 Krzysztof Pytka=krzysztof.pytka@eui.eu
 Ernest Pytlarczyk=ernestp@o2.pl
 Mariola Pytlikova=jola.pytlikova@gmail.com
 Ju Hyun Pyun=juhnpyun@gmail.com
