 Nur Zaimah Ubaidillah=unzaimah@feb.unimas.my
 Paloma Ubeda=paloma.ubeda@ehu.es
 Teodora Erika Uberti=erika.uberti@unicatt.it
 Diego Javier Ubfal=diego.ubfal@unibocconi.it
 Angel Ubide=aubide@piie.com
 David Ubilava=david.ubilava@sydney.edu.au
 Jan Ubøe=jan.uboe@nhh.no
 Okyay Ucan=okyayu@hotmail.com
 Nuri Ucar=unuri33@gmail.com
 David Uclés Aguilera=ducles@cajamar.com
 Merih A. Uctum=muctum@gc.cuny.edu
 Remzi Uctum=uctum@u-paris10.fr
 Ramazan Uctu=uctu@yahoo.com
 Gazi Salah Uddin=gazi.salah.uddin@liu.se
 Gregory Udell=gudell@indiana.edu
 Frederic Udina=frederic.udina@upf.edu
 Mioara Udrica=udrica@gmail.com
 Christopher Udry=christopher.udry@yale.edu
 Martin Uebele=m.uebele@rug.nl
 Silke Uebelmesser=silke.uebelmesser@uni-jena.de
 Kazuo Ueda=ueda@e.u-tokyo.ac.jp
 Kenichi Ueda=kueda@imf.org
 Masako Ueda=m-ueda@northwestern.edu
 Yasushi Ueki=yasushi.ueki@eria.org
 Tomoyuki Uemiya=uemiya@osaka-ue.ac.jp
 Iichiro Uesugi=uesugi-iichiro@rieti.go.jp
 Aneta Ufert=ufert@europa-uni.de
 Darwin Ugarte Ontiveros=dugarte@udape.gob.bo
 Elisa Ughetto=elisa.ughetto@lep.polito.it
 Stefano Ugolini=stefano.ugolini@univ-tlse1.fr
 Erginbay Uğurlu=erginbayugurlu@hitit.edu.tr
 Mehmet Ugur=m.ugur@gre.ac.uk
 Johannes Uhde=johannes.uhde@uni-wuerzburg.de
 Arne Uhlendorff=uhlendorff@uni-mannheim.de
 Dr. Gerald Roger Uhlich=gerald.uhlich@dr-uhlich.com
 Harald Uhlig=huhlig@uchicago.edu
 Matthias Uhl=matthias.uhl@wiwi.uni-marburg.de
 Fatos Ukaj=fatos_ukaj@yahoo.com
 Kadri Ukrainski=kadri.ukrainski@ut.ee
 Neslihan Uler=neslihan@umich.edu
 Faruk Ülgen=ulgen.faruk@upmf-grenoble.fr
 John Mususa Ulimwengu=julimwengu@cgiar.org
 Aydogan Ulker=ulker@deakin.edu.au
 Levent Ülkü=levent.ulku@itam.mx
 Irfan Ullah=irfanecon@gmail.com
 Eskil Ullberg=eskil.ullberg@gmail.com
 Katrin Ullrich=katrinullrich.mail@googlemail.com
 Philippe Ulmann=philippe.ulmann@cnamts.fr
 Mustafa Ulus=mulus@gsu.edu.tr
 Veysel Ulusoy=vulusoy@bahcesehir.edu.tr
 Gabriel Lopes de Ulyssea=gabriel.ulyssea@ipea.gov.br
 Chieko Umetsu=umetsu@nagasaki-u.ac.jp
 Stanislaw Uminski=uminski@univ.gda.pl
 Gerardo Martin Uña=gerardo.una@gmail.com
 Deniz Ünal=deniz.unal@cepii.fr
 Hasan Unal=hasan.unal@teb.com.tr
 Deren Unalmis=deren.unalmis@tcmb.gov.tr
 Ibrahim Unalmis=ibrahim.unalmis@tcmb.gov.tr
 Umut Unal=unalumut@gmail.com
 Takashi Unayama=unayama@ier.hit-u.ac.jp
 Bulent Unel=bunel@lsu.edu
 Maurício Yoshinori Une=uneyoshi@hotmail.com
 Laura Ungureanu=ungureanul71@yahoo.com
 Ilter Ünlükaplan=ikaplan@cu.edu.tr
 Laurian June Unnevehr=lunnevehr@gmail.com
 D. Filiz Unsal=dunsal@imf.org
 Hilmi Ünsal=unsal.hilmi@gmail.com
 A. Sinan Ünür=asu1@cornell.edu
 Kamal Upadhyaya=kupadhyaya@newhaven.edu
 Mukti Upadhyay=mpupadhyay@eiu.edu
 mulakala UPENDER=mupender10@rediffmail.com
 Yogesh Uppal=yuppal@ysu.edu
 Gregory B. Upton, Jr.=gupton3@tigers.lsu.edu
 Richard Upward=richard.upward@nottingham.ac.uk
 Takuya Urakami=urakami@bus.kindai.ac.jp
 Beyza Ural Marchand=beyza.ural@ualberta.ca
 Shujiro Urata=surata@waseda.jp
 Jean-Pierre Urbain=j.urbain@maastrichtuniversity.nl
 Ivica Urban=ivica@ijf.hr
 David Urbano=david.urbano@uab.es
 Krzysztof Urbanowicz=wonabru@gmail.com
 Waltraut Urban=urban@wiiw.ac.at
 Nigussie Tefera Uregia=nigtefera@yahoo.com
 Giovanni Urga=g.urga@city.ac.uk
 José-Ramón Uriarte=jr.uriarte@ehu.es
 Jorge Mario Uribe Gil=jorge.uribe@correounivalle.edu.co
 Ezequiel Uriel=ezequiel.uriel@ivie.es
 Thijs Urlings=t.urlings@caop.nl
 Miguel Urquiola=miguel.urquiola@columbia.edu
 Joaquín Andrés Urrego García=jurrego3@eafit.edu.co
 Atiq Ur Rehman=atiq164@live.com
 Roberto Urrunaga=urrunaga_rl@up.edu.pe
 Ana Urrutia=anamarta.urrutia@ehu.es
 Carlos Urrutia=currutia@itam.mx
 Miguel Urrutia=murrutia@uniandes.edu.co
 Claudiu Mihaita Urseanu=m.urseanu@yahoo.com
 Heinrich W. Ursprung=heinrich.ursprung@uni-konstanz.de
 Silviu Ursu=silviu.ursu@uaic.ro
 Carlos M. Urzúa=carlosmurzua@gmail.com
 Francisco Urzúa I.=urzuainfante@rsm.nl
 Carlos Usabiaga=cusaiba@upo.es
 Stefano Usai=stefanousai@unica.it
 Philip Ushchev=ph.ushchev@gmail.com
 Tobias Uske=uske@econ.mpg.de
 Murat Usman=musman@ku.edu.tr
 Norio Usui=nusui@adb.org
 Takehiro Usui=usui@soka.ac.jp
 Vuslat Us=vuslat.us@tcmb.gov.tr
 Hale Utar=haleutar@gmail.com
 Usamah A. Uthman=osama@kfupm.edu.sa
 Verena Utikal=verena.utikal@wiso.uni-erlangen.de
 Natalia Utrero-González=n.utrero@unizar.es
 Satu Uusiautti=satu_uusiautti@hotmail.com
 Roope Uusitalo=roope.uusitalo@helsinki.fi
 Lenno Uusküla=lenno.uuskyla@eestipank.ee
 Ruth Osarenti Oyelere nee Uwaifo=ruth.uwaifo@econ.gatech.edu
 Pinar Uysal=pinar.uysal@epfl.ch
 Dimitri Uzunidis=uzunidis@univ-littoral.fr
 Kjell Vaage=kjell.vaage@econ.uib.no
 Paul M. Vaaler=vaal0001@umn.edu
 Lukas Vacha=vachal@utia.cas.cz
 Giacomo Vaciago=giacomo.vaciago@unicatt.it
 Florin Petru Vadean=fpv3@kent.ac.uk
 Maaja Vadi=maaja.vadi@ut.ee
 Radovan Vadovic=radovan_vadovic@carleton.ca
 Cecilia Elena Văduva=vaduva.cecilia@yahoo.com
 Florin Vaduva=florin_vaduva@yahoo.com
 Antoni Vaello-Sebastià, Sr.=antoni.vaello@uib.es
 Georgios Vaggelas=g.vaggelas@stt.aegean.gr
 Gianni Vaggi=gianni.vaggi@unipv.it
 Steinar Vagstad=steinar.vagstad@econ.uib.no
 Sami Vähämaa=sami@uwasa.fi
 Farshid Vahid=farshid.vahid@monash.edu
 Priit Vahter=priit.vahter@ut.ee
 Mika Vaihekoski=mika.vaihekoski@utu.fi
 Ingrid Anarela Vaileanu Paun=ingridvaileanupaun@yahoo.fr
 Julia Vaillant=jvaillant@worldbank.org
 Nicolas Gérard Vaillant=ngvaillant@gmail.com
 Risto Vaittinen=risto.vaittinen@etk.fi
 Narasimha Rao Vajjhala=narasimharao@unyt.edu.al
 Ganna Vakhitova=vakhitova@kse.org.ua
 Renos Vakis=rvakis@worldbank.org
 Elena Vakulenko=evakulenko@hse.ru
 Abbas Valadkhani=abbas@swin.edu.au
 Paola Valbonesi=paola.valbonesi@unipd.it
 Javier Valbuena=valbuena.javier@gmail.com
 Nico Valckx=nico.valckx@ecb.int
 Diego Valderrama=dv10@cornell.edu
 Daniel Valderrama Gonzalez=valderrama.daniel@ur.edu.co
 Maria Teresa Valderrama=maria.valderrama@oenb.at
 Alberto Valdes=avaldese@puc.cl
 Nieves Valdes=nieves.valdes@uai.cl
 Alfonso Valdesogo Robles=avaldesogo@gmail.com
 Emiliano A. Valdez=valdezea@math.msu.edu
 Martín Valdivia=jvaldivi@grade.org.pe
 Néstor Valdivia=nvaldivia@grade.org.pe
 Arnaud Valence=avalence@neuf.fr
 Germán Darío Valencia Agudelo, Sr.=valencia.gd@gmail.com
 Felipe Valencia Caicedo=felipe.valencia@upf.edu
 Fabian Valencia=fvalencia@imf.org
 Federico Valenciano=federico.valenciano@ehu.es
 Oscar Mauricio Valencia=oscarmvalencia@yahoo.com
 Radim Valencik=radim.valencik@vsfs.cz
 Christine Valente=christine.valente@bristol.ac.uk
 Helder Manuel Valente da Silva=hmvs@fep.up.pt
 Giorgio Valente=g.valente@cityu.edu.hk
 Marco Valente=marco.valente@univaq.it
 Marieta Valente=mvalente@eeg.uminho.pt
 Edilio Valentini=valentin@unich.it
 Enzo Valentini=enzo.valentini@unimc.it
 Stegaroiu Valentin=vilistegaroiu@yahoo.com
 Akos Valentinyi=valentinyi.a@gmail.com
 Pál Valentiny=valentin@econ.core.hu
 Ernesto Valenzuela=ernesto.valenzuela@federation.edu.au
 Patricio Valenzuela=patriciov@dii.uchile.cl
 Eva Valeri=eva.valeri@econ.units.it
 Jorge N. Valero-Gil=jnvalero@gmail.com
 Rafael Valero=rafael.valero.fernandez@gmail.com
 Marie-Anne Valfort=mavalfort@gmail.com
 Timo Valila=t.valila@eib.org
 Aurelia Valiño Castro=avalinoc@ccee.ucm.es
 Tarmo Johannes Valkonen=tarmo.valkonen@etla.fi
 Giovanna Vallanti=gvallanti@luiss.it
 Judit Vall Castello=judit.vall@upf.edu
 Thomas Vallée=thomas.vallee@univ-nantes.fr
 Belen Vallejo-Alonso=belen.vallejo@ehu.es
 Laura Vallejo-Torres=l.vallejo-torres@ucl.ac.uk
 Jaime Vallés-Giménez=jvalles@unizar.es
 Giacomo VALLETTA=g.valletta@maastrichtuniversity.nl
 Robert G. Valletta=rob.valletta@sf.frb.org
 Tommaso Valletti=t.valletti@imperial.ac.uk
 Ehsan Vallizadeh=ehsan.vallizadeh@iab.de
 Francesc Valls-Junyent=fvalls@ub.edu
 Pedro L. Valls Pereira=pedro.valls@fgv.br
 Vincenzo Valori=vincenzo.valori@unifi.it
 Michele Valsecchi=michele.valsecchi@economics.gu.se
 Siri Valseth=siri.valseth@uis.no
 Camila Vammalle=camila.vammalle@oecd.org
 Bas van Aarle=b.vanaarle@algec.unimaas.nl
 Alfred Vanags=alf@biceps.org
 Bart van Ark=h.h.van.ark@rug.nl
 Bas J.P. Van Bavel=b.j.p.vanbavel@uu.nl
 Jan Van Bavel=jan.vanbavel@vub.ac.be
 Sebastien Van Bellegem=sebastien.vanbellegem@uclouvain.be
 Christoph Vanberg=vanberg@uni-hd.de
 Ilke Van Beveren=ilke.vanbeveren@kuleuven.be
 Johannes Van Biesebroeck=jo.vanbiesebroeck@econ.kuleuven.be
 Jules Hans van Binsbergen=jvb2@stanford.edu
 Jos van Bommel=jos.vanbommel@uni.lu
 David van Bragt=dbragt@aegon.nl
 Gerla van Breugel=gerlavanbreugel@yahoo.com
 Colin Vance=vance@rwi-essen.de
 Hendrik P. van Dalen=dalen@nidi.nl
 Clement Richard van de Coevering=c.r.coevering@minfin.nl
 Wim van de Griendt=w.e.vandegriendt@alumnus.utwente.nl
 Donald Vandegrift=vandedon@tcnj.edu
 Thijs Vandemoortele=thijs.vandemoortele@econ.kuleuven.be
 Bernard van den Berg=bernard.vandenberg@york.ac.uk
 Vincent Vandenberghe=vincent.vandenberghe@uclouvain.be
 Jan van den Berg=j.vandenberg@tudelft.nl
 Marcel van den Berg=m.r.vandenberg@cbs.nl
 Rene van den Brink=jrbrink@feweb.vu.nl
 Guillaume Vandenbroucke=vandenbr@usc.edu
 Hylke Vandenbussche=hylke.vandenbussche@kuleuven.be
 Philippe VANDEN EECKAUT=philippe.vandeneeckaut@uclouvain.be
 Rob van den Goorbergh=rob.vanden.goorbergh@apg-am.nl
 Skander J. Van den Heuvel=skander.j.vandenheuvel@frb.gov
 Wilco van den Heuvel=wvandenheuvel@few.eur.nl
 Paul van den Noord=pvandennoord@autonomycapital.com
 Dirk Van den Poel=dirk.vandenpoel@ugent.be
 Ellen Van de Poel=vandepoel@bmg.eur.nl
 Pierre van der Eng=pierre.vandereng@anu.edu.au
 Eline van der Heijden=eline.vanderheijden@uvt.nl
 M Peter van der Hoek=vanderhoek@ext.eur.nl
 Sander van der Hoog=svdhoog@gmail.com
 Albert Van der Horst=avdh@cpb.nl
 Bas van der Klaauw=b.vander.klaauw@vu.nl
 Wilbert H van der Klaauw=wilbert.vanderklaauw@ny.frb.org
 Erwin van der Laan=elaan@rsm.nl
 Gerard van der Laan=g.vander.laan@vu.nl
 Bruno Van der Linden=bruno.vanderlinden@uclouvain.be
 Matthijs van der Loos=mvanderloos@ese.eur.nl
 Gerardus Cornelis van der Meijden=gcvandermeijden@gmail.com
 Frederick (Rick) van der Ploeg=rick.vanderploeg@economics.ox.ac.uk
 Karine Van der Straeten=straeten@pse.ens.fr
 Koen van der Veer=k.j.m.van.der.veer@dnb.nl
 Rolf Van der Velden=r.vandervelden@maastrichtuniversity.nl
 Nicolaas Willem van der Wath=wnwath@sun.ac.za
 Roy van der Weide=rvanderweide@worldbank.org
 Michel van der Wel=vanderwel@ese.eur.nl
 Edwin van der Werf=mail@edwinvanderwerf.nl
 Wouter van der Wielen=wouter.vanderwielen@kuleuven.be
 Ton van der Wiele=awiele@rsm.nl
 Bob van der Zwaan=vanderzwaan@ecn.nl
 Peter van der Zwan=vanderzwan@few.eur.nl
 Nicolas Van de Sijpe=nicolas.vandesijpe@qeh.ox.ac.uk
 Kristina van Deuverden=kvandeuverden@diw.de
 Jeroen van de Ven=j.vandeven@uva.nl
 Justin William van de Ven=jvandeven@niesr.ac.uk
 Niels van de Ven=n.v.d.ven@uvt.nl
 Donald R. van Deventer=dvandeventer@kamakuraco.com
 Gerhard Van de Venter=tobiaswillem.vandeventer@uts.edu.au
 Corey Van de Waal=chvandew@uwaterloo.ca
 Dominique van de Walle=dvandewalle@worldbank.org
 Lore Vandewalle=lore.vandewalle@graduateinstitute.ch
 Steven Van de Walle=vandewalle@fsw.eur.nl
 Dick van Dijk=djvandijk@ese.eur.nl
 Jouke van Dijk=jouke.van.dijk@rug.nl
 Mathijs A. van Dijk=madijk@rsm.nl
 Michiel van Dijk=michiel.vandijk@wur.nl
 Daniela Vandone=daniela.vandone@unimi.it
 Ralph van Doorn=rvandoorn@worldbank.org
 Eddy K.A. Van Doorslaer=vandoorslaer@ese.eur.nl
 Vitaliy Vandrovych=vitaliy_vandrovych@yahoo.com
 Mark van Duijn=m.van.duijn@vu.nl
 Toon Vandyck=toon.vandyck@econ.kuleuven.be
 Jindřich Vaněk=vanek@opf.slu.cz
 Matthew James Van Essen=mjvanessen@cba.ua.edu
 Saskia Erline van Ewijk=s.e.van.ewijk@dnb.nl
 Job van Exel=vanexel@bmg.eur.nl
 David D. Van Fleet=ddvf@asu.edu
 Kees Jan van Garderen=k.j.vangarderen@uva.nl
 Tony van Gestel=tony.vangestel@dexia.com
 Bas van Groezen=b.j.a.m.vangroezen@uvt.nl
 Frederick Van Gysegem=frederick.vangysegem@ugent.be
 Juuso Vanhala=juuso.vanhala@bof.fi
 Wim Vanhaverbeke=wim.vanhaverbeke@uhasselt.be
 Jan Horn Van Heerden=jan.vanheerden@up.ac.za
 Kristine Maria Frans Van Herck=kristine.vanherck@econ.kuleuven.be
 Neeltje Van Horen=n.van.horen@dnb.nl
 Patrick Van Horn=pvanhorn@ncf.edu
 Patrick Vanhoudt=p.vanhoudt@eib.org
 Courtney Harold Van Houtven=courtney.vanhoutven@duke.edu
 Jan Van Hove=jan.vanhove@econ.kuleuven.be
 Christophe van Huffel=ch.vanhuffel@univ-tln.fr
 Enrico Vanino=enrico.vanino@gmail.com
 Paolo Vanin=paolo.vanin@unibo.it
 Jos van Iwaarden=josvaniwaarden.mbe@gmail.com
 Philippe Van Kerm=philippe.vankerm@ceps.lu
 Silvester Van Koten=slvstr@gmail.com
 Wim Van Lancker=wim.vanlancker@ua.ac.be
 Bert G.M. Van Landeghem=b.vanlandeghem@maastrichtuniversity.nl
 Eveline S. van Leeuwen=eleeuwen@feweb.vu.nl
 Marko Jeroen van Leeuwen=marko.vanleeuwen@seo.nl
 Gijsbert van Liemt=gbvanliemt@gmail.com
 Duncan Van Limbergen=dvanlimbergen@gmail.com
 Vincent Vannetelbosch=vincent.vannetelbosch@uclouvain.be
 Renger van Nieuwkoop=renger@vannieuwkoop.ch
 Davide Vannoni=davide.vannoni@unito.it
 Gonzague Vannoorenberghe=g.c.l.vannoorenberghe@uvt.nl
 Jan M. van Noortwijk=j.m.van.noortwijk@hkv.nl
 Simon van Norden=simon.van-norden@hec.ca
 Simone Vannuccini=simone.vannuccini@uni-jena.de
 Jos van Ommeren=jos.van.ommeren@vu.nl
 Wim Van Opstal=wim.vanopstal@khleuven.be
 Stijn Vanormelingen=stijn.vanormelingen@econ.kuleuven.be
 Peter van Oudheusden=p.vanoudheusden@gmail.com
 Jan van Ours=vanours@uvt.nl
 Olivier Van Parys=vanparyo@tcd.ie
 Bernard M.S. van Praag=b.m.s.vanpraag@uva.nl
 John van Reenen=j.vanreenen@lse.ac.uk
 Peran van Reeven=vanreeven@ese.eur.nl
 Thijs van Rens=j.m.van-rens@warwick.ac.uk
 Allard Cornelis Van Riel=a.vanriel@fm.ru.nl
 Caroline Van Rijckeghem=cvanrijckeghem@istanbulanalytics.com
 Ine Van Robays=ine.van-robays@ecb.europa.eu
 Maarten van Rooij=m.c.j.van.rooij@dnb.nl
 Patrick Van Roy=pvroy@ulb.ac.be
 Peter C. van Santen=p.c.van.santen@gmail.com
 Arthur van Soest=avas@uvt.nl
 Daan van Soest=d.p.vansoest@uvt.nl
 Jan-Maarten van Sonsbeek=j.m.van.sonsbeek@vu.nl
 Irene van Staveren=staveren@iss.nl
 isabel Vansteenkiste=isabel.vansteenkiste@ecb.europa.eu
 André van Stel=a.van.stel@panteia.nl
 Eric U. Van Tassel=vantasse@fau.edu
 Frank van Tongeren=frank.vantongeren@oecd.org
 Matthijs van Veelen=c.m.vanveelen@uva.nl
 Aico van Vuuren=avuuren@feweb.vu.nl
 Daniel van Vuuren=djvv@cpb.nl
 Desirée van Welsum=dvanwelsum@hotmail.com
 Sweder van Wijnbergen=s.j.g.vanwijnbergen@uva.nl
 Eric van Wincoop=vanwincoop@virginia.edu
 Frans A.A.M. van Winden=f.a.a.m.vanwinden@uva.nl
 Tom van Woensel=t.v.woensel@tm.tue.nl
 Martine van Wouwe=martine.vanwouwe@uantwerpen.be
 Tanguy van Ypersele=tanguy.vy@gmail.com
 Timothy Van Zandt=tvz@insead.edu
 Willem Van Zandweghe=willem.vanzandweghe@kc.frb.org
 Nicolas van Zeebroeck=nicolas.van.zeebroeck@ulb.ac.be
 David Vanzetti=david.vanzetti@anu.edu.au
 Adriaan van Zon=adriaan.vanzon@maastrichtuniversity.nl
 Warrick Boyd van Zyl=warrickvanzyl@gmail.com
 Alberto Vaquero García=vaquero@uvigo.es
 Vijay Kumar Varadi=varadivk@gmail.com
 Urmas Varblane=varblane@mtk.ut.ee
 Erling Vårdal=erling.vardal@econ.uib.no
 Arna Vardardottir=ava.eco@cbs.dk
 N. Baris Vardar=baris.vardar@psemail.eu
 Giannis Vardas=vardasg@econ.soc.uoc.gr
 Felix Vardy=fvardy@haas.berkeley.edu
 João Vareda=joaovareda@hotmail.com
 Jose Varejao=varejao@fep.up.pt
 Carmen Augusta Varela=carmen.varela@fgv.br
 Gonzalo J. Varela=gonzalo.j.varela@gmail.com
 Xose-Luis Varela-Irimia=irimia@economistas.org
 Manuel Varela-Lafuente=mmvarela@uvigo.es
 Patrícia Varela=patricia_varela_@hotmail.com
 Diego Varela=dvarela@udc.es
 Lóránt Varga=vargalor@mnb.hu
 Carmiña O. Vargas=cvargari@banrep.gov.co
 emiliano vargas, Sr.=emiliano.vargas@gmail.com
 Jose P Mauricio Vargas=jpvargas@fen.uchile.cl
 Juan F Vargas=juan.vargas@urosario.edu.co
 Laura Triana Vargas=lalita_11045@msn.com
 Martin Harry Vargas Barrenechea=martin.h.vargas@gmail.com
 Miguel Vargas=miguel.vargas@udp.cl
 Mónica Vargas=monica.vargas61@urosario.edu.co
 Jaime Vargas Ramos=jvargasr@ucb.edu.bo
 Carlos Vargas-Silva=carlos.vargas-silva@compas.ox.ac.uk
 Manuel Vargas-Vargas=manuel.vargas@uclm.es
 Tiziano Vargiolu=vargiolu@math.unipd.it
 Hal Varian=hal@sims.berkeley.edu
 Jayanth Rama Varma=jrvarma@iimahd.ernet.in
 Sumati Varma=varmasumati@yahoo.co.in
 Vijaya Krushna Varma=vijayakrushnavarma@gmail.com
 Simone Varotto=s.varotto@icmacentre.rdg.ac.uk
 Dimitris Varoutas=d.varoutas@di.uoa.gr
 Viktor Várpalotai=varpalotaiv@mnb.hu
 Nikos C. Varsakelis=barsak@econ.auth.gr
 Zoltan Varsanyi=varsanyiz77@yahoo.com
 Alexander Varshavsky=varshav@cemi.rssi.ru
 Hannu Vartiainen=hannu.vartiainen@helsinki.fi
 Anca Varzaru=varzaruanca@yahoo.com
 Alexander Vasa=alexander.vasa@edle-phd.eu
 Carlos Andrés Vasco Correa=carlosvasco@gmail.com
 Mateo Vasco=mvascoco@eafit.edu.co
 Claudio Roberto Foffano Vasconcelos=claudio.foffano@ufjf.edu.br
 Helder Vasconcelos=hvasconcelos@fep.up.pt
 Luis Vasconcelos=lvasco@essex.ac.uk
 Marcos Roberto Vasconcelos=mrvasconcelos@uem.br
 Silvinha Pinto Vasconcelos=silvinha.vasconcelos@ufjf.edu.br
 Bořek Vašíček=borek.vasicek@cnb.cz
 Nicholas V. Vasilakos=n.vasilakos@uea.ac.uk
 Kathryn Vasilaky=kvasilaky@gmail.com
 Bogdan Gabriel Vasilciuc=bogdanvbg@yahoo.com
 Emilia Vasile=rector@univath.ro
 Elka Slavtcheva Vasileva=elkav@unwe.bg
 Valentina Vasile=val.vasile.ien@gmail.com
 Dan Vaško=vasko.dan@gmail.com
 Arturo Vásquez=avasquez@osinerg.gob.pe
 Diego Mauricio Vásquez=dvasques@banrep.gov.co
 Spyros Vassilakis=svasilak@aueb.gr
 Zlatan D. Vassilev=zlatan.vassilev@gmail.com
 Achilleas Vassilopoulos=avas@aua.gr
 Ramaa Vasudevan=ramaa.vasudevan@colostate.edu
 Massimiliano Vatiero=mvatiero@gmail.com
 Roland Vaubel=vaubel@uni-mannheim.de
 Julien VAUDAY=julien.vauday@univ-paris13.fr
 Leighton Vaughan Williams=leighton.vaughan-williams@ntu.ac.uk
 Christoph Vauth=christoph.vauth@googlemail.com
 Joseph Vavra=joseph.vavra@chicagobooth.edu
 Marian Vavra=marian.vavra@nbs.sk
 Elsa Cristina Vaz=elsavaz@uevora.pt
 Margarida Vaz=mvaz@ubi.pt
 Rosalia Vazquez-Alvarez=ralvarez@dec.org.ae
 Emilia Vazquez=mcarmen.guisan@usc.es
 Javier Vázquez Grenno=jvazquezgrenno@ub.edu
 Daniela Vázquez Leggiadro=daniela.vazquez@gmail.com
 Miguel Vázquez=miguel.vazquez.martinez@gmail.com
 Nancy Garcia Vazquez=nancygarciav@yahoo.com.mx
 Pablo Vázquez=pvazquez@fedea.es
 María Xosé Vázquez Rodríguez=maxose@uvigo.es
 Xosé H. Vázquez=xhvv@uvigo.es
 Teresa de Noronha Vaz=mtvaz@ualg.pt
 Michael R. Veall=veall@mcmaster.ca
 Giovanni Vecchi=giovanni.vecchi@uniroma2.it
 Michela Vecchi=m.vecchi@mdx.ac.uk
 Jiri Vecernik=jiri.vecernik@soc.cas.cz
 Andrés Ignacio Vecino Ortiz=andres.vecino@gmail.com
 Marco Vedovato=vedovato@unive.it
 Lionel Védrine=lionel.vedrine@dijon.inra.fr
 Ruut Veenhoven=veenhoven@fsw.eur.nl
 Amaya Vega=amaya.vega@nuigalway.ie
 Maximo Vega-Centeno=mvega@pucp.edu.pe
 George Gerald Vega Yon=gvega@spensiones.cl
 Henry L. Vega=henry@fulbrightmail.org
 Hugo Yamil Vega=hugo.vega@bcrp.gob.pe
 Jaider Vega-Jurado=javega@ingenio.upv.es
 Marco Vega=marco.vega@bcrp.gob.pe
 Carlos Vegh=vegh@econ.bsos.umd.edu
 Francisco José Veiga=fjveiga@eeg.uminho.pt
 Helena Veiga=mhveiga@est-econ.uc3m.es
 Linda Veiga=linda@eeg.uminho.pt
 Luiz Humberto Veiga=luizhumbertoveiga@yahoo.com.br
 Tobias Veith=veith@hs-rottenburg.de
 Rune Vejlin=rvejlin@econ.au.dk
 Alexander Vekker=avekker@ssc.upenn.edu
 Luciana Velarde=velarde_lb@up.edu.pe
 Carlos Velasco=carlos.velasco@uc3m.es
 Andrea Velasquez=andrea.velasquez@duke.edu
 Luis Angel Velastegui M, Sr.=luisangel_velastegui@hotmail.com
 Jackeline Velazco=jr2velazco@yahoo.com
 Francisco J. Velázquez=javel@ccee.ucm.es
 César Velázquez G.=cesar.velazquez@uia.mx
 Chris Veld=chris.veld@monash.edu
 Francois Velde=fvelde@frbchi.org
 Laura Veldkamp=lveldkam@stern.nyu.edu
 Jolan Velencei=velencei.jolan@kgk.uni-obuda.hu
 Luis Guillermo Vélez Álvarez=lgva@une.net.co
 Carlos Eduardo Velez=cev818@gmail.com
 Roberto Velez Grajales=rvelezg@ceey.org.mx
 Maria Alejandra Vélez=mavelez@uniandes.edu.co
 Ignacio Velez-Pareja=nachovelez@gmail.com
 Rodrigo A. Velez=rvelezca@econmail.tamu.edu
 Léa Maria Velho=velho@ige.unicamp.br
 Michail Veliziotis=michail.veliziotis@uwe.ac.uk
 Thomas Velk=tomvelk@aol.com
 Nathanaël Vellekoop=vellekoop@safe.uni-frankfurt.de
 Gabriel T. Velloso=gabriel.velloso@partner.kit.edu
 Charles Vellutini=charles.vellutini@univ-tlse1.fr
 Artur Veloso Vieira=arturvvieira@gmail.com
 Margherita Velucchi=velucchi@ds.unifi.it
 Anthony J. Venables=tony.venables@economics.ox.ac.uk
 Ana Venancio=avenancio@iseg.utl.pt
 Daniela Venanzi=daniela.venanzi@uniroma3.it
 Florent Venayre=florent.venayre@upf.pf
 Dev Vencappa=dev.vencappa@nottingham.ac.uk
 Désiré Vencatachellum=d.vencatachellum@afdb.org
 Xavier Vence-Deza=xavier.vence@usc.es
 Alain Venditti=alain.venditti@univ-amu.fr
 Fabrizio Venditti=fabrizio.venditti@bancaditalia.it
 Bruno Venditto=brunovenditto@yahoo.it
 Francisco Venegas-Martínez=fvenegas1111@yahoo.com.mx
 Paolo Veneri=paolo.veneri@oecd.org
 Hildegardi Venero=hvenero@iep.org.pe
 Nuno Venes=nvenes@sapo.pt
 Ioannis A. Venetis=ivenetis@upatras.gr
 Elisabetta Venezia=e.venezia@dse.uniba.it
 Viktor Andreas Venhorst=v.a.venhorst@rug.nl
 Guido Venier=guido-venier@freenet.de
 Ragupathy Venkatachalam=rpathy@gmail.com
 Danielle Venn=danielle.venn@anu.edu.au
 Tyron James Venn=tyron.venn@cfc.umt.edu
 Daniel Ventosa-Santaulària=daniel@ventosa-santaularia.com
 Vivianne Ventura-Dias=diascordero@me.com
 Jaume Ventura=jventura@crei.cat
 Luigi Ventura=luigi.ventura@uniroma1.it
 Marco Ventura=mventura@istat.it
 Valeria Venturelli=valeria.venturelli@unimore.it
 Alessandra Venturini=alessandra.venturini@unito.it
 Francesco Venturini=francesco.venturini@unipg.it
 Roberto Venturini=rventuri@ulb.ac.be
 Almut E. D. Veraart=a.veraart@imperial.ac.uk
 Cecilia Vera=cecilia.vera@cepal.org
 Celia Patricia Vera=celia.vera@zirve.edu.tr
 Marcos Vera-Hernandez=m.vera@ucl.ac.uk
 Gregory Francisco Veramendi=gregory.veramendi@asu.edu
 Stephane Verani=stephane.h.verani@frb.gov
 Alina Verashchagina=alinaver@gmail.com
 Marno Verbeek=mverbeek@rsm.nl
 Tom Verbeke=tom.verbeke@ugent.be
 Wim Verbeke=wim.verbeke@ugent.be
 Miroslav Verbič=miroslav.verbic@guest.arnes.si
 Dorian Verboux=dorian.verboux@univ-paris-est.fr
 Randal John Verbrugge=randal.verbrugge@clev.frb.org
 Peter H. Verburg=peter.verburg@ivm.vu.nl
 Julien Vercueil=julien.vercueil@inalco.fr
 Adrien Verdelhan=adrienv@mit.edu
 Stefano F. Verde=stefano.verde@eui.eu
 Genevieve Verdier=gverdier@imf.org
 Thierry A. Verdier=thierry.verdier@parisschoolofeconomics.eu
 Gregory Verdugo=gregory.verdugo@banque-france.fr
 David Veredas=dveredas@ulb.ac.be
 Galina Vereshchagina=galinav@asu.edu
 Sergio Vergalli=vergalli@eco.unibs.it
 Sebastian Vergara Marezco=vergaras@un.org
 Rodrigo Vergara=rvergara@bcentral.cl
 Cecilia Vergari=cecilia.vergari@unibo.it
 Joaquim Vergés-Jaime=joaquim.verges@uab.cat
 Thibaud Vergé=thibaud.verge@ensae.fr
 Jean-Christophe Vergnaud=vergnaud@univ-paris1.fr
 Clémence Vergne=clemence.maya@wanadoo.fr
 Loris Vergolini=vergolini@irvapp.it
 Olivier Vergote=olivier.vergote@ecb.europa.eu
 Wouter Vergote=vergote@fusl.ac.be
 Dieter Verhaest=dieter.verhaest@kuleuven.be
 Ingrid Verheul=iverheul@rsm.nl
 Florian Verheyen=florian.verheyen@uni-due.de
 Erik Teodoor Verhoef=everhoef@feweb.vu.nl
 Grietjie Verhoef=gverhoef@uj.ac.za
 Peter Verhoef=p.c.verhoef@rug.nl
 Eric Verhoogen=eric.verhoogen@columbia.edu
 Sher Verick=verick@ilo.org
 Kiki Verico=kverico@yahoo.com
 P C Verma=pcverma3@yahoo.com
 Rubina Verma=rubina.verma@itam.mx
 Ben Vermeulen=b.vermeulen@uni-hohenheim.de
 Philip Vermeulen=philip.vermeulen@ecb.int
 Wouter Vermeulen=w.vermeulen@cpb.nl
 Maximilian A.M. Vermorken=m.vermorken@ucl.ac.uk
 Dorte Verner=dorteverner@yahoo.com
 Mette Verner=vernermette@gmail.com
 Andrei Vernikov=avernikov@hse.ru
 Achille Vernizzi=achille.vernizzi@unimi.it
 Fabio Verona=fabio.verona@bof.fi
 Marco Veronese Passarella=info@marcopassarella.it
 Marcella Veronesi=marcella.veronesi@univr.it
 Vincent Verouden=vincent.verouden@ec.europa.eu
 Thanos Verousis=t.verousis@bath.ac.uk
 Michele Ver Ploeg=sverploeg@ers.usda.gov
 Marijke Verpoorten=marijke.verpoorten@ua.ac.be
 Ewout Verriest=elv224@nyu.edu
 Bruno Versaevel=versaevel@em-lyon.com
 Marijn Verschelde=marijn.verschelde@ugent.be
 Willem Verschoor=w.f.c.verschoor@vu.nl
 Michel Verstraeten=mverstra@ulb.ac.be
 Philip Verwimp=philip.verwimp@ulb.ac.be
 Rossella Verzulli=rossella.verzulli@unibo.it
 Dmitry A. Veselov=dveselov@hse.ru
 Alberto Vesperoni=alberto.vesperoni@gmail.com
 Niels Vestergaard=nv@sam.sdu.dk
 Lise Vesterlund=vester@pitt.edu
 Róbert Ferenc Veszteg=rveszteg@gmail.com
 Veugelers Reinhilde=reinhilde.veugelers@econ.kuleuven.be
 Stan A. Veuger=stan.veuger@aei.org
 Luc Veyssiere=luc.veyssiere@hotmail.com
 Pierre-Louis Vézina=pierre-louis.vezina@economics.ox.ac.uk
 Andrea Vezzulli=andrea.vezzulli@unibocconi.it
 Ariel Marcelo Viale=aviale@fau.edu
 Virginie Vial=virginie.vial@euromed-management.com
 Bruno E. Viani=bviani@nathaninc.com
 Francesca Viani=francesca.viani@bde.es
 Alan D. Viard=aviard@aei.org
 Martina Viarengo=martina.viarengo@graduateinstitute.ch
 Paola Vicard=vicard@uniroma3.it
 Vincent Vicard=vincent.vicard@banque-france.fr
 Claudio Vicarelli=cvicarelli@istat.it
 Luis M. Viceira=lviceira@hbs.edu
 Angelino Viceisza=a.viceisza@cgiar.org
 Eva Vicente=evicente@eco.uva.es
 Francisco Javier Quiros Vicente=javier.quiros@uaslp.mx
 Jérôme Vicente=vicente@univ-tlse1.fr
 Maria Rosalia Vicente=mrosalia@uniovi.es
 Azucena Vicente-Molina=azucena.vicente@ehu.es
 Pedro C. Vicente=pedro.vicente@novasbe.pt
 Juan Vicente-Perdiz=perdiz@eco.uva.es
 Gustavo Vicentini=gvicentini@gmail.com
 Brandon Vick=vick@fordham.edu
 Roger Vickerman=r.w.vickerman@kent.ac.uk
 Chris Vickers=czvickers@gmail.com
 John Vickers=john.vickers@economics.ox.ac.uk
 James Vickery=james.vickery@ny.frb.org
 Neven Vidaković=nvidakovic@vsfp.eu
 Marian Vidal-Fernández=m.vidal-fernandez@unsw.edu.au
 Gregorio Vidal=vidal.gregorio@gmail.com
 Isabel Vidal=ividal@ub.edu
 Carlos Vidal-Melia=carlos.vidal@uv.es
 Javier Vidal Olivares=jvidal@ua.es
 Antoni Vidal-Suñé=antoni.vidal@urv.cat
 Péter Vida=pvida@mail.uni-mannheim.de
 Yann VIDEAU=yann.videau@u-pec.fr
 Antoni Vidiella-I-Anguera=avidiella@bluecap.es
 Vinicius Goncalves Vidigal=vgvidigal@fecilcam.br
 Edouard Vidon=evidon@yahoo.com
 Laurent Vidu=laurent.vidu@unicaen.fr
 María Fernanda Viecens=fviecens@udesa.edu.ar
 Cristina Viegas=colivei@ualg.pt
 Nicola Viegi=nicola.viegi@up.ac.za
 Valentina Viego=vviego@criba.edu.ar
 Carlos Vieira=cvieira@uevora.pt
 Fabrício de Assis Campos Vieira=fabriciovieira@ufv.br
 Flavio Vilela Vieira=flaviovieira@ufu.br
 Isabel Vieira=impvv@uevora.pt
 José Cabral Vieira=josevieira@uac.pt
 José Guilherme Silva Vieira=jg.vieira@uol.com.br
 Luís M.Ribeiro Vieira=lmrv@iseg.utl.pt
 Pedro Cosme da Costa Vieira=pcosme@fep.up.pt
 Marc Vielle=marc.vielle@epfl.ch
 Marie-Louise Vierø=viero@econ.queensu.ca
 Valérie Vierstraete=valerie.vierstraete@usherbrooke.ca
 Christoph Vietze=christoph.vietze@wiwi.uni-jena.de
 Mauro Vigani=mauro.vigani@ec.europa.eu
 Jacob Vigdor=jacob.vigdor@duke.edu
 Stéphane Vigeant=stephane.vigeant@univ-lille1.fr
 Robert John Vigfusson=robert.j.vigfusson@frb.gov
 Olivier VIGNA=ovigna@gmail.com
 Annick Vignes=annick.vignes@irstea.fr
 Silvia Vignetti=vignetti@csilmilano.com
 GAMMADIGBE Vigninou=dodogamma@yahoo.fr
 Anna Vignoles=av404@cam.ac.uk
 Daniele Vignoli=vignoli@ds.unifi.it
 Thierry Vignolo=thierry.vignolo@gmail.com
 Lari Arthur Viianto=lari.viianto@ugto.org
 Mariana Vijil=vijil.mariana@gmail.com
 Dmytro Vikhrov=dmytro.vikhrov@cerge-ei.cz
 Johan Vikström=johan.vikstrom.econ@gmail.com
 Elisabet Viladecans-Marsal=eviladecans@ub.edu
 Montserrat Viladrich-Grau=montse.viladrich@aegern.udl.cat
 Montserrat Vilalta-Bufi=montsevilalta@ub.edu
 Carlos Javier Vilalta Perdomo=carlos.vilalta@cide.edu
 Paulo Vila Maior=pvm@ufp.edu.pt
 Xavier Vilà=xavier.vila@uab.cat
 Luis Vildosola=luis.vildosola@uabc.edu.mx
 Lars Vilhuber=lars.vilhuber@cornell.edu
 Grigory Vilkov=vilkov@vilkov.net
 Lucciano Villacorta=lucciano.villacorta@gmail.com
 Edgar Villa=e.villa@javeriana.edu.co
 Elizabeth Villagomez=vevillagomez@gmail.com
 Guillermo Villa Valdés=guillermo@baphealth.com
 Juan Miguel Villa=juan.villalora@postgrad.manchester.ac.uk
 Carlos Villalobos Barría=cvillal@uni-goettingen.de
 Mauricio Villamizar=mauriciovillam@gmail.com
 Antonio Villanacci=antonio.villanacci@unifi.it
 Espen Villanger=espen.villanger@cmi.no
 Salvatore Villani=salvatore.villani@unina.it
 Renato Andrin Villano=rvillan2@une.edu.au
 Ernesto Villanueva=ernesto.villanueva@bde.es
 Antonio Villar=avillar@upo.es
 Francisco G. Villarreal=francisco.villarreal@cepal.org
 Hector J. Villarreal=hjvp@itesm.mx
 Edna Maria Villarreal Peralta=ednavillarreal@outlook.com
 Sergio G. Villarroel-Böhrt=villabohrt@gmail.com
 Elena Villar-Rubio=elvillar@ugr.es
 Marcia Villasana=marciavillasana@itesm.mx
 Sofia Villas-Boas=sberto@berkeley.edu
 Stefania Villa=stefania.villa@kuleuven.be
 Félix Villatoro=felix.villatoro@uai.cl
 Horacio Villegas Quino=hvillegas@ucb.edu.bo
 Sébastien Villemot=sebastien@dynare.org
 Mauricio G. Villena=mauricio.villena@uai.cl
 Benjamín Villena Roldán=benjamin@benjaminvillena.com
 Bertrand Villeneuve=bertrand.villeneuve@dauphine.fr
 Jean-Pierre VILLETELLE=jean-pierre.villetelle@banque-france.fr
 Marie Claire Villeval=villeval@gate.cnrs.fr
 Patrick Villieu=patrick.villieu@univ-orleans.fr
 Nelson Benjamin Villoria=nvillori@purdue.edu
 Claudia Villosio=c.villosio@repnet.it
 Jouko Vilmunen=jouko.vilmunen@bof.fi
 Peña-Vinces=jesuspvinces@us.es
 János Vincze=vincze.janos1@chello.hu
 Annalisa Vinella=annalisa.vinella@uniba.it
 Rui Vinhas da Silva=rui.vinhas.silva@iscte.pt
 Lucio Vinhas de Souza=lucio.vinhasdesouza@moodys.com
 Aidan Vining=vining@sfu.ca
 Joop Vinke=j.vinke1@upcmail.nl
 Nick Vink=nv@sun.ac.za
 Adriana Vintean=adivinti@yahoo.com
 Nicoleta Vintilă=ncltvntl@yahoo.com
 Denis Vîntu=denis.vintu@hotmail.com
 Francesco Violante=fviolante@creates.au.dk
 Giovanni Luca Violante=glv2@nyu.edu
 Roberto Violi=roberto.violi@bancaditalia.it
 Razvan Viorescu=razvanv@usv.ro
 Gábor Virág=gabor.virag@utoronto.ca
 Stéphane Virol=virol@u-bordeaux4.fr
 Mauro Visaggio=visaggio@unipg.it
 Nuttawat Visaltanachoti=n.visaltanachoti@massey.ac.nz
 Bruno Viscolani=viscolani@math.unipd.it
 Jan Amos Visek=visek@mbox.fsv.cuni.cz
 Sharmila Vishwasrao=svishwas@fau.edu
 Tiia Vissak=tiia.vissak@ut.ee
 Ludo Visschers=ludo.visschers@ed.ac.uk
 Bauke Visser=bvisser@ese.eur.nl
 Martine Visser=martine.visser@uct.ac.za
 Michael Visser=michael.visser@ensae.fr
 Claus Vistesen=clausvistesen@gmail.com
 K.Kuperan Viswanathan=kuperan@gmail.com
 S Viswanathan=viswanat@duke.edu
 Paolo Vitale=p.vitale@unich.it
 Agnese Vitali=agnese.vitali@unibocconi.it
 Donald F. Vitaliano=vitald@rpi.edu
 Giampaolo Vitali=g.vitali@ceris.cnr.it
 Francis Vitek=francis.vitek@gmail.com
 Chaiporn Vithessonthi=chaiporn.vithessonthi@otago.ac.nz
 Giorgio Vittadini=giorgio.vittadini@unimib.it
 Giuseppe Vittucci Marzetti=giuseppe.vittucci@unimib.it
 Marco Vivarelli=marco.vivarelli@unicatt.it
 Alejandro Vivas=avivas@javeriana.edu.co
 Xavier Vives=xvives@iese.edu
 David Vivet=david.vivet@nbb.be
 Carlo Viviani=carlo.viviani@ec.europa.eu
 Jean-Laurent VIVIANI=jean-laurent.viviani@univ-rennes1.fr
 Robert William Vivian=robert.vivian@wits.ac.za
 Wilma Viviers=wilma.viviers@nwu.ac.za
 Maruska Vizek=mvizek@eizg.hr
 Peter Vlaar=peter.vlaar@apg.nl
 ilias Vlachos=ivlachos@gmail.com
 Jonas Vlachos=jonas.vlachos@ne.su.se
 Aspassia Vlachvei=vlahvei@kastoria.teikoz.gr
 Razvan Vlahu=r.e.vlahu@dnb.nl
 Minas Vlassis=mvlassis@econ.soc.uoc.gr
 Michael Vlassopoulos=m.vlassopoulos@soton.ac.uk
 Nikolaos Vlastakis=nvlast@essex.ac.uk
 Jan Vlcek=janvlcekatcz@gmail.com
 Gertjan W. Vlieghe=gertjan.vlieghe@brevanhoward.com
 Olaf van Vliet=o.p.van.vliet@law.leidenuniv.nl
 Milan Vodopivec=milan.vodopivec@gmail.com
 Duc Hong Vo=duc.vo@erawa.com.au
 Valeri Voev=vvoev@creates.au.dk
 Stefan Vögele=s.voegele@fz-juelich.de
 Ulrike Vogelgesang=ulrike.vogelgesang@gmx.de
 Jonathan E. Vogel=jvogel@columbia.edu
 Lukas Vogel=lukas.vogel@ec.europa.eu
 Timothy Vogelsang=tjv@msu.edu
 Thorsten Vogel=vogeltho@staff.hu-berlin.de
 Wolfgang Voges=wvoges@zes.uni-bremen.de
 Hatra Voghouei=hatrav@yahoo.com
 Michael Vogler=vogler@iza.org
 William Vogt=william.b.vogt@gmail.com
 Rajiv Vohra=rajiv_vohra@brown.edu
 Dan Marius Voicilas=dmvoici@yahoo.com
 Alexandru Voicu=voicu@mail.csi.cuny.edu
 Guido Voigt=guido.voigt@ww.uni-magdeburg.de
 Christine Voigtländer=voigtlaender@iwi.uni-hannover.de
 Nico Voigtländer=nico_v@alum.mit.edu
 Sebastian Voigt=voigt@zew.de
 Stefan Voigt=stefan.voigt@uni-hamburg.de
 Richard P. Voith=voith@econsult.com
 Lucia Vojtassak=luciavojtassak@gmail.com
 Martin Vojtek=martin.vojtek@cerge-ei.cz
 Nina Pološki Vokić=npoloski@efzg.hr
 Vyacheslav Volchik=volchik@sfedu.ru
 Natalya Volchkova=nvolchkova@cefir.ru
 Oliver Volckart=o.j.volckart@lse.ac.uk
 Oscar Volij=oscar@volij.co.il
 Dimitrios Voliotis=dvoliotis@unipi.gr
 Engin Volkan=engin.volkan@bilgi.edu.tr
 Christine Katharina Volkmann=volkmann@wiwi.uni-wuppertal.de
 Olga N. Volkova=volkova@rambler.ru
 Dmitry L. Volkov=volkov@gsom.pu.ru
 Herman R.J. Vollebergh=vollebergh@ese.eur.nl
 Sebastian Vollmer=svollmer@uni-goettingen.de
 Thomas L. Vollrath=tlvollrath@me.com
 Andrei Y. Volodin=volodin@hist.msu.ru
 Võ Hải Long (Long Hai Vo)=long_vo_hai@yahoo.com.vn
 Vadym Volosovych=volosovych@ese.eur.nl
 Aurelio Volpe=volpe@csilmilano.com
 Richard J. Volpe, III=rvolpe@ers.usda.gov
 Thomas W. Volscho, Jr.=thomas.volscho@csi.cuny.edu
 Francesco Vona=francesco.vona@sciencespo.fr
 Korbinian von Blanckenburg=korbinian@vonblanckenburg.de
 Peter Michael von der Lippe=plippe@vwl.uni-essen.de
 Marc von der Ruhr=marc.von-der-ruhr@snc.edu
 Godwin Kofi Vondolia=gkvond@yahoo.com
 Maximilian von Ehrlich=maximilian.vonehrlich@vwi.unibe.ch
 Emma von Essen=vonessen@econ.au.dk
 George M. von Furstenberg=vonfurst@indiana.edu
 Hans-Martin von Gaudecker=hmgaudecker@uni-bonn.de
 Georg von Graevenitz=g.graevenitz@uea.ac.uk
 Kathrine von Graevenitz=vongraevenitz@zew.de
 Klaus von Grebmer=k.vongrebmer@cgiar.org
 Juergen von Hagen=vonhagen@uni-bonn.de
 Stephanie von Hinke Kessler Scholder=stephanie.scholder@york.ac.uk
 David Vonka=david.vonka@gmail.com
 Ulf von Kalckreuth=ulf.von-kalckreuth@bundesbank.de
 Julia von Maltzan Pacheco=julia.pacheco@fgv.br
 Balázs Vonnák=vonnakb@mnb.hu
 Goetz von Peter=goetz.von.peter@bis.org
 Benedikt von Scarpatetti=bene.vs@gmail.com
 Erik von Schedvin=erik.vonschedvin@riksbank.se
 Barbara von Schnurbein=barbara@schnurbein.com
 Christian von Soest=soest@giga-hamburg.de
 Bernhard von Stengel=stengel@maths.lse.ac.uk
 Till Marco von Wachter=tvwachter@econ.ucla.edu
 Jakob von Weizsäcker=jvw@bruegel.org
 Natalja Valeria von Westernhagen=natalja.von-westernhagen@bundesbank.de
 Tamás Vonyó=t.vonyo@lse.ac.uk
 Maximilian von Zedtwitz=max@post.harvard.edu
 Peter von zur Muehlen=pmuehlen@verizon.net
 Wim Voordeckers=wim.voordeckers@uhasselt.be
 Maarten J. Voors=maarten.voors@wur.nl
 Matthias Vorell=vorell@rwi-essen.de
 Costas Vorlow=costas@vorlow.com
 Олег Юрьевич Воробьев (Oleg Yurievich Vorobyev)=oleg.yu.vorobyev@gmail.com
 Marc Vorsatz=mvorsatz@cee.uned.es
 Ton Vorst=avorst@feweb.vu.nl
 Dimitrios Vortelinos=dvortelinos@lincoln.ac.uk
 Ilya B. Voskoboynikov=ivoskoboynikov@hse.ru
 Graham M Voss=gvoss@uvic.ca
 Rainer Vosskamp=vosskamp@uni-kassel.de
 Alexander Vostroknutov=a.vostroknutov@maastrichtuniversity.nl
 Miloslav Vošvrda=vosvrda@utia.cas.cz
 Jana Votapkova (Prochazkova)=prochazkova.jana@hotmail.com
 Vlasios Voudouris=vlasios.voudouris@abm-analytics.com
 Nikolaos Voukelatos=n.voukelatos@kent.ac.uk
 Angelos T. Vouldis=vouldis@gmail.com
 Ann Vourc'h=ann.vourch@oecd.org
 Evangelia Vourvachaki=evangelia.vourvachaki@cerge-ei.cz
 Dimitra Vouvaki=dimitra@econ.soc.uoc.gr
 Võ Xuân Vinh=vxvinh@yahoo.com
 Annie Voy=voy@gonzaga.edu
 Ebru Voyvoda=voyvoda@metu.edu.tr
 Liudmila Yu. Voznaya=ludmila.vozna@gmail.com
 Radu Vranceanu=vranceanu@essec.fr
 Liesbet Vranken=liesbetvranken@hotmail.com
 Anders Vredin=anders.vredin@riksbank.se
 James Raymond Vreeland=james.raymond.vreeland@gmail.com
 Nicolaas J. Vriend=n.vriend@qmul.ac.uk
 Hendrik Vrijburg=vrijburg@ese.eur.nl
 Susan Vroman=vromans@georgetown.edu
 Ioannis Vrontos=vrontos@aueb.gr
 Ha Thi Hong Vu=ha.vu@deakin.edu.au
 Guillaume Vuillemey=guillaume.vuillemey@sciences-po.org
 Joseph D. Vu=jvu@depaul.edu
 Vuk Vukovic=vuk.vukovic1@gmail.com
 Guillermo Javier Vuletin=gvuletin@brookings.edu
 Linh Hoang Vu=vhlinh16@yahoo.com
 Giuseppe Vulpes=giuseppe.vulpes@unicreditgroup.eu
 Nhung Thi Hong Vu=vthnhung@ctu.edu.vn
 Quan-Hoang Vuong=qvuong@ulb.ac.be
 Tommi A. Vuorenmaa=tvuorenm@gmail.com
 Daniela Vuri=daniela.vuri@uniroma2.it
 Ondrej Vychodil=ovychodil@csob.cz
 Jana Vyrastekova=j.vyrastekova@fm.ru.nl
 Tomáš Výrost=tomas.vyrost@euke.sk
 Alexey S. Vyskrebentsev=tatalex@yandex.ru
 Edward Vytlacil=vytlacil@nyu.edu
