 Stephan Dabbert=stephan.dabbert@uni-hohenheim.de
 Dan Cristian Dabija=cristi_dabija@yahoo.com
 Marcelo Pedro Dabós=marcelo.dabos@comunidad.ub.edu.ar
 Marek DABROWSKI=marek.dabrowski@case-research.eu
 Jovi Clemente Dacanay=jovi.dacanay@uap.asia
 Luca D'Acci=lucadacci@gmail.com
 Benjamin Dachis=ben@cdhowe.org
 Luca D'Acierno=luca.dacierno@unina.it
 Carlos Eugênio Ellery Lustosa da Costa=carlos.eugenio@fgv.br
 Rita Alexandra Da Costa Pires=rita.dacosta@oecd.org
 Dimitrios Dadakas=dimitriosntantakas@uowdubai.ac.ae
 Gaetano D'Adamo=gaetano.dadamo@uv.es
 Ramin Dadasov=ramin.dadasov@rwth-aachen.de
 Stefano d'Addona=daddona@uniroma3.it
 Ali Dadpay=ali.dadpay@gmail.com
 Alexandra Renate Daea=alexandradaea@yahoo.com
 Yannis Dafermos=yannis.dafermos@uwe.ac.uk
 José DA FONSECA=jose.dafonseca@aut.ac.nz
 Márcia Batista Da Fonseca=mb_marcia@hotmail.com
 Nir Dagan=nir@nirdagan.com
 Antonio D'Agata=adagata@unict.it
 Zara Daghbashyan=zarad@kth.se
 Toby Daglish=toby.daglish@vuw.ac.nz
 Olivier Dagnelie=olivier.dagnelie@gmail.com
 Antonello D'Agostino=a.dagostino@esm.europa.eu
 Giorgio d'Agostino=gdagostino@uniroma3.it
 Lorena Maria D'Agostino=ldagosti@unict.it
 Elena D'Agosto=elena.dagosto@agenziaentrate.it
 Momi Dahan=momidahan@mscc.huji.ac.il
 Wassim E. Daher=daher.w@gust.edu.kw
 Matz Dahlberg=matz.dahlberg@nek.uu.se
 Bev Dahlby=bgdahlby@ucalgary.ca
 Christian Dahl=cmd@sam.sdu.dk
 Drew Dahl=drew.dahl@usu.edu
 Rainer Dahlhaus=dahlhaus@statlab.uni-heidelberg.de
 Michael S. Dahl=md@business.aau.dk
 Roy Endré Dahl=roy.e.dahl@uis.no
 Tobias Dahlström=tobias.dahlstrom@pubcare.uu.se
 Matthias Dahm=matthias.dahm@nottingham.ac.uk
 Kohei Daido=daido@kwansei.ac.jp
 Silvio Daidone=silvio.daidone@york.ac.uk
 Feng Dai=fengdai@126.com
 Adam Joseph Daigneault=daigneaulta@landcareresearch.co.nz
 Meixing Dai=dai@unistra.fr
 Shuanping Dai=daishuanping@hotmail.com
 Ahlem Dakhlaoui=dakhlaoui.ahlem@planet.tn
 Sami Dakhlia=sami.dakhlia@gmail.com
 Arnak Dalalyan=arnak.dalalyan@ensae.fr
 Marcos Jose Dal Bianco=marcos.dalbianco@bbva.com
 Hippolyte d'Albis=dalbis@univ-paris1.fr
 Pedro Dal Bó=pedro_dal_bo@brown.edu
 Douglas Robert Dalenberg=doug.dalenberg@mso.umt.edu
 Simone D'Alessandro=s.dale@ec.unipi.it
 Giovanni D'Alessio=giovanni.dalessio@bancaditalia.it
 Carl-Johan Dalgaard=carl.johan.dalgaard@econ.ku.dk
 Nuh Aygun Dalkiran=dalkiran@bilkent.edu.tr
 Armando João Dalla Costa, Sr.=ajdcosta@ufpr.br
 Violetta Dalla=violetta.dalla@econ.uoa.gr
 Sandy Dall'erba=dallerba@email.arizona.edu
 Marius Dan V. Dalotă=marius_dalota@yahoo.com
 Muriel DAL-PONT LEGRAND=muriel.dal-pont-legrand@univ-lille1.fr
 Thomas Dalsgaard=thdal@dongenergy.dk
 John T. Dalton=daltonjt@wfu.edu
 Patricio Santiago Dalton=p.s.dalton@uvt.nl
 Hounaida Daly=hounaida.daly@gmail.com
 Moira Kate Daly=moda.eco@cbs.dk
 Nurdilek Dalziel=nd80@le.ac.uk
 Romulus-Catalin Damaceanu=romulus_catalin_damaceanu@yahoo.com
 Carlos da Maia=carlosmaia@sun.ac.za
 Ana Damas de Matos=ana.damas-de-matos@hec.ca
 Laura Inés D'Amato=ldamato@bcra.gov.ar
 Marcello D'Amato=damato@unisa.it
 Conchita D'Ambrosio=conchita.dambrosio@gmail.com
 Ettore Damiano=ettore.damiano@utoronto.ca
 Damian S. Damianov=damian.damianov@durham.ac.uk
 Dr. Ev D'amigo=drdamigos@eurocapital.org.uk
 Joze P. Damijan=joze.damijan@ef.uni-lj.si
 Tatiana Damjanovic=t.damjanovic@exeter.ac.uk
 Vladislav Damjanovic=v.damjanovic@exeter.ac.uk
 Anna Piil Damm=apd@asb.dk
 Niels Arne Dam=nad@nationalbanken.dk
 Francesco D'Amuri=francesco.damuri@gmail.com
 Daniela Emanuela Dănăcică=danadde@yahoo.com
 James D. Dana, Jr.=j.dana@neu.edu
 Eric Danan=eric.danan@u-cergy.fr
 Daniel Danau=daniel.danau@unicaen.fr
 Oscar Dancourt=odancou@pucp.edu.pe
 Roberto Dandi=rdandi@luiss.it
 Diego d'Andria=diego.dandria@gmail.com
 Jeff Danforth=jeff.danforth@cra-arc.gc.ca
 Anh Duc Dang=dang.ducanh@anu.edu.au
 Emanuela D'angelo=e.dangelo@univpm.it
 Hai-Anh H. Dang=hdang@worldbank.org
 Rani J. DANG=dang@gredeg.cnrs.fr
 Jérôme Danguy=jdanguy@ulb.ac.be
 Viet Anh Dang=vietanh.dang@mbs.ac.uk
 Betty C. Daniel=bdaniel@albany.edu
 Gianmarco Daniele=daniele.gianmarco@vub.ac.be
 Vittorio Daniele=v.daniele@unicz.it
 Romeo Danielis=danielis@units.it
 Laurent Daniel=laurentdaniel@yahoo.fr
 Lazar Daniel=lazar.dani@gmail.com
 Rhian Mair Daniel=rhian.daniel@lshtm.ac.uk
 Benjamin Daniels=bbdaniels@gmail.com
 Joseph P. Daniels=joseph.daniels@marquette.edu
 Kenneth N. Daniels=kndaniel@vcu.edu
 Lisa Daniels=ldaniels2@washcoll.edu
 Reza Che Daniels=reza.daniels@uct.ac.za
 Jon Danielsson=j.danielsson@lse.ac.uk
 Svetlana Danilkina=sdanilki@unimelb.edu.au
 Vladimir I. Danilov=danilov@cemi.rssi.ru
 Yuri Danilov=ydanilov@rambler.ru
 Hakan Danis=hdanis@uga.edu
 Ben Dankmeyer=dankmeyer.ben@planet.nl
 Alexandre Dankov=zavlab@politlab.org
 Christian Danne=dannec@tcd.ie
 Henry Dannenberg=henry.dannenberg@iwh-halle.de
 Till Dannewald=till.dannewald@wiwi.uni-goettingen.de
 Stephan Danninger=sdanninger@imf.org
 Marko Danon=marko.danon@gmail.com
 Mihaela Cornelia DAN (PREJMEREAN)=mihaela.c.dan@gmail.com
 Michael Danquah=danqua2@yahoo.com
 Jean-Pierre Danthine=jean-pierre.danthine@snb.ch
 Massimo D'Antoni=dantoni@unisi.it
 Mariano D'Antonio=dantonio@uniroma3.it
 Dan Constantin Dănuleţiu=dan.danuletiu@gmail.com
 Alexander M. Danzer=alexander.danzer@lrz.uni-muenchen.de
 Natalia Danzer (née Weißhaar)=danzer@ifo.de
 Leif Danziger=danziger@bgu.ac.il
 Nguyen Thang DAO=dao.nguyenthang@vepr.org.vn
 Joan Daouli=daouli@upatras.gr
 Olivia D'Aoust=odaoust@ulb.ac.be
 Jose Pablo Dapena Fernandez=jd@cema.edu.ar
 Eliane DAPHY=eliane.daphy@ehess.fr
 Dimitrios K. Dapontas=dapontas@uop.gr
 Donja Darai=donja.darai@econ.uzh.ch
 Cinzia Daraio=cinzia@sssup.it
 Arif Billah Dar=billaharif0@gmail.com
 Sandrine Daraut=sandrine.daraut@univ-tlse1.fr
 Julia Darby=julia.darby@strath.ac.uk
 Michael Darby=darby@ucla.edu
 Valentino Dardanoni=vdardano@unipa.it
 Michael Darden=mdarden1@tulane.edu
 František Dařena=frantisek.darena@gmail.com
 Marco Da Rin=marco.darin@uvt.nl
 Arup Daripa=a.daripa@bbk.ac.uk
 Eric Darmon=eric.darmon@univ-rennes1.fr
 Sebastiano Daros=sdaros@yahoo.co.uk
 Denis DARPY=denis.darpy@dauphine.fr
 Matthieu DARRACQ PARIES=matthieu.darracq_paries@ecb.int
 Theofanis Darsinos=tdarsinos@yahoo.co.uk
 Teguh Dartanto=teguh@lpem-feui.org
 Zsolt Darvas=zsolt.darvas@uni-corvinus.hu
 Arabinda Das=ara.das@gmail.com
 Cornelia Dascalu=cornelia.dascalu@cig.ase.ro
 Kristof Dascher=kristof.dascher@ur.de
 Debasish Kumar Das=deba_econ@yahoo.com
 Dhiman Das=aridd@nus.edu.sg
 Gouranga Gopal Das=gouranga_das@hotmail.com
 Basab Dasgpta=bdasgupta@worldbank.org
 Indraneel Dasgupta=indraneel@isical.ac.in
 Kunal Dasgupta=kunal.dasgupta@utoronto.ca
 Monica Das Gupta=mdasgupta@gmail.com
 Susmita Dasgupta=sdasgupta@worldbank.org
 Bharatee Bhusana Dash=bharatee.dash@nipfp.org.in
 Debasis Kumar Dash=debasis669@gmail.com
 Manoj Kumar Dash=manojctp@gmail.com
 Manasranjan Dashmishra=dashmishra@gmail.com
 Nicolas Da Silva=niconds@hotmail.fr
 Sergio Da Silva=professorsergiodasilva@gmail.com
 Ishita Das=dasishita27@yahoo.in
 Jayoti Das=dastina@elon.edu
 George Daskalakis=g.daskalakis@uea.ac.uk
 Irene Daskalopoulou=daskal@uop.gr
 Дасковский Вадим Борисович (Vadim Borisovich Daskovskiy)=vadimdask@ya.ru
 Kumar B. Das=drkumardas@gmail.com
 Marcel Das=das@uvt.nl
 Mausumi Das=mausumi@econdse.org
 Mitali Das=mdas@imf.org
 Monica Das=mdas@skidmore.edu
 Mousumi Das=mousumi@igidr.ac.in
 Pranab Kumar Das=pkdas@cssscal.org
 Claude d'Aspremont=claude.daspremont@uclouvain.be
 Rituparna Das=dr.rituparnadas@gmail.com
 Samarjit Das=samarjit@isical.ac.in
 Sanjiv Ranjan Das=srdas@scu.edu
 Satya P. Das=das@isid.ac.in
 Xeni Dassiou=x.dassiou@city.ac.uk
 Sonali Das=sdas@csir.co.za
 Sukanya Das=dasghosh.sukanya@gmail.com
 Seyit Ali Dastan=sdastan@epdk.org.tr
 Krishnendu Ghosh Dastidar=kgd12@yahoo.com
 Tuhin Kumar Das=tuhin22@hotmail.com
 Nabanita Datta Gupta=ndg@asb.dk
 Gaurav Datt=gaurav.datt@monash.edu
 Julien Daubanes=jdaubanes@ethz.ch
 Estelle P. Dauchy=edauchy@nes.ru
 Christian Daude=christian.daude@oecd.org
 Guillaume Daudin=gdaudin@mac.com
 Andrew F. Daughety=andrew.f.daughety@vanderbilt.edu
 Marie Daumal=marie.daumal@univ-paris8.fr
 Sven-Olov Daunfeldt=sven-olov.daunfeldt@ratio.se
 Anyck Dauphin=anyck.dauphin@uqo.ca
 Alessio D'Auria=aldauria@unina.it
 Bardhyl DAUTI=bardhyl.dauti@unite.edu.mk
 Eleonora Davalos=eleodavalos@gmail.com
 Ezra Davar=ezra.davar@gmail.com
 Chetan Dave=chetdav@gmail.com
 Dhaval M. Dave=ddave@bentley.edu
 Bernardo da Veiga=b.daveiga@curtin.edu.au
 Francesco Daveri=francesco.daveri@unipr.it
 Anda M. David=david@dial.prd.fr
 Joel David=joeldavi@usc.edu
 Sophia Davidova=s.m.davidova@kent.ac.uk
 Paul A. David=pad@stanford.edu
 Quentin David=quentin.max.david@gmail.com
 Carl Davidson=davidso4@msu.edu
 James Davidson=james.davidson@exeter.ac.uk
 Paul Davidson=pdavidson@utk.edu
 Aled Rhys Davies=aled.davies@mansfield.ox.ac.uk
 Antony Davies=antony@antolin-davies.com
 Ceri Davies=daviescr1@cardiff.ac.uk
 James Byron Davies=jdavies@uwo.ca
 Peter I. Davies=p.davies.1@bham.ac.uk
 Ronald Davies=ronbdavies@gmail.com
 Simon Davies=frayedworld@gmail.com
 Troy Davig=troy.davig@kc.frb.org
 Julio Dávila=julio.davila@uclouvain.be
 Carmela D'Avino=cdavino@unive.it
 Brent James Davis=bjdavis@fsu.edu
 Christopher Mark Davis=christopher.davis@economics.ox.ac.uk
 David E. Davis=david.davis@sdstate.edu
 Donald R. Davis=drd28@columbia.edu
 Douglas D. Davis=dddavis@vcu.edu
 E Philip Davis=e_philip_davis@msn.com
 George Keith Davis=davisgk@muohio.edu
 John Bryan Davis=john.davis@marquette.edu
 Jonathan Scott Davis=scott.davis@dal.frb.org
 Kristin Elizabeth Davis=k.davis@cgiar.org
 Lucas W. Davis=ldavis@haas.berkeley.edu
 Michael C Davis=davismc@mst.edu
 Morris Davis=mdavis@bus.wisc.edu
 Nick Davis=davisna@xtra.co.nz
 Peter Davis=peter_john_davis@yahoo.com
 Steven Davis=steven.davis@chicagobooth.edu
 Lucie Davoine=lucie.davoine@gmail.com
 Nurhan Davutyan=dnurhan@hotmail.com
 Georges DAW=georgdaw@gmail.com
 John W. Dawson=dawsonjw@appstate.edu
 Na L. Dawson=ndawson@analysisgroup.com
 Peter C Dawson=petercdawson@yahoo.com
 Peter Michael Dawson=dawsonpeterm@gmail.com
 Thomas Dax=thomas.dax@babf.bmlfuw.gv.at
 Jeff Dayton-Johnson=jdaytonjohnson@miis.edu
 Ricardo A. Daziano=daziano@cornell.edu
 Tosson Nabil Deabes=tossondeabes1@hotmail.com
 Adela Deaconu=adela.deaconu@econ.ubbcluj.ro
 Paola De Agostini=pdeago@essex.ac.uk
 Wenersamy Ramos de Alcantara=wenersamy.alcantara@bcb.gov.br
 Andrés Dean=adean@iecon.ccee.edu.uy
 Fabio Wendling Muniz de Andrade=fabio.wendling@br.experian.com
 Rocio de Andres Calle=rocioac@usal.es
 Luca De Angelis=l.deangelis@unibo.it
 Judith M. Dean=judydean@brandeis.edu
 Mark Dean=mark_dean@brown.edu
 Giuseppe De Arcangelis=giuseppe.dearcangelis@uniroma1.it
 Rafael de Arce Borda=rafael.dearce@uam.es
 James A Dearden=jad8@lehigh.edu
 Lorraine Dearden=ldearden@ifs.org.uk
 Alan V. Deardorff=alandear@umich.edu
 Angus Deaton=deaton@princeton.edu
 Jason Matthew DeBacker=jason.debacker@gmail.com
 Olivier de Bandt=olivier.debandt@banque-france.fr
 Arnab Deb=arnab.deb@imi.edu
 Nicolas Debarsy=nicolas.debarsy@univ-orleans.fr
 Charles de Bartolome=charles.debartolome@colorado.edu
 Francesca De Battisti=francesca.debattisti@unimi.it
 Majdi Debbich=majdi.debbich@ens.fr
 Zelalem Yilma=zelexyilma@gmail.com
 Guy Debelle=debelleg@rba.gov.au
 Luca De Benedictis=debene@unimc.it
 David L. Debertin=ddeberti@uky.edu
 Jean-Etienne de Bettignies=jdebettignies@business.queensu.ca
 Paul de Bijl=paul@radicandeconomics.com
 Joyee Deb=joyee.deb@nyu.edu
 Kaushik Deb=kaushikdeb@gmail.com
 Beatriz de Blas=beatriz.deblas@uam.es
 Koen W. De Bock=k.debock@ieseg.fr
 Riccardo De Bonis=riccardo.debonis@bancaditalia.it
 Dario Debowicz=dariodebowicz@gmail.com
 Partha Deb=partha.deb@hunter.cuny.edu
 Rahul Deb=rahul.deb@utoronto.ca
 Alan de Brauw=alandebrauw@gmail.com
 Marisa P. de Brito=marisadebrito03@yahoo.com
 Alan E. de Bromhead=alan.debromhead@mansfield.ox.ac.uk
 Xavier Debrun=xdebrun@imf.org
 Karolien De Bruyne=karolien.debruyne@kuleuven.be
 Saubhik Deb=sdeb@worldbank.org
 Margarita Debuque-Gonzales=mdgonzales@econ.upd.edu.ph
 Bernard Decaluwe=bdec@ecn.ulaval.ca
 Aurélien DECAMPS=aurelien.decamps@kedgebs.com
 Marc Decamps=marc.decamps@fortis.com
 Koen Decancq=koen.decancq@ua.ac.be
 Stephen DeCanio=decanio@econ.ucsb.edu
 Stéphane De Cara=stdecara@grignon.inra.fr
 Francesco Decarolis=fdc@ssc.wisc.edu
 Irineu Evangelista de Carvalho Filho=idecarvalhofilho@imf.org
 Miguel de Carvalho=mdecarvalho@mat.puc.cl
 Francisco de Castro Fernández=fcastro@bde.es
 Luciano Irineu de Castro=decastro.luciano@gmail.com
 Clément de Chaisemartin=clementdechaisemartin@gmail.com
 Enrica De Cian=enrica.decian@feem.it
 Geoffroy de Clippel=declippel@brown.edu
 Alexandre de Cornière=adecorniere@gmail.com
 Jean-Marie De Corte=decorte@umons.ac.be
 André Decoster=andre.decoster@econ.kuleuven.be
 Bruno Decreuse=bruno.decreuse@univ-amu.fr
 Yvan Decreux=y.decreux@gmail.com
 Maria Luisa Decuir-Viruez=luisadecuir@hotmail.com
 Razvan Nicolae Decuseara=dec_vl@yahoo.com
 Debdeep De=debdeepde@gmail.com
 Luca Dedola=luca.dedola@ecb.int
 Laura de Dominicis=ldedominicis@libero.it
 Jan de Dreu=jandedreu@gmail.com
 Vasile Dedu=vdedu03@yahoo.com
 Ramiro de Elejalde=ramirode@gmail.com
 Philippa S. Dee=philippa.dee@anu.edu.au
 Carmen Diana Deere=deere@ufl.edu
 Rataporn Deesomsak=rdeesomsak@yahoo.co.uk
 Stephane Dees=stephane.dees@ecb.int
 Thomas Dee=tsdee1@gmail.com
 Marcus Deetz=mdeetz@uni-bremen.de
 Aquiles Rocha de Farias=aquiles.farias@bcb.gov.br
 João José de Farias Neto=joaojfn@ieav.cta.br
 Éric Defebvre=eric.defebvre@univ-paris-est.fr
 Giuseppe De Feo=giuseppe.defeo@strath.ac.uk
 Fabrice Defever=f.defever@lse.ac.uk
 Alex Michael Deffner=adeffner@prd.uth.gr
 Enzo Defilippi=defilippi_ef@up.edu.pe
 Fabrizio De Filippis=fabrizio.defilippis@uniroma3.it
 Fiorella De Fiore=fiorella.de_fiore@ecb.int
 Patricia Deflorin=patricia.deflorin@isu.uzh.ch
 Gianni De Fraja=gianni.defraja@nottingham.ac.uk
 Massimo A. De Francesco=defrancesco@unisi.it
 Eva de Francisco=edefrancisco@towson.edu
 Jenny De Freitas=jenny.defreitas@uib.es
 Luciano Charlita de Freitas=lucianofreitas@live.com
 Miguel Lebre de Freitas=afreitas@ua.pt
 Claudia De Fuentes=claudia.defuentes@smu.ca
 Anthony A. DeFusco=defusco@wharton.upenn.edu
 Ramon P. DeGennaro=rdegenna@utk.edu
 Ronald Jean Degen=rjdegen@gmail.com
 Francois Degeorge=francois.degeorge@usi.ch
 Ahmet Değerli=ahmet.degerli@tcmb.gov.tr
 Enrico De Giorgi=enrico.degiorgi@unisg.ch
 Giacomo De Giorgi=giacomo.degiorgi@gmail.com
 Giacomo Degli Antoni=giacomo.degliantoni@unipr.it
 Diana B. De Graeve=diana.degraeve@uantwerpen.be
 Louis de Grange=louis.degrange@udp.cl
 Jose De Gregorio=jdegregorio@fen.uchile.cl
 Andries de Grip=a.degrip@maastrichtuniversity.nl
 Henri L.F. de Groot=h.l.f.de.groot@vu.nl
 Olaf J. de Groot=olaf.degroot@cepal.org
 Hans Degryse=h.degryse@uvt.nl
 Gustavo José de Guimarães e Souza=gustavojgs@gmail.com
 Jakob de Haan=jakob.de.haan@rug.nl
 Leo de Haan=l.de.haan@dnb.nl
 Monique De Haan=moniqued@econ.uio.no
 Ralph De Haas=dehaasr@ebrd.com
 Paul de Hek=dehek@seor.eur.nl
 Jose de Hevia=jose.dehevia@urjc.es
 Pierre Dehez=pierre.dehez@uclouvain.be
 Hossein Dehghanisanij=h.dehghanisanij@gmail.com
 Omid Dehghan Nejad=omiddehghan81@yahoo.com
 Catherine Dehon=cdehon@ulb.ac.be
 Rafael E. De Hoyos=redeho@gmail.com
 Luca Deidda=deidda@uniss.it
 Manuela Deidda=manuela.deidda@unica.it
 Florent Deisting=florent.deisting@esc-pau.fr
 Richard Deitz=richard.deitz@ny.frb.org
 Alain de Janvry=alain@berkeley.edu
 Marcus Dejardin=marcus.dejardin@unamur.be
 Sylvain Dejean=sylvain.dejean@univ-lr.fr
 Muriel Dejemeppe=muriel.dejemeppe@uclouvain.be
 David N. DeJong=dejong@pitt.edu
 Olivier De Jonghe=o.dejonghe@uvt.nl
 Trudo Dejonghe=trudo.dejonghe@lessius.eu
 Marielle de Jong=mdejong@hotmail.com
 Pieter J. de Jong=paldejong@yahoo.com
 Joseph DeJuan=jdejuan@uwaterloo.ca
 Eddie Dekel=dekel@northwestern.edu
 Anne-Marie de Kerchove=kerchove@fusl.ac.be
 David Dekker=ddekker@few.eur.nl
 Marleen Dekker=mdekker@ascleiden.nl
 Rommert Dekker=rdekker@few.eur.nl
 Jasper Dekkers=j.dekkers@vu.nl
 Thijs Dekker=t.dekker@tudelft.nl
 Robert Dekle=dekle@usc.edu
 Jan de Kok=j.de.kok@panteia.nl
 Kees De Koning=keesdekoning008@hotmail.com
 hubert de La Bruslerie=hlb@dauphine.fr
 Philippe Delacote=philippe.delacote@nancy.inra.fr
 Alain Delacroix=delacroix.alain@uqam.ca
 David de la Croix=david.delacroix@uclouvain.be
 Juan J. DelaCruz=juan.delacruz2@lehman.cuny.edu
 Pedro González de La Fe=pgonzalez@daea.ulpgc.es
 Angel de La Fuente=angel.delafuente@uab.es
 Mª Covadonga De la Iglesia Villasol (M. Covadonga De la Iglesia Villasol)=civ@ccee.ucm.es
 Dolores de la Mata=maria.delamata@urosario.edu.co
 Tamara de la Mata=tamara.delamata@uam.es
 Austin Delaney=austin@austindelaney.eu
 Liam Delaney=liam.delaney@stir.ac.uk
 Peter W. de Langen=p.w.d.langen@tue.nl
 Marie J. dela Rama=marie.delarama@uts.edu.au
 Sara De La Rica=sara.delarica@ehu.es
 Catherine Sarlandie de La Robertie=catherine.delarobertie@univ-rennes1.fr
 Jorge De la Roca=jorge.delaroca@nyu.edu
 Guillemette de Larquier=larquier@u-paris10.fr
 Augusto de la Torre=adelatorre@worldbank.org
 José Manuel de La Torre-Ruiz=jmtorre@ugr.es
 Daniel G. De La Torre Ugarte=danieltu@utk.edu
 Anne-Laure Delatte=annelaure.delatte@sciencespo.fr
 Clara Delavallade=clara.delavallade@ensae.org
 Adeline Delavande=aldela@essex.ac.uk
 Mara Del Baldo=mara.delbaldo@uniurb.it
 Tomás del Barrio Castro=tomas.barrio@uib.es
 Benoit A. Delbecq=bdelbecq@ers.usda.gov
 Alessandra Angiola Maria Del Boca=delboca@eco.unibs.it
 Daniela Del Boca=dani.delboca@unito.it
 Chiara Del Bo=chiara.delbo@unimi.it
 Emilia Del Bono=edelbono@essex.ac.uk
 Esther B. Del Brio=edelbrio@usal.es
 Henry Delcamp=henry.delcamp@ensmp.fr
 Carlos del Carpio=carlos.delcarpio@efinlab.com
 Ximena V. Del Carpio=xdelcarpio@worldbank.org
 Barbara Del Corpo=barbaradelcorpo@inwind.it
 Julio del Corral=corraljulio@uniovi.es
 Aurelie Delemarle=a.delemarle@esiee.fr
 Adrian de Leon-Arias=leonarias2013@gmail.com
 Josse Delfgaauw=delfgaauw@ese.eur.nl
 Miguel Tomás Delfiner, Sr.=mdelfiner@bcra.gov.ar
 Catarina Delgado=cdelgado@fep.up.pt
 FELIX DELGADO, Sr.=dfelix746@gmail.com
 Francisco J. Delgado=fdelgado@uniovi.es
 Juan Delgado=delgado.juan@gmail.com
 Miguel A. Delgado=delgado@est-econ.uc3m.es
 Maria Jesus Delgado Rodriguez=mariajesus.delgado@urjc.es
 Teresa Del Giudice=agriqual@unina.it
 Jan Delhey=j.delhey@jacobs-university.de
 Enrico D'Elia=delia.enrico@gmail.com
 Vanesa Valeria D'Elia=vvd04@cema.edu.ar
 Ertuğrul Deliktaş=ertugrul.deliktas@ege.edu.tr
 Radoslav Delina=radoslav.delina@tuke.sk
 Agelos Delis=a.delis@aston.ac.uk
 Manthos D. Delis=elmanthos@hotmail.com
 Arrigo della Gherardesca=arrigo.dg@tin.it
 Marina Della Giusta=m.dellagiusta@rdg.ac.uk
 Antonio Della Malva=antonio.dellamalva@kuleuven.be
 Roberto Dell'Anno=rdellanno@unisa.it
 Gerardo della Paolera=dellapaolerag@gmail.com
 Maëlle Della Peruta=maelle.della-peruta@gredeg.cnrs.fr
 Giovanni Dell'ariccia=gdellariccia@imf.org
 Giuseppe Della Torre=dellatorre@unisi.it
 Stefano DellaVigna=sdellavi@econ.berkeley.edu
 Simona Delle Chiaie=simona.dellechiaie@banque-france.fr
 Davide Delle Monache=d.dellemonache@qmul.ac.uk
 Mario Dell'Era=m.dellera@ec.unipi.it
 Salvatore Dell'Erba=salvatore.dellerba@graduateinstitute.ch
 Steven Deller=scdeller@wisc.edu
 Paolo Delle Site=paolo.dellesite@uniroma1.it
 Domenico Delli Gatti=domenico.delligatti@unicatt.it
 Arnaud Dellis=arnaud.dellis@ecn.ulaval.ca
 Frédéric Delmar=frederic.delmar@fek.lu.se
 Marco Delmastro=marcodelmastro@yahoo.it
 Elena Laureana del Mercato=elena.delmercato@univ-paris1.fr
 Marina Delmondes de Carvalho=marina.carvalho@yale.edu
 Marco Del Negro=mdn000@gmail.com
 Stephen B. DeLoach=deloach@elon.edu
 Jan K. De Loecker=jdeloeck@princeton.edu
 James Bradford DeLong=brad.delong@gmail.com
 Babur De los Santos=babur@indiana.edu
 Claire Delpeuch=claire.delpeuch@oecd.org
 Xavier Del Pozo=xavier.delpozo@econ.uzh.ch
 Elena Del Rey=elena.delrey@udg.edu
 Fernando del Rio=fernando.delrio@usc.es
 Coral del Rio Otero=crio@uvigo.es
 Maria Del Sorbo=maria.del-sorbo@ec.europa.eu
 George Deltas=deltas@uiuc.edu
 Giacomo Davide De Luca=giacomo.deluca@york.ac.uk
 Giovanni De Luca=giovanni.deluca@uniparthenope.it
 Giuseppe De Luca=giuseppe.de.luca@uniroma2.it
 Juan José de Lucio=juan.delucio@cscamaras.es
 Roperto S. Deluna, Jr.=rupertdeluna@gmail.com
 Ikerne del Valle=ikerne.delvalle@ehu.es
 Benoit Delzelle=bdelzelle@gmail.com
 Gauthier de Maere d'Aertrycke=gauthier.demaere@feem.it
 Leandro Machado de Magalhaes=leandro.demagalhaes@bristol.ac.uk
 Gabrielle Demange=demange@pse.ens.fr
 Mirzha de Manuel=mirzha.demanuel@cfainstitute.org
 Nathalie de Marcellis-Warin=demarcen@cirano.qc.ca
 Valentina De Marchi=valentina.demarchi@unipd.it
 Salvatore Michele De Marco=s.demarco@unifg.it
 Federica Demaria=demariaf@unical.it
 Paola Demartini=pdemartini@uniroma3.it
 Nango Niama Dembele=dembele@msu.edu
 Otavio Ribeiro De Medeiros=otavio@unb.br
 Felipa de Mello-Sampayo=felipamsampayo@gmail.com
 Gioia de Melo=gioiademelo@iecon.ccee.edu.uy
 Jaime de Melo=jaime.demelo@unige.ch
 Suresh de Mel=sdemel@pdn.ac.lk
 Gui Pedro de Mendonça=g.p.a.de-mendonca@warwick.ac.uk
 Helder Ferreira de Mendonça=helderfm@hotmail.com
 George de Menil=gdemenil@demvest.com
 Elizabeth Anne Demers=demerse@darden.virginia.edu
 Frederick Demers=frederick.demers@credit-suisse.com
 Michel Demers=michel_demers@carleton.ca
 Aggeliki Demertzi=aggeldem@yahoo.gr
 Louis de Mesnard=louis.de-mesnard@u-bourgogne.fr
 Krisztina Demeter=kdemeter2220@gmail.com
 Matei Demetrescu=mdeme@stat-econ.uni-kiel.de
 Panicos Demetriades=pd28@le.ac.uk
 Yann de Mey=yann.demey@uhasselt.be
 Horia Demian=horia_demian@yahoo.com
 Andrea De Michelis=andrea.demichelis@frb.gov
 Svetlana A. Demidova=demidov@mcmaster.ca
 Carlos de Miguel, Sr.=carlos.demiguel@cepal.org
 Berna Demiralp=bedemiralp@hotmail.com
 Banu Demir=banup@bilkent.edu.tr
 Ufuk Devrim Demirel=ufukdevrim@gmail.com
 Ender Demir=ender.demir@medeniyet.edu.tr
 Riza Demirer=rdemire@siue.edu
 Firat Demir=fdemir@ou.edu
 Ihsan Cemil Demir=icdemir@aku.edu.tr
 Cem Demiroglu=cdemiroglu@ku.edu.tr
 Lilas DEMMOU=lilas.demmou@oecd.org
 Gabriel Demombynes=gdemombynes@worldbank.org
 Jean-Luc Demonsant=jldemonsant@gmail.com
 Matty Demont=m.demont@irri.org
 Charles Ulises De Montreuil Carmona=carmona@ufpe.br
 Ruud A. de Mooij=rdemooij@imf.org
 Lieven De Moor=lieven.de.moor@vub.ac.be
 Tine De Moor=t.demoor@uu.nl
 Antonis Demos=demos@aueb.gr
 Dominique Demougin=demougin@liverpool.ac.uk
 Nathalie Demoulin=n.demoulin@ieseg.fr
 Michael Demoussis=micdem@upatras.gr
 Daniel James de Munnik=dmunnik@bankofcanada.ca
 Sylvie Démurger=demurger@gate.cnrs.fr
 Pasquale De Muro=pasquale.demuro@uniroma3.it
 Thomas Demuynck=t.demuynck@maastrichtuniversity.nl
 Yuliya Demyanyk=yuliya.demyanyk@clev.frb.org
 Michele De Nadai=michele.denadai@unipd.it
 Laurent Denant-Boemont=laurent.denant-boemont@univ-rennes1.fr
 Mariacristina De Nardi=denardim@nber.org
 Frank A.G. Den Butter=fbutter@feweb.vu.nl
 Ai Deng=dengai929@gmail.com
 Paul Duo Deng=pdd.eco@cbs.dk
 Wen-Shuenn Deng=121350@mail.tku.edu.tw
 Xiang Deng=dengxiangecon@hotmail.com
 Xiangzheng Deng, Sr.=dengxz.ccap@igsnrr.ac.cn
 Yongheng Deng=ydeng@nus.edu.sg
 Ziliang Deng=ziliang.deng@ruc.edu.cn
 Wouter Denhaan=wjdenhaan@gmail.com
 Dick Den Hertog=d.denhertog@uvt.nl
 Pim Den Hertog=denhertog@dialogic.nl
 Francesca de Nicola=fdenicola@worldbank.org
 Vincenzo Denicolo'=vincenzo.denicolo@unibo.it
 Andy Denis=a.denis@city.ac.uk
 Jean-Philippe Denis=jean-philippe.denis@u-paris10.fr
 Irina A. Denisova=idenisova@cefir.ru
 Cevdet A. Denizer=cd.cee@boun.edu.tr
 Pınar Deniz=pinar.deniz@yahoo.co.uk
 Robert Denk=robert.denk@uni-konstanz.de
 Mario Denni=mario.denni@agcm.it
 Benjamin N. Dennis=bdennis@uop.edu
 Richard Dennis=richard.dennis@glasgow.ac.uk
 Eleanor Denny=dennye@tcd.ie
 Kevin John Denny=kevin.denny@ucd.ie
 Ivan De Noni=ivan.denoni@unimi.it
 Michiel De Nooij=michiel.denooij@hotmail.com
 Darinka Dentcheva=darinka.dentcheva@stevens.edu
 Oindrila De=oindrila@iimidr.ac.in
 Luiz Guilherme De Oliveira=lgoliveira@unb.br
 Rohit S. Deo=rdeo@stern.nyu.edu
 Juan Carlos de Pablo=depablo43@hotmail.com
 Pierangelo De Pace=pierangelo.depace@pomona.edu
 André de Palma=andre.depalma@ens-cachan.fr
 Domenico Depalo=domenico.depalo@bancaditalia.it
 Andrea de Panizza=andrea.depanizza@istat.it
 Maria De Paola=m.depaola@unical.it
 Anna Sibilla Francesca De Paoli=anna.depaoli@unimib.it
 Bianca De Paoli=bianca.depaoli@ny.frb.org
 Luiz Fernando de Paula=luizfpaula@terra.com.br
 Christian de Peretti=christian.de-peretti@sfr.fr
 Antonio De Pin=dep@unive.it
 Alessandro (Alex) De Pinto=a.depinto@cgiar.org
 Prabal de=contactprabal@yahoo.com
 Laure Bellice de Preux=l.depreux@imperial.ac.uk
 Celine de Quatrebarbes=celine.dequatrebarbes@gmail.com
 David Dequech=dequech@eco.unicamp.br
 Jonathan de Quidt=jonathan.dequidt@iies.su.se
 Vianney Dequiedt=vianney.dequiedt@u-clermont1.fr
 Miguel de Quinto=mdequinto@sic.gov.co
 Sebastian J. A. de-Ramon=sebastian.de-ramon@bankofengland.co.uk
 Kelly DeRango=kderango@gmail.com
 Pablo N. D'Erasmo=pabloderasmo@gmail.com
 Stefan Dercon=stefan.dercon@economics.ox.ac.uk
 Joppe de Ree=joppederee@gmail.com
 David R. DeRemer=david.de.remer@ulb.ac.be
 Temesgen Tadesse Deressa=ttderessa@yahoo.com
 Rafael Barros de Rezende=rafael.rezende@hhs.se
 Theologos Dergiades=t.dergiades@ihu.edu.gr
 Catherine Deri Armstrong=cdarmstrong@uottawa.ca
 Jean Derks=jean.derks@maastrichtuniversity.nl
 jean m. Dermine=jean.dermine@insead.edu
 Sofia V. Dermisi=sdermisi@roosevelt.edu
 Frédéric Deroïan=frederic.deroian@univ-amu.fr
 Nicolas de Roos=nicolas.deroos@sydney.edu.au
 Donato De Rosa=dderosa@worldbank.org
 Nicolás De Roux=nd2282@columbia.edu
 Robert de Rozario=rob.rozario@unsw.edu.au
 Ginés de Rus=gderus@daea.ulpgc.es
 Julien Derveeuw=julien.derveeuw@gmail.com
 Alexis Derviz=alexis.derviz@cnb.cz
 Tatyana Deryugina=deryugin@illinois.edu
 Sameeksha Desai=desai@indiana.edu
 Roberta de Santis=rdesantis@istat.it
 Roberto A. De Santis=roberto.de_santis@ecb.int
 Audrey Desbonnet=audrey.desbonnet@dauphine.fr
 Philippe Desbrières=philippe.desbrieres@u-bourgogne.fr
 Marc Deschamps=marc.deschamps@gredeg.cnrs.fr
 Xavier De Scheemaekere=xdeschee@ulb.ac.be
 Ann De Schepper=ann.deschepper@ua.ac.be
 Peter DeScioli=pdescioli@gmail.com
 Alain Desdoigts=adesdoigts@free.fr
 Ivan Deseatnicov=ivan@aoni.waseda.jp
 Kurt A. Desender=kdesende@emp.uc3m.es
 Alain de Serres=alain.deserres@oecd.org
 Gabriel Desgranges=gabriel.desgranges@u-cergy.fr
 Priya Deshingkar=p.deshingkar@sussex.ac.uk
 Ashwini Deshpande=ashwini@econdse.org
 R S. Deshpande=rs.kalbandi@gmail.com
 Lionel Jacques Désiage=lionel.desiage@univ-mlv.fr
 Rita De Siano=desiano@uniparthenope.it
 Saul Desiderio=saul1979@libero.it
 Ashton de Silva=ashton.desilva@rmit.edu.au
 Dakshina G. De Silva=d.desilva@lancaster.ac.uk
 Indunil de Silva=siudesilva@hotmail.com
 Sanjaya Desilva=desilva@bard.edu
 Elina De Simone=elina.desimone@uniparthenope.it
 Gianfranco De Simone=gianfranco.desimone@fga.it
 Evangelia Desli=desli@econ.auth.gr
 David Desmarchelier=david.desmarchelier@gmail.com
 Dries De Smet=dries.desmet@econ.kuleuven.be
 Klaus Desmet=klaus.desmet@uc3m.es
 Pierre DESMET=pierre.desmet@dauphine.fr
 José de Sousa=jose.de-sousa@u-psud.fr
 Joaquim Bento de Souza Ferreira Filho=jbsferre@usp.br
 Bert D'Espallier=bert.despallier@hubrussel.be
 Wouter Dessein=wd2179@columbia.edu
 Bartlomiej Dessoulavy-Sliwinski=bsliwinski@wne.uw.edu.pl
 Orietta Dessy=orietta.dessy@unicatt.it
 Sylvain Dessy=sdes@ecn.ulaval.ca
 Christophe DESTAIS=christophe.destais@cepii.fr
 Sergio Destefanis=destefanis@unisa.it
 Gilles DESVE=g.desve@epiconcept.fr
 Panos Desyllas=panos.desyllas@mbs.ac.uk
 Jean-Jacques Dethier=jdethier@worldbank.org
 Enrica Detragiache=edetragiache@imf.org
 Gilles DE TRUCHIS=gilles.de-truchis@univ-amu.fr
 Georg Dettmann=georg.dettmann@univr.it
 Bianka Dettmer=bianka.dettmer@uni-jena.de
 Utpal Kumar de=utpalkde@gmail.com
 Evelyn Shyamala Devadason=evelyns@um.edu.my
 Xavier de Vanssay=devanssay@glendon.yorku.ca
 Haritharan=haree_om@hotmail.com
 Suresh Kumar Devarajulu=rithusuresh@yahoo.com
 Jed DeVaro=jed.devaro@csueastbay.edu
 François-Xavier de Vaujany=devaujany@dauphine.fr
 Michael B. Devereux=devm@interchange.ubc.ca
 Michael P. Devereux=michael.devereux@sbs.ox.ac.uk
 Paul J. Devereux=devereux@ucd.ie
 Francesco Devicienti=francesco.devicienti@unito.it
 Nicolas De Vijlder=nicolas.devijlder@ugent.be
 Laurent DEVILLE=laurent.deville@gredeg.cnrs.fr
 Pierre de Villiers=apdv@sun.ac.za
 Timothy Michael Devinney=t.devinney@leeds.ac.uk
 Rose Anne Devlin=radevlin@uottawa.ca
 Michel Dévoluy=michel.devoluy@unistra.fr
 Erik Devos=hdevos@utep.edu
 Klaas de Vos=k.devos@uvt.nl
 Casper G. de Vries=cdevries@ese.eur.nl
 Johan Devriese=johan.devriese@accenture.com
 Frans P. de Vries=f.p.devries@stir.ac.uk
 Jacob J. de Vries=j.j.de.vries@vu.nl
 Michel De Vroey=michel.devroey@uclouvain.be
 Stefan de Vylder=sdvylder@algonet.se
 A.A. de Waal=andredewaal@planet.nl
 Anja De Waegenaere=a.m.b.dewaegenaere@uvt.nl
 Benoit Dewaele=bedewael@ulb.ac.be
 Damien de Walque=ddewalque@worldbank.org
 Grégory de Walque=gregory.dewalque@nbb.be
 Mathias Dewatripont=mdewat@ulb.ac.be
 Ian Louis Dew-Becker=beckeri@nber.org
 John Dewhurst=j.h.l.dewhurst@dundee.ac.uk
 Jasper de Winter=j.m.de.winter@dnb.nl
 Dirk P.M. De Wit=dirkpmdewit@outlook.com
 Erik Robert de Wit=erikrdewit@gmail.com
 Martinus Petrus de Wit=martindwt@gmail.com
 Kristof De Witte=kristof.dewitte@econ.kuleuven.be
 Ishita Dey=idey@uga.edu
 Jaya Dey=jdey2@slu.edu
 Shubhasis Dey=sdey@bank-banque-canada.ca
 Soma Dey=soma@nus.edu.sg
 Jan Dhaene=jan.dhaene@kuleuven.be
 Dharmendra Purush Dhakal=ddhakal@tnstate.edu
 Sanjit Dhami=sd106@le.ac.uk
 Biswajit Dhar=bisjit@gmail.com
 Paramita Dhar=paramita.dhar@ccsu.edu
 Kishore Kumar Dhavala=kishoredhavala@gmail.com
 Rajeev Dhawan=rdhawan@gsu.edu
 Siwapong Dheera-aumpon=dheera-aumpon.1@osu.edu
 Boubaker Dhehibi=bdhehibi07@webmails.com
 Isabelle DHERMENT-FERERE=dherment@univ-tln.fr
 Amrita Dhillon=amrita.dhillon@kcl.ac.uk
 Shatakshee Dhongde=shatakshee.dhongde@econ.gatech.edu
 Elizabeth Dhuey=elizabeth.dhuey@utoronto.ca
 Basanta R. Dhungana=hibasanta@yahoo.com
 Kevin C. Dhuyvetter=kcd@ksu.edu
 Emmanuel Dhyne=emmanuel.dhyne@nbb.be
 Mihaela Diaconu=d_mihaela@msn.com
 Sabrina Lucia Di Addario=sabrina.diaddario@bancaditalia.it
 Enzo Dia=enzo.dia@unimib.it
 Youssoupha Sakrya DIAGNE=zack.diagne@gmail.com
 Amadou Bassirou Diallo=adiallo5@gmail.com
 Ibrahima Amadou Diallo=zavren@gmail.com
 Dimitrios Diamantaras=dimitrios.diamantaras@temple.edu
 Effrosyni Diamantoudi=ediamant@alcor.concordia.ca
 Arthur Diamond=adiamond@unomaha.edu
 Peter A. Diamond=pdiamond@mit.edu
 Giuseppe Diana=giuseppe.diana@unistra.fr
 Xinshen Diao=x.diao@cgiar.org
 Gaoussou DIARRA=gadiarra@gmail.com
 Theo Diasakos=diasakos@gmail.com
 Daniel Dias=ddias@illinois.edu
 Joilson Dias=jdias@uem.br
 Rodnei Fagundes Dias, Sr.=rdias@inmetro.gov.br
 Diadié Diaw=diadie.diaw@univ-rennes2.fr
 Marc-Arthur Diaye=marc-arthur.diaye@eco.univ-evry.fr
 Antonia Díaz=andiaz@eco.uc3m.es
 José Gregorio Díaz Bahamonde=jdiazb@uc.cl
 Ángel Díaz-Chao=angel.diaz@urjc.es
 Bernardo Díaz de Astarloa=bernardo@psu.edu
 Eliseo Diaz=ediaz@colef.mx
 Emilio Díaz=emidiaz@us.es
 Ignacio Díaz-Emparanza=ignacio.diaz-emparanza@ehu.es
 Mirta Diaz Fernandez=mdiafer@upo.es
 Daniel Díaz-Fuentes=diazd@unican.es
 Javier Díaz-Giménez=jdiaz@iese.edu
 Jorge Diaz-Lanchas=jorge.diaz@uam.es
 Fernando Javier Díaz López=fernando.diazlopez@tno.nl
 Patricio R. Diaz Lucarelli=pdiazl@puc.cl
 Agustín Díaz-Pinés=adpines@yahoo.com
 Oscar Alberto Díaz Quevedo=odiaz@bcb.gob.bo
 Reinaldo Giraldo Díaz, Sr.=reinaldo.giraldo@unad.edu.co
 Carmen Diaz-Roldan=carmen.diazroldan@uclm.es
 Julián Díaz-Saavedra=julianalbertodiaz@ugr.es
 Jose Luis Diaz Sanchez=jdiazsanchez@worldbank.org
 Luis Diaz-Serrano=luis.diaz@urv.cat
 Carlos Andres Diaz Valdivia=carandiazv@gmail.com
 M. Rosario Diaz-Vazquez=rosario.diaz@usc.es
 Behzad T. Diba=dibab@georgetown.edu
 Ali Dib=adib@bankofcanada.ca
 Giovanni Di Bartolomeo=giovanni.dibartolomeo@uniroma1.it
 Ludovic Dibiaggio=ludovic.dibiaggio@skema.edu
 Daniela Teresa Di Cagno=ddicagno@luiss.it
 Emiliano Di Carlo=dicarloe@uniroma2.it
 Riccardo DiCecio=riccardo.dicecio@stls.frb.org
 Claudio Dicembrino=claudio.dicembrino@enel.com
 Antonio Di Cesare=antonio.dicesare@bancaditalia.it
 Marco Di Cintio=marco.dicintio@unisalento.it
 Richard Dickens=r.f.dickens@sussex.ac.uk
 Andrew Peter Dickerson=a.p.dickerson@sheffield.ac.uk
 Thorsten Dickhaus=dickhaus@math.hu-berlin.de
 Boris Dickow=dickow@uni-bremen.de
 Alex Dickson=alex.dickson@strath.ac.uk
 Matt Dickson=m.dickson@bath.ac.uk
 Vaughan Andrew Dickson=vadecon@unb.ca
 Mehmet F. Dicle=mfdicle@loyno.edu
 Stefano Di Colli=stedicolli@gmail.com
 Luca Di Corato=luca.di.corato@slu.se
 Valeria Di Cosmo=valeria.dicosmo@esri.ie
 Tatiana Didier=tdidier@worldbank.org
 Fabio Di Dio=fdidio@sogei.it
 Marco Di Domizio=mdidomizio@unite.it
 Francis Diebold=fdiebold@sas.upenn.edu
 Claude DIEBOLT=cdiebolt@unistra.fr
 Caroline Dieckhoener=c.dieckhoener@googlemail.com
 Sten Dieden=sten.dieden@actualytics.se
 Paul Diederen=paul@awt.nl
 Martin Diedrich=m.diedrich@fs.de
 Martin Diehl=martin.diehl@bundesbank.de
 Andreas Diekmann=diekmann@soz.gess.ethz.ch
 Jochen Diekmann=jdiekmann@diw.de
 Julian Dieler=dieler@ifo.de
 George C Diemer=diemerg@chc.edu
 Alan Diener=alan.diener@phac-aspc.gc.ca
 Ed Diener=ediener@s.psych.uiuc.edu
 Alistair Dieppe=alistair.dieppe@ecb.int
 Andreas Dietrich=andreas.dietrich@hslu.ch
 Karl Dietrich=dietrich@vwl.uni-hannover.de
 Michael Dietrich=m.dietrich@sheffield.ac.uk
 Jens Dietrichson=jens.dietrichson@nek.lu.se
 Michel Dietsch=michel.dietsch@unistra.fr
 Martin D. Dietz=mddietz@gmail.com
 Robert David Dietz=rdietz@nahb.com
 Njankoua Wandji Dieu Ne Dort=wndieunedort@yahoo.fr
 Martin Diewald=martin.diewald@uni-bielefeld.de
 Walter Erwin Diewert=erwin.diewert@ubc.ca
 Antonio Diez de los Rios=antonioddr@gmail.com
 Francisco Diez=francisco.diez@urjc.es
 Salvatore Di Falco=salvatore.difalco@unige.ch
 James A. DiGabriele=jim@dmcpa.com
 Luigi Di Gaetano=luigi.digaetano.10@ucl.ac.uk
 Valter Di Giacinto=valter.digiacinto@bancaditalia.it
 Marina Di Giacomo=marina.digiacomo@unito.it
 Giorgio Di Giorgio=gdg@luiss.it
 Viviana Di Giovinazzo=viviana.digiovinazzo@unimib.it
 Daniele Di Giulio=daniele.digiulio@hotmail.it
 Stefania Di Giuseppe=stefania.digiuseppe@gmail.com
 Corrado Di Guilmi=corrado.diguilmi@uts.edu.au
 Giovanni di Iasio=giovanni.diiasio@bancaditalia.it
 Elbert Dijkgraaf=dijkgraaf@ese.eur.nl
 Peter T. Dijkstra=p.t.dijkstra@rug.nl
 Cees Diks=c.g.h.diks@uva.nl
 Davide Di Laurea=dilaurea@istat.it
 Zafer Dilaver=z.dilaver@surrey.ac.uk
 Alexander Dilger=alexander.dilger@uni-muenster.de
 Di Liberto, Adriana=diliberto@unica.it
 Andrea Di Liddo=a.diliddo@unifg.it
 David Dillenberger=ddill@sas.upenn.edu
 Marcus Dillender=dillender@upjohn.org
 Verena Dill=dill@uni-trier.de
 Maryam Dilmaghani=maryam.dilmaghani@smu.ca
 Bogdan Dima=bogdandima2001@gmail.com
 Marco Di Maggio=md3226@columbia.edu
 Michele Di Maio=michele.dimaio@uniparthenope.it
 Eugen Dimant=eugen.dimant@wiwi.upb.de
 Charles-Henri DiMaria=charles-henri.dimaria@statec.etat.lu
 Vincenzo Di Maro=vdimaro@worldbank.org
 Joseph DiMasi=joseph.dimasi@tufts.edu
 Carmela Di Mauro=cdimauro@unict.it
 Filippo di Mauro=filippodi_mauro@t-online.de
 Gisela Di Meglio=gdimeglio@ccee.ucm.es
 Arcangelo Dimico=arcangelo_dimico@hotmail.it
 Alberto Di Minin=a.diminin@sssup.it
 Carolyn Dimitri=carolyn.dimitri@nyu.edu
 Dimitrios Dimitriou=ddimi@cc.uoi.gr
 Mihail Dimitriu=dimitriu689@gmail.com
 Valentina Dimitrova-Grajzl=dimitrova-grajzlvp@vmi.edu
 Makedonka Dona Dimitrova=dimitrova@uacs.edu.mk
 Dinko Dimitrov=dinko.dimitrov@mx.uni-saarland.de
 Митко Димитров (Mitko Dimitrov)=m.dimitrov@iki.bas.bg
 Pavel Dimitrov=paveld@unwe.acad.bg
 Michel Dimou=dimou@univ-tln.fr
 Ralitza Dimova Dimova=ralitza.dimova@manchester.ac.uk
 Bill Dimovski=wd@deakin.edu.au
 Elroy Dimson=edimson@london.edu
 Ariel Dinar=adinar@ucr.edu
 Violeta Mihaela Dinca=violetamihaeladinca@yahoo.fr
 Mark Dincecco=dincecco@umich.edu
 Hayrullah Dindar=hayrullah.dindar@bilgi.edu.tr
 Soumyananda Dinda=sdinda2000@yahoo.co.in
 Pietro Dindo=p.dindo@sssup.it
 Jonathan Ivan Dingel=jid2106@columbia.edu
 Michael Dinges=michael.dinges@ait.ac.at
 Helen (Hongyu) Ding=helending0623@gmail.com
 Ning Ding=ning.ding@anu.edu.au
 Sai Ding=sai.ding@glasgow.ac.uk
 Weili Ding=dingw@queensu.ca
 Huy Tran Ngoc Dinh=dtnhuy2010@gmail.com
 Virginia Di Nino=virginia.dinino@bancaditalia.it
 Anabela do Rosário Leitão Dinis=adinis@ubi.pt
 Francisco Diniz=fdiniz@utad.pt
 Emin Dinlersoz=emin.m.dinlersoz@census.gov
 Musleh-ud Din=musleh.ud@gmail.com
 Cinzia Di Novi=cinzia.dinovi@unive.it
 Marin Dinu=www@dinumarin.ro
 Evangelos V. Dioikitopoulos=evangelos.dioikitopoulos@aueb.gr
 Rafaela Dios=rdios@uco.es
 Francesco Diotallevi=francesco.diotallevi@unipg.it
 Antonio Di Paolo=antonio.dipaolo@ub.edu
 Giorgio Di Pietro=g.d.i.pietro@westminster.ac.uk
 Edoardo Di Porto=edoardodiporto@yahoo.it
 Carlo D'Ippoliti=carlo.dippoliti@uniroma1.it
 Alexis Direr=direr@ens.fr
 Marie Diron=marie.diron@gmx.de
 Anne-Célia Disdier=anne-celia.disdier@ens.fr
 Sahan T. M. Dissanayake=sdissan2@gmail.com
 Mostapha DISS=diss@gate.cnrs.fr
 Yazid Dissou=ydissou@uottawa.ca
 Roberta Distante=roberta.distante@feem.it
 Piti Disyatat=pitid@bot.or.th
 Astrid Dita=astriddita@outlook.com
 Alfredo Di Tillio=alfredo.ditillio@unibocconi.it
 Maria Laura Di Tommaso=marialaura.ditommaso@unito.it
 Ingolf Dittmann=dittmann@ese.eur.nl
 Robert F. Dittmar=rdittmar@umich.edu
 Dennis Alexis Valin Dittrich=davd@economicscience.net
 Marcus Dittrich=marcus.dittrich@wirtschaft.tu-chemnitz.de
 Gianfranco Di Vaio=gdivaio@luiss.it
 Jose Angelo Divino=jangelo@pos.ucb.br
 Giuseppe Di Vita=gdivita@lex.unict.it
 Giuseppe Di Vita=gvitae@hotmail.com
 Halanaik Diwakara=hdiwakara@yahoo.com
 Anita K Dixit=anidixit@gmail.com
 Avinash Kamalakar Dixit=dixitak@princeton.edu
 Huw David Dixon=dixonh@cardiff.ac.uk
 Keith Dixon=keith.dixon@canterbury.ac.nz
 Mary English Dixon=mdixon@depauw.edu
 Robert Dixon=r.dixon@unimelb.edu.au
 Vladimir Dj. Djakovic=v_djakovic@uns.ac.rs
 Simeon Djankov=simeon_djankov@hks.harvard.edu
 Abdelkader DJEFLAT=abdelkader.djeflat@univ-lille1.fr
 Boualem Djehiche=boualem@math.kth.se
 Faridah Djellal=faridah.djellal@univ-lille1.fr
 Elodie DJEMAI=elodiedjemai@gmail.com
 Harjanto Djunaidi=hdjunaidi@yahoo.com
 Dragana Djurdjevic=djurdjevic@wuestundpartner.com
 Djuro Milos Djuric=djuro.mdjuric@gmail.com
 Ivan Mile Djuric=djuric@iamo.de
 Stephan Dlugosz=dlugosz@zew.de
 Alexandre Dmitriev=alexandre.dmitriev@utas.edu.au
 Jekaterina Dmitrijeva=jekaterina.dmitrijeva@univ-mlv.fr
 Tom Doan=tomd@estima.com
 Rafael Dobado González=rdobado@ccee.ucm.es
 Sabien Dobbelaere=sabien.dobbelaere@vu.nl
 Michael John Dobbie=mdobbie@efs.mq.edu.au
 Ian McQuin Dobbs=i.m.dobbs@ncl.ac.uk
 Leo Dobes=leo.dobes@anu.edu.au
 Carlos Dobkin=cdobkin@ucsc.edu
 Antonio Doblas-Madrid=doblasma@msu.edu
 Imre Dobos=imre.dobos@uni-corvinus.hu
 Alexandra Dobra=a.dobra@warwick.ac.uk
 Iulian Bogdan DOBRA=dobra.iulian@uab.ro
 Ana Maria Dobre=dobre.anamaria@hotmail.com
 Razvan Catalin Dobrea=razvan.dobrea@man.ase.ro
 Emilian Dobrescu=emiliand@clicknet.ro
 Emilian M. Dobrescu=dobrescu@acad.ro
 Loretti Isabella Dobrescu=dobrescu@unsw.edu.au
 Monica Dobrescu=monicam_dobrescu@yahoo.com
 Anton Dobronogov=adobronogov@worldbank.org
 Paul W. Dobson=p.dobson@uea.ac.uk
 Wendy Dobson=dobson@rotman.utoronto.ca
 Peter Docherty=peter.docherty@uts.edu.au
 Chris Dockins=dockins.chris@epa.gov
 Frédéric Docquier=frederic.docquier@uclouvain.be
 Stefan Dodds=s.dodds@uwinnipeg.ca
 Nina Dodig=nina.dodig@hwr-berlin.de
 Matthias Doepke=doepke@northwestern.edu
 Peter Brantley Doeringer=doeringe@bu.edu
 Ralf Doering=ralf.doering@vti.bund.de
 William M. Doerner=william.doerner@fhfa.gov
 Eyup Dogan=edogan@clemson.edu
 Gizem Umut Dogan=gizem.umut@tuik.gov.tr
 Nukhet Dogan=nukhed@gazi.edu.tr
 Onur Doğan=onur.do@gmail.com
 Pinar Dogan=pinar_dogan@ksg.harvard.edu
 Ahmad Bello Dogarawa=abellodogarawa@gmail.com
 Vasile DOGARU=vasile.dogaru@e-uvt.ro
 Giam Quang Do=giamdq.hua@gmail.com
 Bulent Dogru=buldogru@gmail.com
 Ali̇ Suut Doğruel (ALI SUUT DOGRUEL)=suut.dogruel@marmara.edu.tr
 Erik Dohlman=edohlman@ers.usda.gov
 Thomas Dohmen=t.dohmen@uni-bonn.de
 Stephan Dohrn=stephan@sustainableteams.org
 Dirk Dohse=dirk.dohse@ifw-kiel.de
 Mihai Doinea=mihai.doinea@ie.ase.ro
 Noriyuki Doi=noriyuki@kwansei.ac.jp
 Denise Jeanne Doiron=d.doiron@unsw.edu.au
 Takero Doi=tdoi@econ.keio.ac.jp
 Firmin Doko Tchatoka=firmin.dokotchatoka@adelaide.edu.au
 Emin Dokumaci=edokumaci@wisc.edu
 Veronika Dolar=veronika.dolar@liu.edu
 Jennifer L. Doleac=jdoleac@virginia.edu
 Wilfred Dolfsma=w.a.dolfsma@rug.nl
 Tatiana Dolgopyatova=longheel@hse.ru
 David Dollar=ddollar@brookings.edu
 Brian Edward Dollery=bdollery@une.edu.au
 Mathias Dolls=dolls@zew.de
 Jim Dolmas=jim@jimdolmas.net
 Clair Hannah Doloriert=clair.doloriert@bangor.ac.uk
 Ilker Domac=ilker.domac@citi.com
 Bruce Domazlicky=bdomazlicky@semo.edu
 David Domeij=david.domeij@hhs.se
 Jordi Domenech=jdomenec@clio.uc3m.es
 Rafael Domenech=rafael.domenech@uv.es
 Giorgio Dominese=giorgio.dominese@ceeun.org
 Manon Domingues Dos Santos=msantos@univ-mlv.fr
 Edson Paulo Domingues=epdomin@cedeplar.ufmg.br
 Diego Dominguez=diego.dominguez@itam.mx
 Emilio J. Domínguez=edominguez@unavarra.es
 Iciar Dominguez Lacasa=ida@iwh-halle.de
 Manuel Angel Dominguez=madt@ccee.ucm.es
 Silvia Dominguez-Martinez=s.dominguezmartinez@uva.nl
 C-Rene Dominique=rdom1@netzero.net
 Jeff Dominitz=jdominitz@resecon.com
 Ian Domowitz=ian.domowitz@itg.com
 Mark E. Doms=mdoms@doc.gov
 Kenneth Samir Donahue=ksdonahue@gmail.com
 David Donald=d.donald@gcu.ac.uk
 Paola Donati=paola.donati@ecb.europa.eu
 Luiggi Donayre=adonayre@d.umn.edu
 Luis Miguel Doncel Pedrera=luismiguel.doncel@urjc.es
 Murat Donduran=donduran@yildiz.edu.tr
 Milagros Dones Tacero=milagros.dones@uam.es
 Hermann P. P. Donfouet=hermann.donfouet@univ-rennes1.fr
 Baomin Dong=baomindong@vip.163.com
 Congcong Dong=dongcongcong@126.com
 Diansheng Dong=ddong@ers.usda.gov
 Fang Dong=fdong@providence.edu
 Fengxia Dong=fdong6@wisc.edu
 Mei Dong=mei.dong@unimelb.edu.au
 Sen Dong=sd2068@columbia.edu
 Xiaofang Dong=xfangdong@gmail.com
 Xiao-yuan Dong=x.dong@uwinnipeg.ca
 Yan Dong=ydong@swufe.edu.cn
 Yan Dong=dongyan@cass.org.cn
 Gabriel Andrei Donici=gabriel.donici@gmail.com
 Nicola Doni=nicola.doni@unifi.it
 Bas Donkers=donkers@ese.eur.nl
 John J. Donohue=donohue@law.stanford.edu
 Patricio Carlos Donoso=pdonoso@uc.cl
 Cynthia Donovan=donovanc@anr.msu.edu
 Kevin Donovan=kdonova6@nd.edu
 Paul Martin Dontsop Nguezet=pdontsop@yahoo.fr
 Jocelyn Donze=donze@unistra.fr
 Laurent Donzé=laurent.donze@unifr.ch
 Franco Donzelli=franco.donzelli@unimi.it
 Frank J. Dooley=dooleyf@purdue.edu
 Martin D. Dooley=dooley@mcmaster.ca
 Michael Dooley=mpd@ucsc.edu
 Shuh-Chyi Doong=scdoong@nchu.edu.tw
 Karina Doorley=doorley@iza.org
 Kurt Dopfer=kurt.dopfer@unisg.ch
 Gernot Doppelhofer=gernot.doppelhofer@nhh.no
 Quoc-Anh Do=doquocanh@post.harvard.edu
 Quy-Toan Do=qdo@worldbank.org
 James S. Doran=jsdoran@cob.fsu.edu
 Justin Doran=justin.doran@ucc.ie
 Kirk B. Doran=kdoran@nd.edu
 Carlos Alberto Dorantes=cdorante@itesm.mx
 Eric Dor=e.dor@ieseg.fr
 Marco Doretti=marco.doretti@gmail.com
 Aedín Doris=aedin.doris@nuim.ie
 Fabio D'Orlando=fabio.dorlando@unicas.it
 Noah Dormady=dormady.1@osu.edu
 Brigitte Simone Dormont=brigitte.dormont@dauphine.fr
 Daniel Dorn=dd79@drexel.edu
 David Dorn=dorn@cemfi.es
 Sławomir Dorocki=sdorocki@up.krakow.pl
 Paul Anthony Dorosh=paul.dorosh@gmail.com
 Sabine Dörry=sabine.doerry@ceps.lu
 Michael Dorsch=mdorsch@aup.edu
 Richard Patrick Dorsett=r.dorsett@niesr.ac.uk
 Pablo Dorta-González=pdorta@dmc.ulpgc.es
 Thibaut Dort=thibautdort@gmail.com
 Andrew Dorward=andrew.dorward@soas.ac.uk
 Giovanni Dosi=gdosi@sssup.it
 Trond Døskeland=trond.doskeland@nhh.no
 Rodolphe Dos Santos Ferreira=rdsf@cournot.u-strasbg.fr
 Maria José Palma Lampreia Dos Santos=mjpls1963@gmail.com
 Hugo Gil dos Santos Silva=hugogilsilva@gmail.com
 Maarten Dossche=maartendossche@gmail.com
 Cheryl Doss=cheryl.doss@yale.edu
 Benoit Dostie=benoit.dostie@hec.ca
 George Dotsis=gdotsis@econ.uoa.gr
 Nicola Francesco Dotti=nicola.dotti@vub.ac.be
 Valerio Dotti=uctp012@ucl.ac.uk
 Ali Douai=ali.douai@unice.fr
 Elodie Douarin=e.douarin@ucl.ac.uk
 Mohamed Douch=mdouch@mdouch.net
 Chris Doucouliagos=douc@deakin.edu.au
 Sean M. Dougherty=sean.dougherty@oecd.org
 Graham Douglas=integrative@optusnet.com.au
 Robin Douglass=robin.douglass@kcl.ac.uk
 Stratford M. Douglas=stratford.douglas@mail.wvu.edu
 Robin Douhan=robin.douhan@ifn.se
 John Doukas=jdoukas@odu.edu
 FE Doukouré Charles=fedoukoure@yahoo.fr
 Soumaila DOUMBIA=soumdoumbia@yahoo.fr
 John A. Dove=jadove@troy.edu
 Eric Doviak=eric@doviak.net
 Viet Dung Do=dovietdung@mof.gov.vn
 Marion Dovis=marion.dovis@univ-amu.fr
 Alexander Dow=a.dow@virgin.net
 Kevin Dowd=kevin.dowd@hotmail.co.uk
 Timothy A. Dowd=tim.dowd@mail.house.gov
 Thomas Dowling=dowlingt@gwu.edu
 Thomas Downes=thomas.downes@tufts.edu
 William H. Dow=wdow@berkeley.edu
 Damona Doye=damona.doye@okstate.edu
 Luc Doyen=luc.doyen@orange.fr
 Brian Doyle=brian.m.doyle@frb.gov
 Chris Doyle=chris.doyle@warwick.ac.uk
 Matthew Doyle=m6doyle@uwaterloo.ca
 Irina Maria Dragan=irina.dragan@csie.ase.ro
 Lena Dräger=lena.draeger@wiso.uni-hamburg.de
 Arnaud Z. Dragicevic=arnaud.dragicevic@agroparistech.fr
 Carlo Drago=c.drago@mclink.it
 Larisa Loredana Dragolea=larisadragolea@uab.ro
 Robert Dragomir=robert73d@yahoo.com
 Davide Dragone=davide.dragone@unibo.it
 Ingrid-Mihaela Dragota=mihaela.dragota@fin.ase.ro
 Victor Dragotă=victor.dragota@fin.ase.ro
 Tiberiu Dragu=tiberiu.dragu@nyu.edu
 Leigh Drake=l.drake@latrobe.edu.au
 Stavros Drakopoulos=sdrakop@phs.uoa.gr
 Konstantinos Drakos=kdrakos@aueb.gr
 Nick Draper=dagd@cpb.nl
 Carine Drapier=carine.drapier@univ-lille2.fr
 Allan Drazen=drazen@econ.umd.edu
 Eoin Drea=eoindrea@hotmail.com
 Vladimir Drebentsov=vladimir.drebentsov@bp.com
 Anna Dreber=anna.dreber@hhs.se
 Katja Drechsel=katja.drechsel@uos.de
 Denis M. Drechsler=denis.drechsler@fao.org
 Joerg Drechsler=joerg.drechsler@iab.de
 Wolfgang Drechsler=wolfgang.drechsler@ttu.ee
 Burkhard Drees=bdrees@imf.org
 Christian Dreger=cdreger@diw.de
 Axel Dreher=mail@axel-dreher.de
 Mathias Drehmann=mathias.drehmann@bis.org
 Christian Drescher=christian.drescher@uni-bayreuth.de
 Jorge Dresdner=jdresdne@udec.cl
 Scott J. Dressler=scott.dressler@villanova.edu
 Aaron Drew=adrew@nzsuperfund.co.nz
 Michael E. Drew=michael.drew@griffith.edu.au
 Andreas Drichoutis=adrihout@gmail.com
 Mohamed Dridi=mohameddridi@hotmail.fr
 Bram Driesen=bram.driesen@awi.uni-heidelberg.de
 Joost Driessen=j.j.a.g.driessen@uvt.nl
 Nigel L. Driffield=n.l.driffield@aston.ac.uk
 Imola Driga=imola.driga@gmail.com
 Scott Drimie=scottdrimie@mweb.co.za
 Imed Drine=drine@wider.unu.edu
 Stephen Drinkwater=s.j.drinkwater@swansea.ac.uk
 John Driscoll=john_driscoll@alum.mit.edu
 Ciaran Driver=c.driver@soas.ac.uk
 Martijn I. Dröes=m.droes@vu.nl
 Sophie Drogué=sophie.drogue@supagro.inra.fr
 Nicolas L. DROMEL=dromel@psemail.eu
 Marcus Drometer=drometer@ifo.de
 Jaap Dronkers=j.dronkers@maastrichtuniversity.nl
 Feike C. Drost=f.c.drost@uvt.nl
 Nicolas Drouhin=nicolas.drouhin@ens-cachan.fr
 Michalis Drouvelis=m.drouvelis@bham.ac.uk
 Ines Drumond=inesdrum@fep.up.pt
 Moritz A. Drupp=moritz.drupp@fulbrightmail.org
 Bastien Drut=bastien.drut@gmail.com
 Nick Drydakis=ndrydakis@econ.soc.uoc.gr
 Peter David Drysdale=peter.drysdale@anu.edu.au
 Anna D'Souza=anna.dsouza@gmail.com
 Pami Dua=dua@econdse.org
 Cláudia Filipa Duarte=cfduarte@bportugal.pt
 Fabián Duarte=fabian_duarte@rand.org
 Fernando Duarte=fernando.duarte@ny.frb.org
 Maria Adelaide Silva Duarte=maduarte@fe.uc.pt
 Nelson Duarte=duarte.nelson@gmail.com
 Pablo Duarte=pablo.duarte@uni-leipzig.de
 Rosa Duarte=rduarte@unizar.es
 Jarita Duasa=jarita@iium.edu.my
 Simon Dubecq=simon.dubecq@ecb.int
 Oeindrila Dube=odube@nyu.edu
 Rameshwar Dubey=rameshwardubey@gmail.com
 Ram Sewak Dubey=dubeyr@mail.montclair.edu
 Dimitri DUBOIS=dimitri.dubois@lameta.univ-montp1.fr
 Eric Dubois=catheric.dubois@free.fr
 Pierre Dubois=pierre.dubois@tse-fr.eu
 Robert Dubois=2rdubois@gmail.com
 Andrei Dubovik=andrei.dubovik@gmail.com
 Tetyana Dubovyk=tetyana.dubovyk@gmail.com
 Juan Dubra=dubraj@um.edu.uy
 Anne DUBROCARD=anne.dubrocard@statec.etat.lu
 Drago Dubrovski=linnair@siol.net
 Alexander Dubyansky=assig@inbox.ru
 Florinita Duca=florinitaduca@yahoo.com
 Ioana Duca=ioana.duca@utm.ro
 Philip Du Caju=philip.ducaju@nbb.be
 Geoffrey M. Ducanes=jducanes@yahoo.com
 Pierre Duchesne=duchesne@dms.umontreal.ca
 Chuang Du=duchovry@163.com
 Jean-Yves Duclos=jyves@ecn.ulaval.ca
 Cristián Arturo Ducoing, Sr.=cristian.ducoing@uv.cl
 Dana-Codruta Duda-Daianu=cddaianu@yahoo.com
 Maciej Konrad Dudek=mkdudek@sgh.waw.pl
 Sławomir Marcin Dudek=slawomir.dudek@sgh.waw.pl
 Marc Dudey=dudey@rice.edu
 Leonard Dudley=dudleylm@gmail.com
 Hasan Dudu=hasan@dudu.gen.tr
 Ximena Duenas Herrera=xduenas@icesi.edu.co
 Georg Duernecker=duernecker@uni-mannheim.de
 David Duffy=david.duffy@esri.ie
 John Duffy=jduffy@pitt.edu
 Thomas Bernhard Dufhues=dufhues@iamo.de
 Gautier DUFLOS=gduflos@univ-paris1.fr
 Jean-Marie Dufour=jean-marie.dufour@mcgill.ca
 Frédéric Dufourt=frederic.dufourt@univ-amu.fr
 Gilles Dufrénot=lopaduf@aol.com
 Jérôme Dugast=jerome.dugast@banque-france.fr
 Marie Christine Duggan=mduggan@keene.edu
 Emmanuel Duguet=emmanuel.duguet@gmail.com
 Paul Duguid=duguid@berkeley.edu
 Richard Duhautois=richard.duhautois@cee-recherche.fr
 Cristina Duhnea=cristina@duhnea.net
 Maarten Duijvendak=m.g.j.duijvendak@rug.nl
 Claire Dujardin=c.dujardin@iweps.be
 Philippe du Jardin=philippe.dujardin@edhec.edu
 Jun Du=j.du@aston.ac.uk
 Anthony Dukes=dukes@marshall.usc.edu
 Hari Bansha Dulal=hbdulal@gmail.com
 Philippe Dulbecco=p.dulbecco@cerdi.u-clermont1.fr
 Michel Dulcire=michel.dulcire@cirad.fr
 Limin Du=dlmsos@hotmail.com
 Jan Dul=jdul@rsm.nl
 Uwe Dulleck=uwe.dulleck@qut.edu.au
 Sebastian Dullien=sebastian@dullien.net
 Jesus Castanos Dumagan=jcdcu91@yahoo.com
 Laszlo Duma=duma.laszlo@kgk.bmf.hu
 Alper Duman=alper.duman@ieu.edu.tr
 Sertac Duman Gonenc=sduman@uludag.edu.tr
 Christelle Dumas=dumas.ch@gmail.com
 Roxana Arabela Dumitrascu=dumitrascu_arabela@yahoo.com
 Ariadna Dumitrescu=ariadna.dumitrescu@esade.edu
 Bogdan Andrei Dumitrescu=bogdan.dumitrescu@fin.ase.ro
 Luigi Dumitrescu=luigi.dumitrescu@ulbsibiu.ro
 Ramona DUMITRIU=ramona_dumitriu@yahoo.com
 Ionut Dumitru=dumitruionut@yahoo.com
 Madalina Dumitru=madidumitru2007@gmail.com
 Devrim Dumludağ=d.dumludag@maastrichtuniversity.nl
 Michel Dumont=dm@plan.be
 Jerome Robert Florian Dumortier=jerome.dumortier@gmx.net
 Taya Dumrongrittikul=taya.dumrongrittikul@anu.edu.au
 Kwamie O. Dunbar, Sr.=dunbark@sacredheart.edu
 Alan S Duncan=alan.duncan@curtin.edu.au
 Andrew Stuart Duncan=andrew.stuart.duncan@gmail.com
 Denvil Duncan=denvild@gmail.com
 Gregory M. Duncan=duncang@uw.edu
 Kevin C. Duncan=kevin.duncan@colostate-pueblo.edu
 Roberto Duncan=duncanr1@ohio.edu
 Roderick Duncan=rduncan@csu.edu.au
 Mardi Dungey=mardi.dungey@utas.edu.au
 Rachel Dunifon=red26@cornell.edu
 Dario Dunkovic=dunkovic.dario@gmail.com
 James A. Dunlevy=dunlevja@miamioh.edu
 Abe Dunn=abe.dunn@bea.gov
 John Dunne=jpdbris@gmail.com
 Peter Dunne=peter.dunne@centralbank.ie
 Theo Dunnewijk=dunnewijk@merit.unu.edu
 Lucia F. Dunn=dunn.4@osu.edu
 Huu Nhan Duong=huu.duong@monash.edu
 Martial Dupaigne=martial.dupaigne@tse-fr.eu
 Sophia du Plessis=sophia@sun.ac.za
 Stan Du Plessis=stan@sun.ac.za
 Marguerite Duponchel=marguerite.duponchel@gmail.com
 Brandon Dupont=brandon.dupont@wwu.edu
 Diane P. Dupont=diane.dupont@brocku.ca
 William Dupont=william.dupont@vanderbilt.edu
 Bill Dupor=billdupor@gmail.com
 Arnaud Dupuy=arnauddupuy74@gmail.com
 Claude DUPUY=claude.dupuy@u-bordeaux4.fr
 Louis Dupuy=louis.dupuy@u-bordeaux.fr
 Philippe Dupuy=philippe.dupuy@grenoble-em.com
 Andi Duqi=andi.duqi@unibo.it
 João Duque=jduque@iseg.utl.pt
 Juan Carlos Duque=juanca.duque@gmail.com
 Marie-Noëlle Duquenne=mdyken@prd.uth.gr
 Nicolas J. Duquette=nduquett@umich.edu
 Codruta Dura=codrutadura@yahoo.com
 Ahmet Duran=aduran@itu.edu.tr
 Philippe Durance=ph.durance@wanadoo.fr
 Cédric Durand=cdurand@ehess.fr
 Roberto Duran-Fernandez=r.duran.fernandez@gmail.com
 Gonzalo Ignacio Duran Sanhueza=giduran@puc.cl
 Hasan Engin Duran=enginduran@iyte.edu.tr
 Iván Mauricio Durán=ivanmduran@gmail.com
 Jorge Durán=jorge.duran-laguna@ec.europa.eu
 José Elías Durán Lima=jose.duran@cepal.org
 Murat Duran=murat.duran@tcmb.gov.tr
 Ruben Durante=ruben.durante@sciences-po.org
 Gilles Duranton=duranton@wharton.upenn.edu
 Pascale Duran-Vigneron=p.duranvigneron@gmail.com
 Garey Clark Durden=gareydurden@gmail.com
 Dick Durevall=dick.durevall@economics.gu.se
 Catherine A. Durham=cathy.durham@oregonstate.edu
 J. Benson Durham=jbenson.durham@ny.frb.org
 Wolfgang Dürig=duerig@rwi-essen.de
 Nazif Durmaz=durmazn@uhv.edu
 Artyom Durnev=artem-durnev@uiowa.edu
 Wannaphong Durongkaveroj=wnp-dveroj@hotmail.com
 Alain Durré=alain.durre@ecb.int
 Robert Dur=dur@ese.eur.nl
 Harpreet Dusanjh=harpreet.dusanjh@gmail.com
 Richard Dusansky=dusansky@eco.utexas.edu
 Matthias Duschl=matthias.duschl@staff.uni-marburg.de
 Libor Dusek=libor.dusek@cerge-ei.cz
 Tamás Dusek=dusekt@sze.hu
 Ivica Dus=dus@wiwi.uni-frankfurt.de
 Tomaso Duso=tduso@diw.de
 Enrique S. Dussel Peters=dussel@unam.mx
 Maciej Duszczyk=m.duszczyk@uw.edu.pl
 Géraldine Duthé=geraldine.duthe@ined.fr
 Donald Dutkowsky=dondutk@maxwell.syr.edu
 Leon Charl du Toit=dutoit.leon@gmail.com
 Gabriela Dutrénit=gabrieladutrenit@gmail.com
 Arijita Dutta=dutta.arijita@gmail.com
 Bhaskar Dutta=b.dutta@warwick.ac.uk
 Champa Bati Dutta=puja.econ@gmail.com
 Jayasri Dutta=j.dutta@bham.ac.uk
 Amitava Krishna Dutt=adutt@nd.edu
 Mousumi Dutta=dmousumi1970@gmail.com
 Nabamita Dutta=ndutta@uwlax.edu
 Priya Brata Dutta=priyabratadutta@gmail.com
 Puja Vasudeva Dutta=pvdutta@gmail.com
 Rohan Dutta=rohan.dutta@mcgill.ca
 Pushan Dutt=pushan.dutt@insead.edu
 Richard Dutu=rdutu@u-paris10.fr
 Sabine Duvaleix-Tréguer=treguer@agrocampus-ouest.fr
 Robert Duval-Hernandez=rduval@gmail.com
 Romain Duval=rduval@imf.org
 Chloé Duvivier=duvivierchloe@gmail.com
 Florence Duvivier=florence.duvivier@ulb.ac.be
 Vincent Duwicquet=vincent.duwicquet@univ-lille1.fr
 Darren Duxbury=darren.duxbury@newcastle.ac.uk
 Xiaodong Du=xdu23@wisc.edu
 Yan Du=y.du@ieseg.fr
 Yan Du=duyosu@gmail.com
 Ethem Duygulu=ethem.duygulu@deu.edu.tr
 Geert Duysters=g.m.duijsters@tilburguniversity.edu
 Vuong Quoc Duy=vqduy@ctu.edu.vn
 Zaichao Du=zadu@umail.iu.edu
 Eyal Dvir=dvire@bc.edu
 Tomas Dvorak=dvorakt@union.edu
 Ben Adarkwa Dwamena=bdwamena@umich.edu
 Amit Kumar Dwivedi=dwivedipgdm@gmail.com
 Gerald Dwyer=gpdwyer@gmail.com
 Brenda Dyack=brenda.dyack@canberra.edu.au
 Robert Dylewski=r.dylewski@wmie.uz.zgora.pl
 Susan Dynarski=dynarski@umich.edu
 Sebastian Dyrda=dyrda020@umn.edu
 Ratbek Dzhumashev=ratbek.dzhumashev@monash.edu
 Jaroslaw Dzialek=jarek.dzialek@uj.edu.pl
 Dariusz Dziuba=dziubadt@wne.uw.edu.pl
 Marcin Dziubiński=m.dziubinski@mimuw.edu.pl
 Wioletta Dziuda=wdziuda@northwestern.edu
