 Leo Kaas=leo.kaas@uni-konstanz.de
 Grant Peter Kabango=kabangogrant@yahoo.co.uk
 Rilind Kabashi=kabashir@nbrm.mk
 Jan Kabátek=j.kabatek@uvt.nl
 Tarun Kabiraj=tarun@isical.ac.in
 Akassi Sandrine Kablan=sandrinekablan@hotmail.com
 Alain Kabundi=alain.kabundi@resbank.co.za
 Febrio Kacaribu=kacaribu@ku.edu
 David Kaczan=david.kaczan@duke.edu
 Pawel Kaczmarczyk=p.kaczmarczyk@uw.edu.pl
 Ferya Kadioglu=ferya.kadioglu@tcmb.gov.tr
 Sergey M. Kadochnikov=skadochnikov@hse.ru
 Alexander Kadow=alexander.kadow@bundesbank.de
 Dalida Kadyrzhanova=dkadyrz@rhsmith.umd.edu
 William Kaempfer=kaempfer@colorado.edu
 Robert Kaestner=kaestner@uic.edu
 Michael Kaganovich=mkaganov@indiana.edu
 John Kagel=kagel.4@osu.edu
 Martijn Kagie=martijn.kagie@calcasa.nl
 Marta Kahancová=marta.kahancova@celsi.sk
 Leo H. Kahane=lkahane@providence.edu
 Christian Kahl=kahl@math.uni-wuppertal.de
 Charles Milton Kahn=c-kahn@uiuc.edu
 George A. Kahn=george.a.kahn@kc.frb.org
 James A Kahn=jkahn1@yu.edu
 Matthew E. Kahn=mkahn@ioe.ucla.edu
 Shulamit Kahn=skahn@bu.edu
 Sondès Kahouli=sondes.kahouli@univ-brest.fr
 Hiroaki Kaido=hkaido@bu.edu
 Gursharan Singh Kainth=kainthgs@yahoo.com
 Harry M. Kaiser=hmk2@cornell.edu
 Johannes Kaiser=johannes.kaiser@uni-bonn.de
 Kai Kaiser=kkaiser@worldbank.org
 Ulrich Kaiser=ulrich.kaiser@isu.uzh.ch
 Ville Kaitila=ville.kaitila@etla.fi
 Jari Kaivo-oja=jari.kaivo-oja@utu.fi
 Taisei Kaizoji=kaizoji@icu.ac.jp
 Kiran Kumar Kakarlapudi=kiran20uohyd@gmail.com
 Egmont Kakarot-Handtke=handtke@axec.de
 Jan Kakes=j.i.kakes@dnb.nl
 Vikas Kakkar=efvikas@cityu.edu.hk
 Koray Mustafa Kalafatcılar=koray.kalafatcilar@tcmb.gov.tr
 Zarko Y. Kalamov=zarko.y.kalamov@tu-berlin.de
 Tasos Kalandrakis=kalandrakis@rochester.edu
 Yannick Kalantzis=yannick.kalantzis@banque-france.fr
 Vitaliy Kalashnikov, Sr.=kalashnikov_de@yahoo.de
 Elif Kalaycı=elifkalayci11@yahoo.com
 Kenan KALAYCI=k.kalayci@uq.edu.au
 Panagiotis E. Kaldis=diresta@ekdd.gr
 Muhammad Kaleem=m.kaleem.1@research.gla.ac.uk
 Sebnem Kalemli-Ozcan=kalemli@econ.umd.edu
 Christine Kalenborn=christine.kalenborn@tu-dresden.de
 Kaliappa Kalirajan=kaliappa.kalirajan@anu.edu.au
 David E. Kalist=dekali@ship.edu
 Ewa Kaliszuk=ewa.kaliszuk@ibrkk.pl
 Mamoni Kalita=mamoniprb@gmail.com
 Christos Kallandranis=kallandrac@regents.ac.uk
 Epp Kallaste=epp.kallaste@centar.ee
 Zein Kallas, Sr.=zein.kallas@upc.edu
 Steffen Kallbekken=steffen.kallbekken@cicero.uio.no
 Vasileios Kallinterakis=vkalliderakis@yahoo.com
 Dimitris Kallioras=dkallior@uth.gr
 Giorgos Kallis=giorgoskallis@gmail.com
 Ilze Kalnina=ilze.kalnina@umontreal.ca
 Konstantinos Kalogeropoulos=k.kalogeropoulos@lse.ac.uk
 Aris Kaloudis=aris.kaloudis@kd.dep.no
 Ekaterina Kalugina=ekaterina.kalugina@univ-evry.fr
 Emenike Kalu O.=emenikekaluonwukwe@yahoo.com
 Tarmo Kalvet=tarmo@ibs.ee
 Adriaan Kalwij=a.s.kalwij@uu.nl
 Grigory V. Kalyagin=gkalyagin@yandex.ru
 Huseyin KALYONCU=hkalyoncu@meliksah.edu.tr
 Kahraman Kalyoncu=kkalyunc@yahoo.com
 Antonios Nikolaos Kalyvas=a.kalyvas@sussex.ac.uk
 Lampros Kalyvas=lkalyvas@bankofgreece.gr
 Sarantis Kalyvitis=skalyvitis@aueb.gr
 Kohei Kamaga=kohei.kamaga@sophia.ac.jp
 Sukumar Kamalasadan=skamalas@uncc.edu
 Lamia Kamal-Chaoui=lamia.kamal-chaoui@oecd.org
 Fariha Kamal=fariha.kamal@census.gov
 Yiannis Kamarianakis=kamarian@iacm.forth.gr
 Manasvi Manoj Kamat=brendarod147@yahoo.com
 Manoj Subhash Kamat=mskamat@iitb.ac.in
 Uma Sarada Kambhampati=les98usk@rdg.ac.uk
 Bidénam Kambia-Chopin=bidenamchopin@yahoo.fr
 Gueorgui Kambourov=g.kambourov@utoronto.ca
 Ulrich Kamecke=kamecke@wiwi.hu-berlin.de
 Keigo KAMEDA=kameda@kwansei.ac.jp
 Kenju Kamei=kenju.kamei@gmail.com
 Sjoerd Paul Kamerbeek=skamerbeek@hotmail.com
 Eric Kam=erickam@economics.ryerson.ca
 Severin Yves Kamgna=kamgna@beac.int
 Joanna Kámiche=kamiche_jn@up.edu.pe
 Yoshio Kamijo=yoshio.kamijo@gmail.com
 Iryna Kaminska=iryna.kaminska@bankofengland.co.uk
 Olena Kaminska=olena@essex.ac.uk
 Szymon Kaminski=szym.kaminski@gmail.com
 Graciela Laura Kaminsky=graciela@gwu.edu
 Marco Kamiya=mkamiya@gmail.com
 Pantelis Kammas=kammas@cc.uoi.gr
 Olfa Kammoun=olfakammoun@yahoo.fr
 Athanasios Kampas=tkampas@aua.gr
 Stephan Kampelmann=stephan.kampelmann@ulb.ac.be
 Jurjen Johannes Antonie Kamphorst=kamphorst@ese.eur.nl
 Christophe Kamps=christophekamps@gmx.de
 Mark Kamstra=mark@markkamstra.com
 Dick Nuwamanya Kamuganga=dick.kamuganga@graduateinstitute.ch
 Ricky Kanabar=rk519@york.ac.uk
 Bryce Kanago=bryce.kanago@uni.edu
 Taro Kanatani=t-kanatani@biwako.shiga-u.ac.jp
 Fabio Kanczuk=kanczuk@usp.br
 Patrick Kanda=patrick.kanda@up.ac.za
 Eugene Kandel=mskandel@mscc.huji.ac.il
 Astrid Kristina Kander=astrid.kander@ekh.lu.se
 Edward J. Kane=edward.kane@bc.edu
 John Kane=kane@oswego.edu
 Mamoru Kaneko=kaneko@shako.sk.tsukuba.ac.jp
 Elif Oznur Kan=elifoznurkan@cankaya.edu.tr
 Nikolaos C. Kanellopoulos=nkanel@kepe.gr
 Maria Kaneva=mkaneva@gmail.com
 Aki Kangasharju=aki.kangasharju@nordea.com
 Changhui Kang=ckang@cau.ac.kr
 Heedon Kang=hkang@imf.org
 Hyunju Kang=hjkang326@gmail.com
 Kichun Kang=kikang@ynu.ac.kr
 Mingyi Kang=mkang@fudan.edu.cn
 Moonsoo Kang=mkang@iona.edu
 Sawoong Kang=swkang@handong.edu
 Sung Hoon Kang=shkang@kipf.re.kr
 Wensheng Kang=wkang3@kent.edu
 Woojin Kang=woojin.kang@anu.edu.au
 Jose K. Kanichukattu=kkjstc@gmail.com
 Zafer Kanik=kanik@bc.edu
 Yuri (Yuriy) Kaniovski (Kaniovskyi),=yuriy.kaniovskyi@unibz.it
 Serguei Kaniovski=serguei.kaniovski@wifo.ac.at
 Kamhon Kan=kk@sinica.edu.tw
 Miloš Kankaraš=m.kankaras@uvt.nl
 Vlasta Kaňková=kankova@utia.cas.cz
 İbrahim Burak Kanlı=burak.kanli@finansinvest.com
 Prakash Kannan=prakash@alum.mit.edu
 Barbara J Kanninen=barbkann@verizon.net
 Takashi Kano=tkano@econ.hit-u.ac.jp
 Tunga Kantarci=kantarci@uvt.nl
 David Kantor=kantor.d@att.net
 Shawn Kantor=kantos@rpi.edu
 Anil Kumar Kanungo=akanungo@iift.ac.in
 Rama Prasad Kanungo=kanungomba@hotmail.com
 Isaac Kalonda Kanyama=ikanyama@uj.ac.za
 Eugene Kanzieper=eugene.kanzieper@gmail.com
 Ludwig Kanzler=ludwig.kanzler@chch.oxon.org
 Martin Kanz=mkanz@worldbank.org
 Chihwa Kao=cdkao@maxwell.syr.edu
 Rostislav Kapeliushnikov=rostis@hse.ru
 Sergey Kapelyuk=skapelyuk@bk.ru
 George Kapetanios=g.kapetanios@qmul.ac.uk
 Soultana Tania Kapiki=tadimaka@hotmail.com
 Pavel Kapinos=pavel_kapinos@yahoo.com
 Zsuzsa Kapitány=kapitany@econ.core.hu
 Spyridon Kapitsinas=skapits@econ.uoa.gr
 Nikolaos Kapitsinis=nikos.kapitsinis@yahoo.com
 Cameron M. Kaplan=ckaplan@uthsc.edu
 David Scott Kaplan=dkaplan@iadb.org
 Erin Kaplan=kaplane@rhodes.edu
 Ethan Daniel Kaplan=ethan.kaplan@gmail.com
 Scott M. Kaplan=scottkaplan@berkeley.edu
 Steven Neil Kaplan=skaplan@uchicago.edu
 Todd R. Kaplan=dr@toddkaplan.com
 Louis Kaplow=meskridge@law.harvard.edu
 Sony Kapoor=sony.kapoor@gmail.com
 Svatopluk Kapounek=skapounek@mendelu.cz
 Andreas Kappeler=andreas.kappeler@oecd.org
 Robert T. Kappel=kappel@giga-hamburg.de
 Basant K. Kapur=ecskapur@nus.edu.sg
 Kanika Kapur=kanika.kapur@ucd.ie
 Alper Kara=alperkara@gmail.com
 Mehmet Emin Karaaslan=memin@isikun.edu.tr
 Bilgehan Karabay=bilgehan.karabay@gmail.com
 Tatiana Karabchuk=tkarabchuk@hse.ru
 Daniel Karabekyan=dkarabekyan@hse.ru
 Orhan Karaca=okaraca@ekonomist.com.tr
 Vladimir V. Karacharovskiy=vvk@hse.ru
 Mehmet Karacuka=mehmet.karacuka@ege.edu.tr
 Ece Ceylan Karadagli=ece@cankaya.edu.tr
 Aikaterini Karadimitropoulou=a.karadimitropoulou@uea.ac.uk
 Peter Karadi=peter.karadi@ecb.int
 Engin Kara=engin.kara@bristol.ac.uk
 Ozer Karagedikli=ozer.karagedikli@rbnz.govt.nz
 Giannis Karagiannis=karagian@uom.gr
 Nikolaos Karagiannis=karagiannisni@wssu.edu
 Erdal Karagol=erdalkaragol@hotmail.com
 Emin Karagözoğlu=karagozoglu@bilkent.edu.tr
 Tsvetanka S. Karagyozova=tsvety_k@yahoo.com
 Ali Hakan Kara=hakan.kara@tcmb.gov.tr
 Fatih Karahan=fatih.karahan@ny.frb.org
 Burhan Can Karahasan=can.karahasan@okan.edu.tr
 Alexander K. Karaivanov=akaraiva@sfu.ca
 Elira Karaja=ekaraja@econ.berkeley.edu
 Mustafa C. Karakus=mustafakarakus@westat.com
 Mahmut Kara=mahmut@uchicago.edu
 Deniz Dilan Karaman Örsal=deniz.oersal@leuphana.de
 Frédéric Karamé=frederic.karame@univ-lemans.fr
 Fida Karam=karam.f@gust.edu.kw
 Nikos Karamouzis=nkaramouzis@piraeusbank.gr
 Vladimir A. Karamychev=karamychev@ese.eur.nl
 Menelaos Karanasos=menelaos.karanasos@brunel.ac.uk
 Marika Karanassou=m.karanassou@qmul.ac.uk
 Fatih Karanfil=fkaranfil@u-paris10.fr
 Pavlos Karanikolas=pkaranik@aua.gr
 Anirban Kar=anirban@econdse.org
 Dr Francis Karanja=fkaranja@yahoo.com
 Kostas Karantininis=karantininis.konstantinos@slu.se
 Anastasios Karantounias=anastasios.karantounias@atl.frb.org
 Murat Karaöz=mkaraoz@gmail.com
 Ashim Kumar Kar=ashimkar11@gmail.com
 Andrei Karavaev=andrei.karavaev@gmail.com
 Yiannis Karavias=ioannis.karavias@nottingham.ac.uk
 Cem Karayalcin=karayalc@fiu.edu
 Krzysztof Karbownik=krzysztof.karbownik@northwestern.edu
 Adam Karbowski=ak31476@sgh.waw.pl
 Sohbet Karbuz=karbuz@ome.org
 Mihaela Kardos=mihaela_kardos@yahoo.com
 Bilal KARGI=bilalkargi@gmail.com
 Vladislav Kargin=slavakargin@yahoo.com
 Emadul Karim=emad@kasbit.edu.pk
 Arizo Karimi=arizo.karimi@ifau.uu.se
 Mohammad Sharif Karimi=sharifkarimi@yahoo.com
 Mohd Zaini Abd Karim=zaini500@uum.edu.my
 Stephen Njuguna Karingi=skaringi@uneca.org
 Seppo Kari=seppo.kari@vatt.fi
 Hannu Kärkkäinen=hannu.karkkainen@tut.fi
 Dean Karlan=dean.karlan@yale.edu
 Heiko Karle=hkarle@ethz.ch
 Hans-Dieter Karl=karl@ifo.de
 Kristian Bernt Karlson=kristian.karlson@gmail.com
 Charlie Karlsson=charlie.karlsson@jibs.hj.se
 Sune Karlsson=sune.karlsson@oru.se
 Sudipto Karmakar=skarmakar@bportugal.pt
 Alexandr M. Karminsky=karminsky@mail.ru
 Muhsin Kar=mkar@konya.edu.tr
 Amit Karna=karna@iimahd.ernet.in
 Ajit Karnik=ajit.karnik@gmail.com
 Ekaterina Karniouchina=karniouc@chapman.edu
 Lilia Karnizova=lkarnizo@uottawa.ca
 G. Andrew Karolyi=gak56@cornell.edu
 Patrik Karpaty=patrik.karpaty@oru.se
 Andreas Karpf=andreas.karpf@univ-paris1.fr
 Andrew Karpio=andrzej_karpio@sggw.pl
 Jonathan Mark Karpoff=karpoff@uw.edu
 Александр Карпов (Alexander Karpov)=akarpov@hse.ru
 Georgios Karras=gkarras@uic.edu
 Saibal Kar=saibal@cssscal.org
 Judit Karsai=kar@econ.core.hu
 Hiroyuki Kasahara=hkasahar@mail.ubc.ca
 Shigehisa Kasahara=sckasahara123123@gmail.com
 Kenneth Kasa=kkasa@sfu.ca
 Christian Jonathan Kascha=christian.kascha@econ.uzh.ch
 Mila Kashcheeva=mila_kashcheeva@ide.go.jp
 Mohammad Ali Kashefi=alikashefii@gmail.com
 Anil Kashyap=anil.kashyap@chicagobooth.edu
 Pradeep Singh Kashyap=pskashyap@yahoo.com
 Syurkani Ishak Kasim=skani@depkeu.go.id
 Igors Kasjanovs=igors.kasjanovs@gmail.com
 Maria Th. Kasselaki=mkasselaki@bankofgreece.gr
 Girma Tesfahun Kassie=g.tesfahun@cgiar.org
 Salina H. Kassim=ksalina@iium.edu.my
 Stephen Kastoryano=s.kastoryano@uni-mannheim.de
 Zafeira Kastrinaki=z.kastrinaki@bath.ac.uk
 Norihiro KASUGA=kasuga@econ.kobe-u.ac.jp
 Maximilian Kasy=maximiliankasy@fas.harvard.edu
 Lorant Kaszab=kaszablorant@yahoo.com
 Mariusz Franciszek Kaszubowski=mkaszubo@zie.pg.gda.pl
 Mitesh Kataria=mitesh.kataria@economics.gu.se
 Hajime Katayama=hajime.katayama@waseda.jp
 Munechika Katayama=katayama@econ.kyoto-u.ac.jp
 Gábor Kátay=kataygabor@gmail.com
 Ani L. Katchova=akatchova@uky.edu
 Harry M. Kat=harry@harrykat.com
 Salih Turan Katircioglu=salihk@emu.edu.tr
 Kazuhiko Kato=kkato@asia-u.ac.jp
 Elena Katok=ekatok@utdallas.edu
 Ryo Kato=ryou.katou@boj.or.jp
 Ryuta Ray Kato=kato@iuj.ac.jp
 Takao Kato=tkato@colgate.edu
 Constantinos Katrakilidis=katrak@econ.auth.gr
 Stelios D. Katranidis=katranid@uom.edu.gr
 Juraj Katriak=katriak@gmail.com
 Marina-Selini Katsaiti=selini.katsaiti@uaeu.ac.ae
 Ilya Katsev=katsev@yandex.ru
 Dimitris K. Katsianis=dkats@di.uoa.gr
 Vicky Katsoni=katsoniv@gmail.com
 Rasmus Kattai=rkattai@epbe.ee
 Rainer Kattel=rainer.kattel@ttu.ee
 Peter Katuscak=peter.katuscak@cerge-ei.cz
 Barbara G. Katz=bkatz@stern.nyu.edu
 Jonathan N. Katz=jkatz@caltech.edu
 Nico Frederick Katzke=nfkatzke@gmail.com
 Lawrence F. Katz=lkatz@harvard.edu
 Michael L. Katz=katz@haas.berkeley.edu
 Martina Kauffeld-Monz=kauffeld-monz@ifsberlin.de
 Albrecht Kauffmann=albrecht.kauffmann@iwh-halle.de
 Alexander Kaufmann=alexander.kaufmann@ait.ac.at
 Daniel Kaufmann=daniel.kaufmann@snb.ch
 Daniel Kaufmann=dkaufmann@brookings.edu
 Katja Maria Kaufmann=katja.kaufmann@unibocconi.it
 Robert K. Kaufmann=kaufmann@bu.edu
 Sylvia Kaufmann=sylvia.kaufmann@szgerzensee.ch
 Roger T. Kaufman=rkaufman@email.smith.edu
 Antti Kauhanen=antti.kauhanen@etla.fi
 James B. Kau=jkau@terry.uga.edu
 Gautam Kaul=kaul@umich.edu
 Florian Kaulich=florian.kaulich@wu.ac.at
 Dr Nitasha Kaul=nitasha.kaul@gmail.com
 Ilpo Kauppinen=kauppinen@ifo.de
 Edgar E. Kausel=kauseljdm@gmail.com
 Arun Kumar Kaushik=arunkaush@gmail.com
 Pamela Kaval=pam98k@yahoo.com
 Georgios Kavetsos=g.kavetsos@lse.ac.uk
 Ilja Kristian Kavonius=ilja.k.kavonius@alumni.helsinki.fi
 Dimitris Kavroudakis=dimitrisk@geo.aegean.gr
 Manolis Kavussanos=mkavus@aueb.gr
 Nozomu Kawabata=kawabata@econ.tohoku.ac.jp
 Daiji Kawaguchi=kawaguch@econ.hit-u.ac.jp
 Hiroki Kawai=hk@econ.keio.ac.jp
 Kei Kawai=kkawai@stern.nyu.edu
 Masahiro KAWAI=mkawai.tokyo@gmail.com
 Enrique Lucio Kawamura=kawa@udesa.edu.ar
 Kohei Kawamura=kohei.kawamura@ed.ac.uk
 Koichi Kawamura=koichi_kawamura@ide.go.jp
 Satoshi Kawanishi=s-kawani@sophia.ac.jp
 Yukichika Kawata=yukichika_kawata@yahoo.co.jp
 Ayşe Kaya=ayse.kaya@ikc.edu.tr
 Ayşen A. Kaya=aysen.kaya@ege.edu.tr
 Volkan Kayacetin=volkan.kayacetin@ozyegin.edu.tr
 Adrian Kay=adrian.kay@anu.edu.au
 Huseyin Kaya=huseyin.kaya@bahcesehir.edu.tr
 Saime SUNA KAYAM=kayams@itu.edu.tr
 Neslihan Kaya=neslihan.kaya@tcmb.gov.tr
 William Henry Kaye-Blake=bill.kaye-blake@nzier.org.nz
 Remzi Kaygusuz=rkaygusuz@sabanciuniv.edu
 Ayla Kayhan=akayhan@lsu.edu
 Çağatay Kayı=kayi.cagatay@urosario.edu.co
 Uzay Kaymak=u.kaymak@ieee.org
 Neil Marshall Kay=n.m.kay@strath.ac.uk
 Gennadi Kazakevitch=gennadi.kazakevitch@monash.edu
 Maria Vladimirovna Kazakova=kazakova@iep.ru
 Thanassis Kazanas=tkazanas@aueb.gr
 Anatoly K. Kazantsev=kazantcev@gsom.pu.ru
 Mark Vahram Kazarosian=mkazarosian@stonehill.edu
 Brugt Kazemier=brugt.kazemier@planet.nl
 Hossein S. Kazemi=kazemi@stonehill.edu
 Abdul Kabeer Kazi=kabeer@kasbit.edu.pk
 Harounan Kazianga=harounan.kazianga@okstate.edu
 Richard Francis Kazmierczak, Jr.=rkazmierczak@agcenter.lsu.edu
 Andrius Kažukauskas=andrius.kazukauskas@econ.umu.se
 Claire Keane=claire.keane@esri.ie
 Michael P Keane=michael.keane@nuffield.ox.ac.uk
 Colm Kearney=colm.kearney@monash.edu
 Barry Patrick Keating=keating.1@nd.edu
 Bereket Kebede=b.kebede@uea.ac.uk
 Sindu Workneh Kebede=kebedesw@agrar.hu-berlin.de
 Mazen KEBEWAR=mazen.kebewar@univ-orleans.fr
 Med KECHIDI=kechidi@univ-tlse1.fr
 Benjamin Keddad=b.keddad@gmail.com
 Abbi Mamo Kedir=ak493@le.ac.uk
 Stephen P. Keef=stephen.keef@vuw.ac.nz
 Hiau Joo Kee=hiau.kee@anu.edu.au
 Hiau Looi Kee=hlkee@worldbank.org
 Louise Keely=lkeely@thecambridgegroup.com
 Donald Keenan=donald.keenan@u-cergy.fr
 Benjamin David Keen=ben.keen@ou.edu
 Roman Keeney=rkeeney@purdue.edu
 Michael Keen=mkeen@imf.org
 Steve Keen=debunking@gmail.com
 Ghirmai T. Kefela=gkefela@live.com
 Patrick J. Kehoe=pkehoe@res.mpls.frb.fed.us
 Timothy J. Kehoe=tkehoe@umn.edu
 Yaya KEHO=yayakeho@yahoo.fr
 Matthias Kehrig=matthias.kehrig@austin.utexas.edu
 Thomas Keijser=thomaskeijser@kvdv.eu
 Angelina Keil=keil@wifo.ac.at
 Max C. Keilbach=keilbach@wedgebrook.de
 Nico Keilman=nico.keilman@econ.uio.no
 Donald B. Keim=keim@wharton.upenn.edu
 Todd Keister=todd.keister@rutgers.edu
 David Keith=david_keith@harvard.edu
 John Keith=jkeith@econ.usu.edu
 Michal Kejak=michal.kejak@cerge-ei.cz
 Zerihun Getachew Kelbore=zehagu@gmail.com
 David Kelch=drdrkelch@gmail.com
 Stijn Kelchtermans=stijn.kelchtermans@kuleuven.be
 Markus Kelle=kellemarkust@gmail.com
 Derek K. Kellenberg=derek.kellenberg@mso.umt.edu
 Joachim Keller=joachim.keller@nbb.be
 R Godfrey Keller=godfrey.keller@economics.ox.ac.uk
 Wolfgang Keller=wolfgang.keller@colorado.edu
 Maryellen R. Kelley=maryellen.kelley@hughes.net
 Austin Kelly=repec@vanness.org
 David L. Kelly=dkelly@miami.edu
 Kenneth H. Kelly=kkelly@ftc.gov
 Patrick Joseph Kelly=pkelly@nes.ru
 Robert Kelly=robert.kelly@centralbank.ie
 Simon Kelly=simon@kellyresearch.com.au
 Valerie Auserehl Kelly=kelly@msu.edu
 Robert Kelm=emfrok@uni.lodz.pl
 M. Ali Kemal=m.alikemal@gmail.com
 Thomas Kemeny=tomkemeny@gmail.com
 Claudia Kemfert=ckemfert@diw.de
 David M. Kemme=dmkemme@memphis.edu
 Alexander Kemnitz=alexander.kemnitz@tu-dresden.de
 Bernd Kempa=bernd.kempa@uni-muenster.de
 Eric Kemp-Benedict=eric.kemp-benedict@sei-international.org
 Hubert Kempf=hubert.kempf@ens-cachan.fr
 Johannes Hermanus Kemp=johannes.kemp@gmail.com
 Murray C. Kemp=murraykemp@optusnet.com.au
 Daniel Kemptner=dkemptner@diw.de
 Brian Thomas Kench=bkench@ut.edu
 Crucita Ken=cruken@uqroo.mx
 Jake Kendall=kendall_jake@hotmail.com
 David Andrew Kendrick=kendrick@austin.utexas.edu
 Neil Kendrick=kendrickconsultancy@gmail.com
 Monica Jan Keneley=mkeneley@deakin.edu.au
 Ron S. Kenett=ron@kpa-group.com
 Karligash Kenjegalieva=k.a.kenjegalieva@lboro.ac.uk
 Amangeldi Kenjegaliev=a.kenjegaliev@hull.ac.uk
 Eiko Kenjoh=kenjoh@asia-u.ac.jp
 Donald S. Kenkel=dsk10@cornell.edu
 John Kennan=jkennan@ssc.wisc.edu
 John Kennedy=j.kennedy@latrobe.edu.au
 Brendan Kennelly=brendan.kennelly@nuigalway.ie
 John Kennes=jkennes@econ.au.dk
 David Mark Kennet=markkennet@markkennet.com
 Miriam Kennet=greeneconomicsinstitute@yahoo.com
 Lawrence W. Kenny=larry.kenny@cba.ufl.edu
 Lance C. Kent=lckent@wm.edu
 Richard J. Kent=rkent@kent.edu
 Nathaniel O. Keohane=nathaniel.keohane@nyu.edu
 Jan Horst Keppler=jan-horst.keppler@dauphine.fr
 Wolfgang Kerber=kerber@wiwi.uni-marburg.de
 Spartak Keremidchiev=spartak@club2000.org
 Michael Keren=mskeren@mscc.huji.ac.il
 Leena Kerkelä=leena.kerkela@ptt.fi
 Andreas Kern=ak679@georgetown.edu
 Axel Olaf Kern=axel.kern@hs-weingarten.de
 Rongzhu Ke=rzke@cuhk.edu.hk
 Arthur Kerrigan=arthur.kerrigan@ec.europa.eu
 Suzi Kerr=suzi.kerr@motu.org.nz
 William Kerr=wkerr@hbs.edu
 Kristiaan H. J. Kerstens=k.kerstens@ieseg.fr
 Erasmus K. Kersting=erasmus.kersting@villanova.edu
 Gabor Kertesi=kertesi@econ.core.hu
 Robert R Kerton=kerton@uwaterloo.ca
 ดุษณี เกศวยุธ (Dusanee Kesavayuth)=dusanee_kes@utcc.ac.th
 Stefan Kesenne=stefan.kesenne@ua.ac.be
 Pradeep Kumar Keshari=p.keshari@idbi.co.in
 Effie Kesidou=e.kesidou@leeds.ac.uk
 Ioannis N. Kessides=ioannis.kessides@gmail.com
 Iris Kesternich=iris.kesternich@lrz.uni-muenchen.de
 Martin Kesternich=kesternich@zew.de
 Keszthelyi András=keszthelyi.andras@kgk.uni-obuda.hu
 Christian H. M. Ketels=cketels@hbs.edu
 Mikko Ketokivi=mikko@ketokivi.fi
 Willemien Kets=willemien.kets@gmail.com
 Andreas Kettemann=andreas.kettemann@econ.uzh.ch
 Tobias D. Ketterer=t.ketterer@lse.ac.uk
 Paul Carlisle Kettler=paulck@math.uio.no
 Claudia Kettner=claudia.kettner@wifo.at
 Steven Jan Keuning=steven.keuning@freenet.de
 Mirela Keuschnigg=mirela.keuschnigg@unisg.ch
 Michael Kevane=mkevane@scu.edu
 Ilias S. Kevork=kevork@uth.gr
 Gabor Kezdi=kezdig@ceu.hu
 Suresh K.G.=sureshkg2020@gmail.com
 Jeetendra Khadan=jit1987@hotmail.co.uk
 Dmitriy Kha=dmitriy.kha@gmail.com
 Ruslan Khaitkulov=khaitkulovhse@gmail.com
 Sabit Khakimzhanov=sabitkh@halykbank.kz
 Lynda Khalaf=lynda_khalaf@carleton.ca
 Arian Khaleghi Moghadam=arian.khaleghi@gmail.com
 Rabeh Khalfaoui=r.kalfaoui@gmail.com
 Raja J. Khalidi=khalidirj@gmail.com
 Mahmood Khalid=mahmoodkhd@yahoo.com
 Elias Khalil=elias.khalil@monash.edu
 Wajih Khallouli=wajih.khallouli@gmail.com
 Kiryl Khalmetski=kiryl.khalmetski@hof.uni-frankfurt.de
 Yohane Khamfula=ykhamfula@yahoo.co.uk
 Melanie Khamis=mkhamis@wesleyan.edu
 Thanchanok Khamkaew=thanchanok@mju.ac.th
 Abdul Jalil Khan=ajkhanlhr@yahoo.com
 Aftab Alam Khan=aftabalam112@gmail.com
 Amir Jahan Khan=a.j.khan@warwick.ac.uk
 Rasheda Khanam=rasheda.khanam@usq.edu.au
 Komeil Khanarinejad=komeil.khanarinejad@gmail.com
 Aubhik Khan=mail@aubhik-khan.net
 Imen Khanchel=im_khanchel@yahoo.fr
 Lalit Khandare=lkhandar@umail.iu.edu
 Shahidur Rahman Khandker=skhandker@worldbank.org
 Faheem Jehangir Khan=faheem.jehangir@gmail.com
 Haider Khan=hkhan@du.edu
 Hashmat Khan=hashmat_khan@carleton.ca
 Hayat Khan=h.khan@latrobe.edu.au
 Iram A. Khan=iram.khan@fulbrightmail.org
 Dr. Jangraiz Khan=economist95@hotmail.com
 Kamran Khan=kamran.crdo@gmail.com
 Mahmood ul Hasan Khan=mhkhan45@hotmail.com
 M. Ali Khan=akhan@jhu.edu
 Mohsin Khan=mkhan@acus.org
 Muhammad Irfan Khan=irfanacc@yahoo.com
 Niaz Ahmad Khan=drnakhan2000@yahoo.com
 Rana Ejaz Ali Khan=ranaejazalikhan@yahoo.com
 Sajawal Khan=lodhiphd@yahoo.com
 Saleem Khan=srh.gomal@gmail.com
 Salman Khan=sal.k@hotmail.com
 Tehmina Shaukat Khan=tehmina25@gmail.com
 Zahoor Khan=zahoor_660@hotmail.com
 Karina Kharina=rezenkova@iet.ru
 Fouad Khaskhoussi=khaskhoussifouad@yahoo.fr
 Naeem ur rehman Khattak=naeemurrehman2001@yahoo.com
 Fahmida Khatun=fahmida@cpd.org.bd
 Kaysara Khatun=kaysara1@googlemail.com
 Muhammad Idrees Khawaja=idreeskhawaja@pide.org.pk
 Mariam Khawar=mkhawar@elmira.edu
 Nabaz T. Khayyat=nabaz@snu.ac.kr
 Massoud Khazabi=mkhazabi@yahoo.com
 Atef Khelifi=atefkhe@aim.com
 Stuti Khemani=skhemani@worldbank.org
 Tarron Khemraj=tkhemraj@ncf.edu
 Nasser Khiabani=n.khiabani@imps.ac.ir
 Hoang Van Khieu=met12401@grips.ac.jp
 Jaeuk Khil=jkhil@hanyang.ac.kr
 Mohammed Khnifer=mkhnifer1@gmail.com
 Konstantin Kholodilin=renoloco@yandex.ru
 Roy W. L. Khong=khongroy@yahoo.com
 Sangeeta Khorana=sak@aber.ac.uk
 Hoe Ee KHOR=hekhor@gmail.com
 Natalia Khorunzhina=nk.eco@cbs.dk
 Maroula Khraiche=maroula.khraiche@coloradocollege.edu
 Naceur Khraief=nkhraief@gmail.com
 Stanislav Khrapov=khrapovs@gmail.com
 Timur X. kHrotko=ac@timurx.net
 Bhekuzulu Khumalo=bhekuzulu.khumalo@gmail.com
 Hasan Kiaee, Dr.=hasankiaee@gmail.com
 Muhammad Framurz Kiani=framurz@pide.org.pk
 James A. Kiawu=jafkiawu@gmail.com
 Aykut Kibritçioğlu=kibritcioglu@gmail.com
 Bengi Kibritcioglu=bengi.kibritcioglu@hazine.gov.tr
 Thomas Kick=thomas.kick@bundesbank.de
 Rozalia Kicsi=rozaliak@seap.usv.ro
 Mizuho Kida=mkida@worldbank.org
 Michael P Kidd=michael.kidd@qut.edu.au
 Christian Kiedaisch=christian.kiedaisch@econ.uzh.ch
 Nicholas M. Kiefer=nicholas.kiefer@cornell.edu
 Thomas Kiehlborn=kiehlborn@finance.uni-frankfurt.de
 Katherine Ann Kiel=kkiel@holycross.edu
 Julia Kielyte=kielyte@eeri.eu
 Youssouf KIENDREBEOGO=k_youssouf@yahoo.fr
 Hans Kiesl=hans.kiesl@hs-regensburg.de
 John Kiff=jkiff@imf.org
 Mathias Kifmann=mathias.kifmann@wiso.uni-hamburg.de
 David Asiimwe KIHANGIRE=dkihangire@bou.or.ug
 Astrid Kiil=aski@kora.dk
 Yoko Kijima=kijima@sk.tsukuba.ac.jp
 Toru Kikuchi=kikuchi@econ.kobe-u.ac.jp
 Christopher Kilby=chkilby@yahoo.com
 Michael Kiley=michael.t.kiley@frb.gov
 Lutz Kilian=lkilian@umich.edu
 Yilmaz Kiliçaslan=ykilicaslan@anadolu.edu.tr
 Ekrem Kilic=ekremk@gmail.com
 Zubeyir Kilinc=zubeyirkilinc@gmail.com
 Fiodar Kilin=fiodar.kilin@web.de
 F.S. Kilin=fedor.kilin@s2001.tu-chemnitz.de
 Maureen Kilkenny=maureenkilkenny@gmail.com
 M. Ulric Killion=mulrickillion@netscape.net
 Jean-Marc Malambwe Kilolo=malambwe@yahoo.com
 John A. Kilpatrick=john@greenfieldadvisors.com
 Juha Kilponen=juha.kilponen@bof.fi
 Kaarel Kilvits=kaarel.kilvits@tseba.ttu.ee
 Ralph C. Kimball=kimball@babson.edu
 Beomsoo Kim=kimecon@korea.ac.kr
 Chris Kimble=chris.kimble@chris-kimble.com
 Bonggeun Kim=bgkim07@snu.ac.kr
 Gray Kimbrough=jgkimbro@uncg.edu
 Bum J. Kim=bumkim@ssu.ac.kr
 Byung-Cheol Kim=byung-cheol.kim@econ.gatech.edu
 ByungWoo Kim=byungw@cjnu.ac.kr
 Chang-Jin Kim=cjkim@korea.ac.kr
 Chansung Kim=cskim@koti.re.kr
 Charles Kim=charleskim@post.harvard.edu
 Daehaeng Kim=dkim2@imf.org
 David Deok-Ki Kim=kim.david@sydney.edu.au
 Dongcheol Kim=kimdc@korea.ac.kr
 Dong Heon Kim=dongkim@korea.ac.kr
 Doyoung Kim=dkim@sogang.ac.kr
 Dukpa Kim=dukpakim@korea.ac.kr
 Heeho Kim=kimhh@knu.ac.kr
 Ayal Kimhi=ayal.kimhi@mail.huji.ac.il
 Ho Yeon Kim=hykim@skku.edu
 Hwagyun (Hagen) Kim=hagenkim@tamu.edu
 Hyeongwoo Kim=gmmkim@gmail.com
 Lily Kiminami=kiminami@agr.niigata-u.ac.jp
 Insu Kim=insu.kim@email.ucr.edu
 Jae Hoon Kim=j.kim@latrobe.edu.au
 Jaesoo Kim=jaeskim@iupui.edu
 Jaewon Kim=jaewon.kim@kkv.se
 Jangryoul Kim=kjryoul@hufs.ac.kr
 Jeonghyun Kim=sowoonsr@korea.ac.kr
 Jin-Hyuk Kim=jinhyuk.kim@colorado.edu
 Jinill Kim=jk9n@hotmail.com
 Jinwoo Kim=jikim72@gmail.com
 Jinyoung Kim=jinykim@korea.ac.kr
 Jungho Kim=jungho@alumni.brown.edu
 Jung Sik Kim=kimjs@yonsei.ac.kr
 Junhan Kim=junhank@bok.or.kr
 Kibae Kim=kibaejjang@gmail.com
 Kijong Kim=kim@levy.org
 Kwang-ho Kim=kwanghokim@hanyang.ac.kr
 Kwang Hwan Kim=kimkh01@yonsei.ac.kr
 Kyung Hoon Kim=kyunghoon_kim2000@yahoo.com
 Jean Kimmel=jean.kimmel@wmich.edu
 Minho Kim=kimmh@jbnu.ac.kr
 Minki Kim=minki.kim@kaist.ac.kr
 Minseong Kim=minseong@skku.edu
 Min Seong Kim=minseong.kim@ryerson.ca
 Moshe Kim=kim@econ.haifa.ac.il
 Namsuk Kim=kimnamsuk@un.org
 Sang Bong Kim=brainkim75@hanmail.net
 Seonghoon Kim=seonghoonkim@smu.edu.sg
 Seong-Hoon Kim=economicsnote@gmail.com
 Se-Um Kim=konstra@kli.re.kr
 Seung-Rae Kim=srkim@hallym.ac.kr
 Soyoung Kim=soyoungkim@snu.ac.kr
 Suk-Joong Kim=sukjoong@gmail.com
 Sun-Bin Kim=sunbin.kim@yonsei.ac.kr
 Sung-Hwan Kim=skim92@ajou.ac.kr
 Sung Hyun Kim=sungkim@ewha.ac.kr
 Sunghyun Henry Kim=sunghyun.kim@suffolk.edu
 Sung Jae Kim=sungjaekim2004@gmail.com
 Sunwoong Kim=kim@uwm.edu
 Tae-Hwan Kim=tae-hwan.kim@yonsei.ac.kr
 Fukunari Kimura=fkimura@econ.keio.ac.jp
 Shingo Kimura=shingo.kimura@oecd.org
 Wonjoon Kim=wonjoon.kim@kaist.edu
 Woochan Kim=wckim@korea.ac.kr
 Woojin Kim=woojinkim@snu.ac.kr
 Yoonbai Kim=ykim01@uky.edu
 Young-Bae Kim=ybkim01@gmail.com
 Young-Chul Kim=yckim.kdi@gmail.com
 Young-Han Kim=kimyh@skku.edu
 Yunhee Kim=yunhee.kim@oecd.org
 Yun Jung Kim=yunjungk@sogang.ac.kr
 Terrence Kinal=tkinal@albany.edu
 Markus Kinateder=mkinateder@unav.es
 Joel Kincaid=jfkincaid@gmail.com
 Somlanare Romuald KINDA=somlanare.kinda@udamail.fr
 Tidiane Kinda=tkinda@imf.org
 Hans Jarle Kind=hans.kind@nhh.no
 David Neden King=dnk1@stir.ac.uk
 Geeta Gandhi Kingdon=g.kingdon@ioe.ac.uk
 Elizabeth M. King=eking@worldbank.org
 Gary King=king@harvard.edu
 Ian King=ipking@unimelb.edu.au
 Michael R. King=mking@ivey.ca
 Christian Kitenge Moembo Kingombe=c.kingombe@afdb.org
 Robert King=rking@bu.edu
 Robert P. King=rking@umn.edu
 Stephen Peter King=stephen.king@monash.edu
 Christopher Kingston=cgkingston@amherst.edu
 Takuya Kinkawa=taku@bluesky.memail.jp
 Henry W Kinnucan=kinnuhw@auburn.edu
 Stephen Kinsella=stephen.kinsella@ul.ie
 Gorm Kipperberg=gorm.kipperberg@uis.no
 Arzdar Kiraci=arzdar.kiraci@gmail.com
 Ankinée Kirakozian=ankinee.kirakozian@unice.fr
 Philipp Albert Theodor Kircher=philipp.kircher@gmail.com
 Gebhard Kirchgässner=gebhard.kirchgaessner@unisg.ch
 Oliver Kirchkamp=oliver@kirchkamp.de
 Markus Kirchner=mkirchner@bcentral.cl
 Stephen Kirchner=info@institutional-economics.com
 Georg Kirchsteiger=gkirchst@ulb.ac.be
 Alexei Kireyev=akireyev@hotmail.com
 Dimitris G. Kirikos=kirikosd@staff.teicrete.gr
 Tanja Kirjavainen=tanja.kirjavainen@vtv.fi
 Jacob Funk Kirkegaard=jkirkegaard@piie.com
 Rene Kirkegaard=rkirkega@uoguelph.ca
 John A. Kirlin=jkirlin@ers.usda.gov
 Alan Kirman=alan.kirman@univ-amu.fr
 Hasan Kirmanoglu=hkirman@bilgi.edu.tr
 Tanja Kirn=tanja.kirn@uni.li
 Heitor Marcos Kirsch=heitor.kirsch@gmail.com
 Johann Frederick Kirsten=johann.kirsten@up.ac.za
 Marie Kirsten=mariek@dbsa.org
 Olessia Kirtchik=okirchik@hse.ru
 Barrett E. Kirwan=bkirwan@illinois.edu
 Eugene Kiselev=ekiselev@brandeis.edu
 Keiichi Kishi=ba000069@gmail.com
 Avinash Kishore=avinash.kishore@gmail.com
 N Kundan Kishor=kishor@uwm.edu
 Turgut Kisinbay=kisinbay@yahoo.com
 David Kiss=kiss@aoek.uni-hannover.de
 Elinda Fishman Kiss=efkiss@aol.com
 Gábor Dávid Kiss=kiss.gabor.david@eco.u-szeged.hu
 Istvan Kiss=kiss-i@freemail.hu
 Khalid M. Kisswani=kisswani.k@gust.edu.kw
 Akiomi Kitagawa=kitagawa@econ.tohoku.ac.jp
 Masaomi Kitagawa=info@masaomi.jp
 Minoru Kitahara=ee37019@mail.ecc.u-tokyo.ac.jp
 Ryoma Kitamura=aja83048@kwansei.ac.jp
 Yoshihiro Kitamura=kitamu@gmail.com
 Yukinobu Kitamura=kitamura@ier.hit-u.ac.jp
 Shigeto Kitano=kitano@rieb.kobe-u.ac.jp
 Sagiri Kitao=sagiri.kitao@gmail.com
 John Kitchen=john.kitchen@treasury.gov
 Ivan Kitov=ivan.o.kitov@gmail.com
 Oleg Kitov=oleg.kitov@economics.ox.ac.uk
 Michael Kitson=mk24@cam.ac.uk
 Sverre A.C. Kittelsen=sverre.kittelsen@frisch.uio.no
 Markus Kitzmuller=mkitzmue@umich.edu
 Samir Kiuhan=skiuhan@javeriana.edu.co
 Olga Kiuila=kiuila@yahoo.com
 Bjørnar Karlsen Kivedal=bjornark@hiof.no
 Jan Frederik Kiviet=jfkiviet@ntu.edu.sg
 Kurmet Kivipõld=kurmet.kivipold@ut.ee
 Kazuharu Kiyono=kazr@waseda.jp
 Renatas Kizys=renatas.kizys@port.ac.uk
 Özgür Kıbrıs=ozgur@sabanciuniv.edu
 Murat Güray Kırdar=kirdar@metu.edu.tr
 Franc Klaassen=f.klaassen@uva.nl
 Johan Klaesson=johan.klaesson@jibs.hj.se
 Leora F. Klapper=lklapper@worldbank.org
 Erik Klär=erikklaer@aol.com
 Torben Alexander Klarl=torben.alexander.klarl@wiwi.uni-augsburg.de
 Stephan Klasen=sklasen@uni-goettingen.de
 Mariko J. Klasing=klasing.mariko@gmail.com
 Benjamin Klaus=benjamin.klaus@ecb.int
 Bettina Klaus=bettina.klaus@unil.ch
 Hansjörg Klausinger=hansjoerg.klausinger@wu.ac.at
 Chris van Klaveren=cp.vanklaveren@maastrichtuniversity.nl
 Stanislav Klazar=klazar@vse.cz
 Michael Kleemann=kleemann@ifo.de
 Frank Kleibergen=frank_kleibergen@brown.edu
 Jan Kleibrink=jan.kleibrink@rub.de
 Stefanie Kleimeier=s.kleimeier@maastrichtuniversity.nl
 Benjamin Klein=bklein@compasslexecon.com
 Daniel B. Klein=dklein@gmu.edu
 Joern Kleinert=joern.kleinert@uni-graz.at
 Gordon Jochem Klein=klein@dice.uni-duesseldorf.de
 Kristin J. Kleinjans=kkleinjans@fullerton.edu
 Joachim Klein=joachim.klein@lrz.uni-muenchen.de
 Martin Klein=martin.klein@wiwi.uni-halle.de
 Mathias Klein=m.klein4@gmx.de
 Michael W. Klein=michael.klein@tufts.edu
 Jan Kleinnijenhuis=j.kleinnijenhuis@fsw.vu.nl
 Paul Klein=paul_klein_2@sfu.ca
 Peter Klein=pklein@missouri.edu
 Roger W. Klein=rogerwklein@gmail.com
 Tobias J. Klein=t.j.klein@uvt.nl
 Heather Klemick=klemick.heather@epa.gov
 Marcus Klemm=marcus.klemm@destatis.de
 Paul Klemperer=paul.klemperer@economics.ox.ac.uk
 Marc Patrick Brag Klemp=marc_klemp@brown.edu
 Tore Selland Kleppe=tore.kleppe@math.uib.no
 Parvinder Kler=p.kler@griffith.edu.au
 N. Anders Klevmarken=anders.klevmarken@nek.uu.se
 Agata Kliber=agata.kliber@ue.poznan.pl
 Pawel Kilber=p.kliber@ue.poznan.pl
 Mohamed Faker KLIBI=faker.klibi@planet.tn
 Jonathan Klick=jklick@law.upenn.edu
 Martin Kliem=martin.kliem@bundesbank.de
 Kevin L. Kliesen=kliesen@stls.frb.org
 Doron Kliger=kliger@econ.haifa.ac.il
 Flip Klijn=flip.klijn@iae.csic.es
 Christiana Klikova=christiana.klikova@vsb.cz
 Karol Marek Klimczak=kmklim@poczta.onet.pl
 Mikołaj Klimczak=mikolaj.klimczak@ue.wroc.pl
 Andrzej Klimczuk=aklimczuk@gazeta.pl
 Artur Klimek=artur.klimek@ue.wroc.pl
 Shawn D. Klimek=shawn.d.klimek@census.gov
 Anastasia Klimova=anastasia.klimova@uts.edu.au
 Blagoy Klimov=bklimov@yahoo.co.uk
 Catherine Louise Kling=ckling@iastate.edu
 Henrik Klinge Jacobsen=jhja@dtu.dk
 Gerhard Kling=gk17@soas.ac.uk
 Sigbert Klinke=sigbert@wiwi.hu-berlin.de
 Stathis Klonaris=s.klonaris@aua.gr
 Stefan Klonner=stefan@klonner.de
 Frédéric Klopfert=frederic.klopfert@ulb.ac.be
 Esteban F. Klor=eklor@huji.ac.il
 Jens Klose=jens.klose@svr-wirtschaft.de
 Mathias Kloss=kloss@iamo.de
 Tomas Klos=t.b.klos@tudelft.nl
 Ben Klotz=benklotz@gmail.com
 Jan Kluge=kluge@ifo.de
 Florian Klug=florian.klug@hm.edu
 Tilman Klumpp=klumpp@ualberta.ca
 Tatiana Kluvánková-Oravská=tana@cetip.sk
 Jochen Kluve=jochen.kluve@hu-berlin.de
 Vladimir Klyuev=vklyuev@imf.org
 Manoj P. K=manoj_p_k2004@yahoo.co.in
 Jan Kmenta=jan.kmenta@cerge-ei.cz
 Thijs Knaap=thijs@knaap.com
 Andreas Knabe=andreas.knabe@ovgu.de
 Andreas Knaut=andreas.knaut@ewi.uni-koeln.de
 Christian Knebel=cknebel@web.de
 Ronald Kneebone=kneebone@ucalgary.ca
 Richard Anthony Kneller=richard.kneller@nottingham.ac.uk
 Mark S. Knell=mark.knell@nifu.no
 Markus Knell=markus.knell@oenb.at
 Jack Knetsch=knetsch@sfu.ca
 Martin Kniepert=martin.kniepert@boku.ac.at
 Thomas J. Kniesner=tkniesne@maxwell.syr.edu
 Genevieve Margaret Knight=g.knight@psi.org.uk
 John L. Knight=jknight@uwo.ca
 April Knill=aknill@cob.fsu.edu
 Christopher R. Knittel=knittel@mit.edu
 Vicki Knoblauch=vicki.knoblauch@uconn.edu
 Michael Knogler=knogler@ios-regensburg.de
 Christoph Knoppik=christoph.knoppik@wiwi.uni-regensburg.de
 Edward S. Knotek, II=edward.knotek@clev.frb.org
 John A. Knowles=j.a.knowles@soton.ac.uk
 William Knudson=knudsonw@msu.edu
 John F. Knutsen=john.knutsen@alum.mit.edu
 Bruce Harold Kobayashi=bkobayas@gmu.edu
 Mimako Kobayashi=mkobayashi@worldbank.org
 Takao Kobayashi=tkobayashi@e.u-tokyo.ac.jp
 Ralph Kober=ralph.kober@monash.edu
 Necmettin Alpay KOÇAK=alpaykocak@tuik.gov.tr
 Evžen Kočenda=evzen.kocenda@cerge-ei.cz
 Alexander Karl Koch=akoch@econ.au.dk
 Andreas Koch=andreas.koch@iaw.edu
 Anna Kochanova=kochanova@coll.mpg.de
 Georgi Kocharkov=georgi@georgikocharkov.com
 Catherine Tahmee Koch=catherine.koch@econ.uzh.ch
 Christoffer Koch=christoffer.koch@dal.frb.org
 Christopher Koch=ckoch@bwl.uni-mannheim.de
 Martin Georg Kocher=martin.kocher@lrz.uni-muenchen.de
 Yuri B. Kochevrin=brakobra@mail.ru
 Ikuho Kochi=ikuho.kochi@uacj.mx
 Chiu Yu Ko=kochiuyu@nus.edu.sg
 James V. Koch=jkoch@odu.edu
 Karl-Josef Koch=koch@vwl.wiwi.uni-siegen.de
 Steven Fredric Koch=steve.koch@up.ac.za
 Wilfried KOCH=koch.wilfried@uqam.ca
 Andrzej Kociecki=andrzej.kociecki@nbp.pl
 Levent Kockesen=lkockesen@ku.edu.tr
 Udo Kock=ukock@imf.org
 Zalan Kocsis=kocsisz@mnb.hu
 László Á. Kóczy=koczy@krtk.mta.hu
 Yuka Kodama=kodama@ide.go.jp
 Oasis Kodila-Tedika=oasiskodila@yahoo.fr
 Bertrand M. Koebel=koebel@unistra.fr
 Steen Koekebakker=steen.koekebakker@uia.no
 Carla I. Koen=c.i.koen@hotmail.com
 Johannes Koenen=koenen@ifo.de
 Andreas Koenig=andreas.koenig@uni-hohenheim.de
 Vincent Koen=vincent.koen@oecd.org
 Thorsten V. Koeppl=thor@econ.queensu.ca
 Kristian Koerselman=koerselman@economistatwork.com
 Mark J. Koetse=mark.koetse@vu.nl
 Mori Kogid=edy@ums.edu.my
 Dieter Franz Kogler=dieter.kogler@ucd.ie
 Andrew I. Kohen=kohenai@jmu.edu
 Christian Köhler=christian.koehler@zew.de
 Pierre Kohler=kohler.pierre@gmail.com
 Ulrich Kohler=ukohler@uni-potsdam.de
 Michael Kohlhaas=mkohlhaas@diw.de
 Janet Kohlhase=jkohlhase@uh.edu
 Gunnar Köhlin=gunnar.kohlin@economics.gu.se
 Renu Kohli=renukohli@yahoo.com
 Emanuel Kohlscheen=emanuel.kohlscheen@bcb.gov.br
 Sebastian Kohls=sebastian.kohls@u.northwestern.edu
 Dirk Kohnert=kohnert@giga-hamburg.de
 Meir Kohn=mkohn@dartmouth.edu
 Robert J. Kohn=r.kohn@unsw.edu.au
 Anssi Kohonen=anssi.kohonen@helsinki.fi
 Katerina Koka=kkoka@brocku.ca
 Sotirios C. Kokas=skokas01@ucy.ac.cy
 Edward Charles Kokkelenberg=kokkele@binghamton.edu
 Angelika I. Kokkinaki=kokkinaki.a@intercollege.ac.cy
 Ari Kokko=ako.int@cbs.dk
 Maria Kokoreva=mkokoreva@hse.ru
 Aycan Koksal=aycankoksal@gmail.com
 Bülent Köksal=bkoksal@gmail.com
 Christoffer Kok Sørensen=christoffer.kok@ecb.europa.eu
 Kwan Wai Ko=kwan.ko@cuhk.edu.hk
 Marcin Kolasa=marcin.kolasa@nbp.pl
 Gilles Koléda=gilles.koleda@univ-tours.fr
 Erik Kole=kole@ese.eur.nl
 Stanislav Kolenikov=skolenik@gmail.com
 Georgiy Kolesnik=gvkolesn@inbox.ru
 Stefan Kolev=kolev@hwwi.org
 Kayhan Koleyni=kkoleyni@memphis.edu
 Mohan Kolhe=mpkolhe@yahoo.com
 Felix Kölle=felix.kolle@nottingham.ac.uk
 Robert Kollmann=robert.kollmann@ulb.ac.be
 Trevor Matthew Kollmann=t.kollmann@latrobe.edu.au
 Janos Köllő=kollo@econ.core.hu
 Srinivas Kolluru=kolluru03@gmail.com
 Ann-Sofie Kolm=ann-sofie.kolm@ne.su.se
 Martin Kolmar=martin.kolmar@unisg.ch
 André Kolodziejak=andreas.kolodziejak@ec.europa.eu
 Marek K. Kolodziej=marek@bu.edu
 Argyrios D. Kolokontes=argiriko@otenet.gr
 Yaya Koloma=ykoloma@yahoo.fr
 Philipp Kolo=philipp.kolo@googlemail.com
 Marina Kolosnitsyna=mkolosnitsyna@hse.ru
 Anton Kolotilin=akolotilin@gmail.com
 Lubos Komarek=lubos.komarek@cnb.cz
 Iliya Komarev=ikomarev@yahoo.com
 Zlatuse Komarkova=zlatuse.komarkova@cnb.cz
 András Komáromi=komaromi@econ.berkeley.edu
 Ahmad Komarulzaman=ahmadkomarulzaman@yahoo.com
 John Komlos=john.komlos@gmx.de
 Basanth Kommadath=basanth@iitk.ac.in
 Piet Kommers, Sr.=kommers@edte.utwente.nl
 Tom Kompas=tom.kompas@anu.edu.au
 Denise Eby Konan=konan@hawaii.edu
 Arup Kanti Konar=akkonar@gmail.com
 Vadym Konchyn=konwad@yahoo.com
 Ayako Kondo=akondo@ynu.ac.jp
 Péter Kondor=kondorp@ceu.hu
 Nikolay Kondrashov=nkondrashov@hse.ru
 Tomas Konecny=tomas.konecny@cnb.cz
 Chaleampong Kongcharoen=chaleampong@econ.tu.ac.th
 Tao Sherry Kong=tao.kong@pku.edu.cn
 Jerzy D. Konieczny=jurek@wlu.ca
 Michael David König=michael.koenig@econ.uzh.ch
 Amir Konigsberg=amirkonigsberg@gmail.com
 Sebastian Königs=sebastian.konigs@economics.ox.ac.uk
 Pierre Koning=pierrex@ziggo.nl
 Ruud Koning=ruud@rhkoning.com
 Jozef Konings=joep.konings@econ.kuleuven.be
 Hideo Konishi=hideo.konishi@bc.edu
 Igor Konnov=konn-igor@ya.ru
 Hisaki Kono=kono@econ.kyoto-u.ac.jp
 Joshua Ioji Konov=joshua.konov@gmail.com
 James Konow=jkonow@lmu.edu
 Kai A. Konrad=kai.konrad@tax.mpg.de
 Adama Konseiga=akonseiga@yahoo.com
 Konstantinos Konstantaras=konstantinos.konstantaras@yahoo.com
 Vassil A. Konstantinov=vakonstantinov@statestreet.com
 Krzysztof Kontek=kontek@artal.com.pl
 Maty KONTE=maty_konte@yahoo.fr
 Erricos John Kontoghiorghes=erricos@dcs.bbk.ac.uk
 Zenon Kontolemis=zenon.kontolemis@ec.europa.eu
 Alexandros Kontonikas=alexandros.kontonikas@glasgow.ac.uk
 István Kónya=konyai@mnb.hu
 Laszlo Konya=l.konya@latrobe.edu.au
 Jawoo Koo=j.koo@cgiar.org
 Clemens J.M. Kool=c.j.m.kool@uu.nl
 Eric Koomen=ekoomen@feweb.vu.nl
 Gary Koop=gary.koop@strath.ac.uk
 Siem Jan Koopman=s.j.koopman@vu.nl
 Katarzyna Kopczewska=kkopczewska@wne.uw.edu.pl
 Tomasz Kopczewski=tkopczewski@wne.uw.edu.pl
 Wojciech Kopczuk=wojciech.kopczuk@columbia.edu
 Karen A. Kopecky=karen.kopecky@atl.frb.org
 Michael Kopel=michael.kopel@uni-graz.at
 Joanna Aleksandra Kopinska=kopinska@economia.uniroma2.it
 Angela Kopmann=angela.kopmann@ifw-kiel.de
 Elena Dmitrievna Kopnova=ekopnova@hse.ru
 Alexandre Kopoin=alexandre.kopoin.1@ulaval.ca
 Hannes Koppel=hannes.koppel@gmail.com
 Hans C. Kopperer=dockop@mweb.co.za
 Roger Koppl=rkoppl@syr.edu
 Monika Irena Köppl-Turyna=monika.turyna@iscte.pt
 Raymond John Kopp=kopp@rff.org
 Michael Kopsidis=kopsidis@iamo.de
 Petr Korab (Petr Koráb)=petr.korab@mendelu.cz
 Catherine Korachais=catherine.korachais@gmail.com
 Robert Korajczyk=r-korajczyk@northwestern.edu
 Levent Korap=lkorap@hotmail.com
 Oleg Korenok=okorenok@vcu.edu
 Jane Korinek=jane.korinek@oecd.org
 Yukio Koriyama=yukio.koriyama@polytechnique.edu
 Abdurrahman KORKMAZ=korkmaz@korkmaz.cc
 Anna Kormilitsina=annak@smu.edu
 Finn Marten Körner=koerner@zen-tra.de
 Pavel Körner=korner@fsv.cuni.cz
 Andrey Korotayev=akorotayev@gmail.com
 Roxanne Korthals=r.korthals@maastrichtuniversity.nl
 Tro Kortian=trok@econ.usyd.edu.au
 John R. Kort=jkort98@gmail.com
 Michael Kortt=michael.kortt@scu.edu.au
 Samuel Kortum=samuel.kortum@yale.edu
 Nebile Korucu=nkorucu@gmail.com
 Anna Korzeniowska=anna.korzeniowska@umcs.lublin.pl
 Artem Korzhenevych=akorzhenevych@diw-econ.de
 Stephen Kosempel=kosempel@uoguelph.ca
 Sevim Kösem=sevimkosem@gmail.com
 Michael Kosfeld=kosfeld@econ.uni-frankfurt.de
 Reinhold Kosfeld=rkosfeld@wirtschaft.uni-kassel.de
 Onur A. Koska=onur.koska@uni-tuebingen.de
 Jennifer Lynch Koski=jkoski@u.washington.edu
 Yrjö Koskinen=yrjo@bu.edu
 Theodora Kosma=tkosma@bankofgreece.gr
 Lea-Rachel D. Kosnik=kosnikl@umsl.edu
 Tuomas Kosonen=tuomas.kosonen@vatt.fi
 Anneke Kosse=j.c.m.kosse@dnb.nl
 Elena Kossova=ekossova@hse.ru
 Tatiana Kossova=tkossova@hse.ru
 Vladimir V. Kossov=kossov3@yandex.ru
 Maurice Koster=mkoster@uva.nl
 Paul Koster=p.r.koster@vu.nl
 Sierdjan Koster=sierdjan.koster@rug.nl
 Crt Kostevc=crt.kostevc@ef.uni-lj.si
 Pantelis Kostis=pkostis@econ.uoa.gr
 Miroslava Kostková=kostkova@opf.slu.cz
 Daniel Kostzer=dkostzer@yahoo.com
 Srinivasa Reddy Kotapati=srinuddm@iitr.ernet.in
 Zoya Kotelnikova=kotelnikova@hse.ru
 Radosław Kotkowski=radek.kotkowski@gmail.com
 Igor Kotlan=igor.kotlan@vsb.cz
 Viktor Kotlán=vkotlan@csas.cz
 Laurence Kotlikoff=kotlikoff@gmail.com
 Jacek Kotłowski=jacek.kotlowski@nbp.pl
 Denis Kotov=dcotov@yahoo.com
 Andrus Kotri=andrus.kotri@ut.ee
 Andreas Kotsadam=andreas.kotsadam@econ.uio.no
 Barbara R. Kotschwar=bkotschwar@piie.com
 Maxim Nikolaevich Kotsemir=mkotsemir@hse.ru
 Maria Georgieva Kotseva-Tikova=maria_kotseva@yahoo.com
 Constantina Kottaridi=kottarid@unipi.gr
 Ashok Kotwal=ashokk@interchange.ubc.ca
 Kevin Kotze=kevin.kotze@uct.ac.za
 Hugues Kouassi KOUADIO=hkouadio@yahoo.fr
 Luděk Kouba=kouba@mendelu.cz
 Sergei P. Kouchtch=kouchtch@gsom.pu.ru
 Imen Kouki=imen_kouki@yahoo.fr
 Minoas Koukouritakis=minoas@econ.soc.uoc.gr
 Sergei Koulayev=sergei.koulayev@gmail.com
 Mikhail Kouliavtsev=kouliavtms@sfasu.edu
 Marie Koulikoff-Souviron=marie.koulikoff@skema.edu
 Christos Koulovatianos=koulovatianos@wiwi.uni-frankfurt.de
 Rouslan Koumakhov=rouslan.koumakhov@reims-ms.fr
 Evangelos Petros Koumanakos=ekoumanakos@cc.uoi.gr
 Nelnan Koumtingué=nelnan.koumtingue@wto.org
 Phoebe Koundouri=pkoundouri@aueb.gr
 Kostantinos Elias Kounetas=kounetas@upatras.gr
 Michael Kouparitsas=michael.kouparitsas@treasury.gov.au
 Georgios P. Kouretas=kouretas@aueb.gr
 Nikolaos Kourogenis=nkourogenis@yahoo.com
 Andros Kourtellos=andros@ucy.ac.cy
 Dimitrios V. Kousenidis=dkous@econ.auth.gr
 Zisimos Koustas=zisimos.koustas@brocku.ca
 Franciscos Koutentakis=f.koutentakis@uoc.gr
 Christos Koutsampelas=koutsampelas.christos@ucy.ac.cy
 Nikitas-Spiros Koutsoukis=nkoutsou@uop.gr
 Roy Kouwenberg=kouwenberg@ese.eur.nl
 Goran Kovachev=goran.kovachev@gmail.com
 Zlatko J. Kovačić=zlatko.kovacic@openpolytechnic.ac.nz
 Erzsébet Kovács=erzsebet.kovacs@uni-corvinus.hu
 Kent Forrest Kovacs=kkovacs@uark.edu
 Tamás Kovács=thomy@t-online.hu
 Alexander Kovalenkov=a.kovalenkov@lbss.gla.ac.uk
 Mikhail M. Kovalev=kovalev@bsu.by
 Jaromír Kovářík=jaromir.kovarik@ehu.es
 Dan Kovenock=kovenock@chapman.edu
 Oskar Kowalewski=okowale@sgh.waw.pl
 Pawel Kowal=pawel.kowal@ibs.org.pl
 Przemyslaw Kowalski=przemyslaw.kowalski@oecd.org
 Tadeusz Kowalski=tadeusz.kowalski@ue.poznan.pl
 Henk L.M. Kox=h.l.m.kox@cpb.nl
 Mark Koyama=mark.koyama@googlemail.com
 Murat Koyuncu=mkoyuncu@boun.edu.tr
 Roman Kozhan=roman.kozhan@wbs.ac.uk
 Sharon Kozicki=skozicki@bank-banque-canada.ca
 Olesia Kozlova=olesia.kozlova@unh.edu
 Ralph Kozlow=rkozlow@imf.org
 Tomasz Kozluk=tomasz.kozluk@oecd.org
 Antonija Kožul=akozul@efzg.hr
 Zeljka Kozul-Wright=zeljka.kozul-wright@unctad.org
 Kangni KPODAR=kkpodar@imf.org
 Prabheesh K P=prabheeshkp@gmail.com
 Aart Kraay=akraay@worldbank.org
 Jan Kraemer=kraemer@kit.edu
 Jackie Krafft=jackie.krafft@gredeg.cnrs.fr
 Aleli D. Kraft=aleli.kraft@up.edu.ph
 Kornelius Kraft=kornelius.kraft@uni-dortmund.de
 Martin Kragh=martin.kragh@hhs.se
 Elke Krahmann=elke.krahmann@brunel.ac.uk
 Jan Pieter Krahnen=krahnen@wiwi.uni-frankfurt.de
 John Robert Krainer=john.krainer@sf.frb.org
 David Mortimer Krainz=dkrainz@yahoo.de
 Jarek Krajewski=krajewsk@uni-wuppertal.de
 Andrea Krajina=akrajina@gmail.com
 Matthias Kräkel=m.kraekel@uni-bonn.de
 Francis Kramarz=kramarz@ensae.fr
 Randall Kramer=kramer@duke.edu
 Walter Krämer=walterk@statistik.uni-dortmund.de
 Dmitry Kramkov=kramkov@andrew.cmu.edu
 Jan Kranich=kranich@mik.uni-hannover.de
 Laurence Kranich=lkranich@albany.edu
 Sebastian Kranz=sebastian.kranz@uni-ulm.de
 Matthias Krapf=matthias.krapf@business.uzh.ch
 Harry Krashinsky=harry.krashinsky@utoronto.ca
 Armand Krasniqi=mandikrasniqi@yahoo.com
 Besnik Krasniqi=b.krasniqi@staffs.ac.uk
 Oleg Krasnopjorov=olegs.krasnopjorovs@bank.lv
 Kurt Heinz Kratena=kurt.kratena@wifo.ac.at
 Markus Krätzig=mk@mk-home.de
 Alan Krause=alan.krause@york.ac.uk
 Kate Krause=kkrause@unm.edu
 Melanie Krause=melanie.krause@wiwi.uni-frankfurt.de
 Michael Krause=michael_u_krause@yahoo.com
 Marvin Kraus=kraus@bc.edu
 Roman Kräussl=roman.kraussl@uni.lu
 Brian Krauth=bkrauth@sfu.ca
 Sebastian Krautheim=sebastian.krautheim@eui.eu
 Jacek Krawczyk=j.krawczyk@vuw.ac.nz
 Michal Wiktor Krawczyk=mkrawczyk@wne.uw.edu.pl
 Tom Krebs=tkrebs@econ.uni-mannheim.de
 Matthias Kredler=mkredler@gmail.com
 Steven F Kreft=skreft@indiana.edu
 Udo Kreickemeier=udo.kreickemeier@uni-tuebingen.de
 Brent Kreider=bkreider@iastate.edu
 Henning Kreis=henning.kreis@fu-berlin.de
 Manfred Kremer=manfred.kremer@ecb.europa.eu
 Michael Kremer=mkremer@fas.harvard.edu
 Hans Kremers=hkremers@icloud.com
 Tobias Kretschmer=t.kretschmer@lmu.de
 Frauke Kreuter=fkreuter@survey.umd.edu
 Eva Kreuzbergova=eva.kreuzbergova@centrum.cz
 Thomas Krichel=krichel@openlib.org
 Ben Kriechel=ben@kriechel.eu
 Christiane Krieger-Boden=christiane.krieger-boden@ifw-kiel.de
 Kristian Krieger=kristian.1.krieger@kcl.ac.uk
 Harold Krikke=krikke@uvt.nl
 Bettina Johanna Krings=bettina-johanna.krings@kit.edu
 Sebastian Kripfganz=kripfganz@wiwi.uni-frankfurt.de
 Leo Krippner=leo.krippner@rbnz.govt.nz
 Kala Krishna=kmk4@psu.edu
 Jaya Krishnakumar=jaya.krishnakumar@unige.ch
 Raveesh Krishnankutty=raveeshbabu@gmail.com
 M Krishnan=mkrishnan57@gmail.com
 Sandeep K. Krishnan=sandeephrm@gmail.com
 Sudeep K. Krishnan=sudeepk@iimahd.ernet.in
 Sooriyakumar Krishnapillai=kzs0008@auburn.edu
 Pravin Krishna=pravin_krishna@jhu.edu
 Vijesh Vijaya Krishna=vijeshkrishna@gmail.com
 Ivan Kristek=ivankristek@gmail.com
 Dennis Kristensen=d.kristensen@ucl.ac.uk
 Johannes Tang Kristensen=jtang@creates.au.dk
 Nicolai Kristensen=nik@akf.dk
 Helga Kristjánsdóttir=helgakr@hi.is
 Arnaldur Sölvi Kristjánsson=kristjansson07@gmail.com
 Jannie Helene Grøne Kristoffersen=jhgk.cebr@cbs.dk
 Ladislav Krištoufek=kristoufek@ies-prague.org
 Bengt Kriström=bengt.kristrom@sekon.slu.se
 Alexander Kritikos=akritikos@diw.de
 Ekaterina Krivonos=ekaterina.krivonos@fao.org
 Damir Krizanac=damir.krizanac@gmail.com
 C.J. Krizan=c_j_krizan@yahoo.com
 Peter Nicholas Kriz=peter.kriz@econassets.com
 Tim A. Kroencke=kroencke@uni-mannheim.de
 Sabine Kröger=skroger@ecn.ulaval.ca
 Oskar Krohmer=krohmer@ifo.de
 Stephan Kroll=stephan.kroll@colostate.edu
 Michal Krol=michal.krol@manchester.ac.uk
 Robert Charles Krol=robert.krol@csun.edu
 Hans-Martin Krolzig=hm.krolzig@kent.ac.uk
 Lone Grønbæk Kronbak=lg@sam.sdu.dk
 Tobias Kronenberg=tobias.kronenberg@hs-bochum.de
 Alexei Krouglov=alexkrouglov@gmail.com
 Ana Krsmanovic=ana.krsmanovic@mif.gov.me
 Alan B. Krueger=akrueger@princeton.edu
 Dirk Krueger=dkrueger@econ.upenn.edu
 Malte Krueger=malte.krueger@h-ab.de
 Norris Krueger=norris.krueger@gmail.com
 Jens J. Krüger=krueger@vwl.tu-darmstadt.de
 Paul Krugman=pkrugman@princeton.edu
 Sebastian Krug=s.krug@economics.uni-kiel.de
 Froukje Kruijssen=fkruijssen@hotmail.com
 Hugo Kruiniger=hugo.kruiniger@durham.ac.uk
 Dzmitry Kruk=kruk@beroc.by
 Alex Krumer=krumer.alex@gmail.com
 Marija Krūmiņa=marija@biceps.org
 Alan Krupnick=krupnick@rff.org
 Thomas Kruppe=thomas.kruppe@iab.de
 Johannes Kruse=jkruse@bigsss.uni-bremen.de
 Per Krusell=krusell@iies.su.se
 Balázs Krusper=krusperb@mnb.hu
 Frank C. Krysiak=frank.krysiak@unibas.ch
 Oleksiy Kryvtsov=okryvtsov@bankofcanada.ca
 K S Chalapati Rao=chalapatirao@yahoo.com
 Muthupandian K S=ksmuthupandian@ymail.com
 Christopher Ksoll=cksoll@uottawa.ca
 Chung-Ming Kuan=ckuanmetrics@gmail.com
 Pei Kuang=p.kuang@bham.ac.uk
 Dana Kubickova=dana.kubickova@centrum.cz
 Ingrid Kubin=ingrid.kubin@wu.ac.at
 Dorothea Kübler=d.kuebler@ww.tu-berlin.de
 Felix Kubler=fkubler@gmail.com
 Luis Claudio Kubota=luis.kubota@ipea.gov.br
 Megumi Kubota=mkubota@worldbank.org
 Jakub Kucera=jakubkucera@web.de
 Miroslav Kucera=kuceram@gmail.com
 ismail Kucukaksoy=kucukaksoy@yahoo.com
 Hande Kucuk=handekucuk1@gmail.com
 Yakup Kucukkale=ykucukkale@hotmail.com
 Guray Kucukkocaoglu=gurayk@baskent.edu.tr
 C. Coşkun Küçüközmen=coskun.kucukozmen@ieu.edu.tr
 Serkan Küçükşenel=kuserkan@metu.edu.tr
 Uğur Namık Kücük=ugurkucuk@gmail.com
 Joanna Kuczewska=ekojku@univ.gda.pl
 Masayuki Kudamatsu=masayuki.kudamatsu@iies.su.se
 Magdaléna Kudelová=magdalena.kudelova@vsb.cz
 Noritaka Kudoh=kudoh@econ.hokudai.ac.jp
 George Kudrna=g.kudrna@unsw.edu.au
 Jerome Kueh=kshjerome@feb.unimas.my
 Daniel Kuehnle=daniel.kuehnle@wiso.uni-erlangen.de
 Zoe Kuehn=zoe.kuehn@uam.es
 Todd Henry Kuethe=tkuethe@ers.usda.gov
 Pawel Kufel=pawel.kufel@wsb.torun.pl
 Tadeusz Kufel=tadeusz.kufel@umk.pl
 Maurice Kugler=maurice.kugler@gmail.com
 Christian Henning Kuhlgatz=christian.kuhlgatz@ti.bund.de
 Jan Kühling=jan.kuehling@uni-oldenburg.de
 Karol Kuhl=kkuhl@wp.pl
 Michael Kühl=michael.kuehl@bundesbank.de
 Camelia Mariana Kuhnen=camelia_kuhnen@kenan-flagler.unc.edu
 Kai-Uwe Kuhn=kukuhn@umich.edu
 Peter Kuhn=pjkuhn@econ.ucsb.edu
 Stephan Kühntopf=stephan.kuehntopf@destatis.de
 Hyejin Ku=h.ku@ucl.ac.uk
 Oscar Kuikeu=projetlivre@yahoo.fr
 Onno Jan Kuik=onno.kuik@ivm.vu.nl
 Praveen Kujal=p.kujal@mdx.ac.uk
 Jiri Kukacka=jiri.kukacka@gmail.com
 Elira Kuka=ekuka@ucdavis.edu
 Agim Kukeli=akukeli@unyt.edu.al
 Agnieszka Kukułka=agnieszka.kukulka@ue.poznan.pl
 Ferit Kula=kulaf@erciyes.edu.tr
 Grzegorz Kula=gkula@wne.uw.edu.pl
 Lumír Kulhánek=lumir.kulhanek@vsb.cz
 Kamila Kulhavá=kamila.kulhava@gmail.com
 Karolina Kuligowska=kkuligowska@wne.uw.edu.pl
 Kishore G Kulkarni=kulkarnk@msudenver.edu
 Usha Kulkarni=ushakulkarni@yahoo.com
 Praveen Kulshreshtha=pravk@iitk.ac.in
 Klaus Kultti=klaus.kultti@helsinki.fi
 Ajantha Sisira Kumara=mhasisira@yahoo.co.uk
 Klajdi Kumaraku=k_kumaraku@yahoo.com
 Alok Kumar=alok@igidr.ac.in
 Alok Kumar=kumara@uvic.ca
 Anil Kumar=anil.kumar@dal.frb.org
 Anuj Kumar=anuj@caa.columbia.edu
 Durairaj K=doorai_raj@yahoo.co.in
 C.satheesh Kumar=drcsatheesh@gmail.com
 Deepak Kumar=barnwaldeepak_11@rediffmail.com
 Gagan Kumar=gaganv96@gmail.com
 Gitanjali Kumar=gkumar@bankofcanada.ca
 Hemanshu Kumar=hemanshu@econdse.org
 jyoti Kumari=jyoti.ind@gmail.com
 Jayesh Kumar=jay.kum@gmail.com
 Jitendra Kumar=vjitendrav@gmail.com
 Krishna Kumar=kumarkb@gmail.com
 Lakshmi Kumar=lakshmik@ifmr.ac.in
 Mukesh Kumar=drkumarmukesh@yahoo.co.in
 Nagesh Kumar=nageshkum@gmail.com
 Rajnish Kumar=rajnish.kumar@qub.ac.uk
 Ranjit Kumar=ranjit_kr@yahoo.com
 Ronald Ravinesh Kumar=ronaldkmr15@gmail.com
 Santosh Kumar=santosh.uh@gmail.com
 Saten Kumar=kumar_saten@yahoo.com
 Sudhanshu Kumar=onlysudh@gmail.com
 Surender Kumar=surenderkumarbansal@hotmail.com
 Vimal Kumar=vk@iitk.ac.in
 Vineet Kumar=vkumar@hbs.edu
 Abdullah Kumas=abdullahkumas@yahoo.com
 Subal C. Kumbhakar=kkar@binghamton.edu
 Vijay Maruti Kumbhar=vijay.kumbhar9@gmail.com
 Nese Kumral=nese.kumral@ege.edu.tr
 Cagri Seda Kumru=cagri.kumru@anu.edu.au
 Aljaz Kuncic=aljaz.kuncic@gmail.com
 Amit Kundu=akundu1970@rediffmail.com
 Rajendra Prasad Kundu=rajendra.kundu@gmail.com
 Fan-chin Kung=kungf@ecu.edu
 Takuma Kunieda=tkunieda@cityu.edu.hk
 André Kunkel=kunkel@vda.de
 Jan Kunnas=j.g.kunnas@stir.ac.uk
 Annemarie Kuenn-Nelen=a.kuenn@maastrichtuniversity.nl
 Robert M. Kunst=robert.kunst@univie.ac.at
 Antoine Kunth=akunth@worldbank.org
 Astrid Kunze=astrid.kunze@nhh.no
 Werner Kunz=werner.kunz@umb.edu
 Jing-Ming Kuo=thomas.jingming.kuo@gmail.com
 Ping-Sing Kuo=pkuo@mail.ndhu.edu.tw
 Timo Kuosmanen=timo.kuosmanen@aalto.fi
 Gerard H. Kuper=g.h.kuper@rug.nl
 Paul H. Kupiec=paul.kupiec@aei.org
 Radosław Kurach=radoslaw.kurach@ue.wroc.pl
 Karlygash Kuralbayeva=k.z.kuralbayeva@lse.ac.uk
 Juana R. Kuramoto=kuramoto@grade.org.pe
 Haydar Kurban=hkurban@howard.edu
 Alexey Nikolaevich Kurbatskiy=akurbatskiy@gmail.com
 Alexander Kurdin=aakurdin@gmail.com
 Anne T. Kuriakose=akuriakose@worldbank.org
 Jun Kurihara=kurihara.jun@gmail.com
 Kyosuke Kurita=kkurita@kwansei.ac.jp
 Koichi Kuriyama=kkuri@kais.kyoto-u.ac.jp
 Lyubov Arnoldovna Kurkalova=lakurkal@ncat.edu
 Elvira Kurmanalieva=ekurmanalieva@yahoo.com
 Andre Kurmann=kurmann.andre@gmail.com
 Иван Вячеславович Курманов (Ivan Kurmanov)=duraley@gmail.com
 Pavel Kurochkin=pkurochkin@gmail.com
 Sachiko Kuroda=s-kuroda@waseda.jp
 Toshifumi Kuroda=kuroda@tku.ac.jp
 Yoshinori Kurokawa=kurokawa.yoshi.fw@u.tsukuba.ac.jp
 Alexander Kurov=alkurov@mail.wvu.edu
 Anna Kurowska=a.kurowska@uw.edu.pl
 黒住英司 (Eiji Kurozumi)=kurozumi@stat.hit-u.ac.jp
 Takushi Kurozumi=takushi.kurozumi@boj.or.jp
 Peter Kurrild-Klitgaard=kurrild@ifs.ku.dk
 Sabine Kurtenbach=kurtenbach@giga-hamburg.de
 Mark R. Kurt=mkurt@elon.edu
 Fidan Ana Kurtulus=fidan@econs.umass.edu
 Oliwia Kurtyka=oliwia.kurtyka@grenoble-inp.fr
 Gokce Kurucu=gokcekurucu@gmail.com
 Burhanettin Kuruscu=kuruscu@gmail.com
 Heinz D. Kurz=heinz.kurz@uni-graz.at
 Alexey Kushnir=alexey.kushnir@gmail.com
 Yoko Kusunose=yoko.kusunose@uky.edu
 Andrea Marie Kuszewski=akuszewski@gmail.com
 Ali M. Kutan=akutan@siue.edu
 Zsolt Kuti=kutizs@mnb.hu
 Levent Kutlu=levent.kutlu@econ.gatech.edu
 Ryszard Kutner=erka@fuw.edu.pl
 Evgeniy Kutsenko=evg-kucenko@ya.ru
 Edward Kutsoati=edward.kutsoati@tufts.edu
 Kenneth Neil Kuttner=kkuttner@gmail.com
 Nandinee K. Kutty=nndkutty@aol.com
 Mark J. Kutzbach=mark.j.kutzbach@census.gov
 Shiro Kuwahara=kuwahara@sk.tsukuba.ac.jp
 Julia Kuzmina=jkuzmina@hse.ru
 Olga Kuznetsova=okuznetsova@hse.ru
 Olga Kuznetsova=o.kuznetsova@mmu.ac.uk
 Tolga Umut Kuzubas=umut.kuzubas@boun.edu.tr
 Mikhail Kuzyk=m_kuzyk@mail.ru
 Ola Kvaløy=ola.kvaloy@uis.no
 Snorre Kverndokk=snorre.kverndokk@frisch.uio.no
 Olav Kvitastein=olav.kvitastein@snf.no
 Sally Kwak=sally.kwak@mail.house.gov
 Sungil Kwak=sikwak@kiep.go.kr
 Noh-Sun Kwark=kwark@sogang.ac.kr
 Witold Kwasnicki=kwasnicki@prawo.uni.wroc.pl
 Yun-kwong Kwok=ykkwok@uic.edu.hk
 Lester M.K. Kwong=lkwong@brocku.ca
 Hyeog Ug Kwon=kwon.hyeogug@nihon-u.ac.jp
 Illoong Kwon=ilkwon@snu.ac.kr
 W. Jean Kwon=kwonw@stjohns.edu
 Margaret K. Kyle=margaret.kyle@tse-fr.eu
 Oldrich Kyn=okyn@verizon.net
 Andreas Kyriacou=andreas.kyriacou@udg.es
 George Kyriacou=georgekyriacou@centralbank.gov.cy
 Maria Kyriacou=m.kyriacou@soton.ac.uk
 Dimitris Kyriazis=dkyr@unipi.gr
 Catherine KYRTSOU=ckyrtsou@uom.gr
 Tomi Kyyrä=tomi.kyyra@vatt.fi
