 Usman Qadir=usman.qadir@pide.org.pk
 Mubashir Qasim=mubashir@iuj.ac.jp
 Abdul Qayyum=abdulqayyum@pide.org.pk
 Ahmar Qasim Qazi=ahmer_qazi@yahoo.com
 Masood Ahmed Qazi=qmasood@iba.edu.pk
 Junhui Qian=junhuiq@gmail.com
 Nancy Qian=nancy.qian@yale.edu
 Rong Qian=rqian@worldbank.org
 Xingwang Qian=qianx@buffalostate.edu
 Yiming Qian=yiming-qian@uiowa.edu
 Xue Qiao=qiaoxue@sem.tsinghua.edu.cn
 Yongyuan Qiao=yongyuan.qiao@gmail.com
 Li Qi=lqi@agnesscott.edu
 Cheng-Zhong Qin=qin@econ.ucsb.edu
 Duo Qin=dq1@soas.ac.uk
 Zhang qing=yinghuajing21@163.com
 Yu Qin=yq38@cornell.edu
 Dhimitri Qirjo=dqirj001@fiu.edu
 Feng Qiu=fqiu@ncsu.edu
 Larry Dongxiao Qiu=larryqiu@hku.hk
 Mozaffar Qizilbash=mozaffar.qizilbash@york.ac.uk
 Friedrun Quaas=quaas@wifa.uni-leipzig.de
 Syed Manzur Quader=manzur_quader@hotmail.com
 Vincenzo Quadrini=quadrini@usc.edu
 Mario Quagliariello=mario.quagliariello@eba.europa.eu
 Kwamena Quagrainie=kquagrai@purdue.edu
 Chee-Heong Quah=quahch@um.edu.my
 Danny Quah=d.quah@lse.ac.uk
 John K.-H. Quah=john.quah@economics.ox.ac.uk
 Anna Grazia Quaranta=annagrazia.quaranta@unibo.it
 Roberto Quaranta=roberto.quaranta@carloalberto.org
 Troy Quast=tcq001@shsu.edu
 Francesco Quatraro=francesco.quatraro@unice.fr
 Virginia Queijo von Heideken=virginia.queijo.von.heideken@riksbank.se
 Bertrand V. Quélin=quelin@hec.fr
 Núria Quella=nuriaquella@usa.net
 Laure Quennouëlle-Corre=laure.corre@noos.fr
 Pablo Querubin=pablo.querubin@gmail.com
 Antonio Quesada=aqa@urv.cat
 Javier Quesada=javier.quesada@ivie.es
 Lucía Quesada=luquesada@gmail.com
 M.G.Quibria=mgquibria@yahoo.com
 John Quiggin=j.quiggin@uq.edu.au
 E. Matthew Quigley=matt.quigley@occ.treas.gov
 Bryce Quillin=bquillin@imf.org
 Stella Luz A. Quimbo=stella_quimbo@yahoo.com
 Joseph Quinn=joseph.quinn@bc.edu
 Simon Quinn=simon.quinn@economics.ox.ac.uk
 Stephen Quinn=s.quinn@tcu.edu
 José Luís Quiñoá=joseluis.quinoa@usc.es
 Esteban J. Quiñones=e.quinones@cgiar.org
 Climent Quintana-Domeque=climent.quintana@gmail.com
 Ximena Quintanilla=xquintanilla@spensiones.cl
 María de los Ángeles Quintás Corredoira=quintas@uvigo.es
 Jose E Quintero=jquintero@stanfordalumni.org
 Luis E. Quintero=leq@cmu.edu
 Coralia Quintero Rojas=coralia@ugto.org
 Fabio Quintiliani=fabio.quintiliani@bancaditalia.it
 Erwan Quintin=equintin@bus.wisc.edu
 Glenda Quintini=glenda.quintini@oecd.org
 Martine Quinzii=mmquinzii@ucdavis.edu
 Miguel Ángel Quiroga Suazo=mquirog@udec.cl
 Zenon Quispe=zenon.quispe@bcrp.gob.pe
 Agnes Reynes Quisumbing=a.quisumbing@cgiar.org
 Lilia Quituisaca Samaniego=lilia.quituisaca.samaniego@gmail.com
 A.M.M. Shahiduzzaman Quoreshi=shahiduzzaman.quoreshi@bth.se
 khubaib Ahmed Qureshi=khubaib_ahmed@yahoo.com
 Madeeha Gohar Qureshi=madeeha@pide.org.pk
 Muhammad Ejaz Qureshi=ejaz.qureshi@aciar.gov.au
 Sohail Zafar Qureshi=s.zafar@usa.com
 Zhaopeng Qu=quzhaopeng@gmail.com
 Zhongjun Qu=qu@bu.edu
 Katharina Raabe=raabe@iuw.uni-hannover.de
 Roman Raab=econrraab@gmail.com
 Rodrigo Jardim Raad=rjraad@gmail.com
 Oddbjørn Raaum=oddbjorn.raaum@frisch.uio.no
 Gaël Raballand=graballand@worldbank.org
 Pau Rabanal=prabanal@imf.org
 Isabelle Rabaud=isabelle.rabaud@univ-orleans.fr
 Fazli Rabbi=rabbi.fazli@gmail.com
 Matthew P. Rabbitt=mprabbit@uncg.edu
 Birgitta Rabe=brabe@essex.ac.uk
 Sophia Rabe-Hesketh=sophiarh@berkeley.edu
 Roberta Rabellotti=roberta.rabellotti@unipv.it
 Marco Raberto=marco.raberto@unige.it
 Matthew D. Rablen=matthew.rablen@brunel.ac.uk
 Andrei Alexandrovich Rachinsky=aarachin@mts.ru
 Rafal Raciborski=rraciborski@stata.com
 François-Éric Racicot=racicot@telfer.uottawa.ca
 Jeffrey Scott Racine=racinej@mcmaster.ca
 Maria Racionero=maria.racionero@anu.edu.au
 Constantin Racoceanu=racoradu@yahoo.com
 Nicoleta Dorina Racolta-Paina=npaina@euro.ubbcluj.ro
 Ovidiu Racorean=decontatorul@hotmail.com
 Olivér Miklós Rácz=raczo@mnb.hu
 Vadim Radaev=radaev@hse.ru
 Alias Radam=alias@upm.edu.my
 Nicholas Edward Rada=nrada@ers.usda.gov
 Stanislav I. Radchenko=sradchen@email.uncc.edu
 Davide Radi=davide.radi@unibg.it
 Lacramioara Radomir=lacramioara.radomir@econ.ubbcluj.ro
 Slavo Radosevic=s.radosevic@ucl.ac.uk
 Jarmila Radová=radova@vse.cz
 Mirjana M. Radovic Markovic=mradovic@gmail.com
 Carmen Valentina Radulescu=cv_radulescu@yahoo.com
 Branko Radulovic=bradulovic@ius.bg.ac.rs
 Simona Luminita Radu=phd_radu_s@yahoo.com
 Valentin Radu=valu_radu@yahoo.com
 Sergiy Radyakin=sradyakin@worldbank.org
 Sven Rady=rady@hcm.uni-bonn.de
 Artur Radziwill=artur.radziwill@oecd.org
 David Rae=drae@nzsuperfund.co.nz
 Thomas Raferzeder=thomas.raferzeder@ooe.gv.at
 Kunibert Raffer=kunibert.raffer@univie.ac.at
 Matthew Rafferty=matthew.rafferty@quinnipiac.edu
 Horst Raff=raff@econ-theory.uni-kiel.de
 Natacha Raffin=nraffin@u-paris10.fr
 Andrea Raffo=andrearaffo@hotmail.com
 Shuddhasattwa Rafiq=shuddhasattwa.rafiq@usq.edu.au
 Ismael Rafols=i.rafols@sussex.ac.uk
 Christopher Thomas Southgate Ragan=christopher.ragan@mcgill.ca
 Catherine Ragasa Ragasa=c.ragasa@cgiar.org
 Elena Ragazzi=e.ragazzi@ceris.cnr.it
 Galindev Ragchaasuren=g.ragchaasuren@qub.ac.uk
 Rania Rageh=r_rageh@yahoo.com
 Davide Raggi=davide.raggi@unibo.it
 Mala Raghavan=mala.raghavan@utas.edu.au
 Srinivas Raghavendra=s.raghav@nuigalway.ie
 Manu Raghav=manuraghav@depauw.edu
 Prabhakaran T. Raghu=tr.prabha@gmail.com
 Ludovic Ragni=ragni@unice.fr
 Joachim Ragnitz=ragnitz@ifo.de
 Maddalena Ragona=maddalena.ragona@unibo.it
 Lionel Ragot=lragot@u-paris10.fr
 Xavier Ragot=xavier.ragot@gmail.com
 Dian Kartika Rahajeng=dkrahajeng@gmail.com
 Mohammad Rahimi=mohammad.rahimii@gmail.com
 Rohit Rahi=r.rahi@lse.ac.uk
 Ilya Markovich Rahkovsky=irahkovsky@ers.usda.gov
 Rudy Rahmaddi=rudy.rahmaddi@customs.go.id
 Ahmed S. Rahman=rahman@usna.edu
 David Rahman=dmr@umn.edu
 Md. Anisur Rahman=rahman.mdanisur@gmail.com
 Mizanur Rahman=mzr.rahman@gmail.com
 Mohammad Mafizur Rahman=rahman@usq.edu.au
 Sanzidur Rahman=srahman@plymouth.ac.uk
 Md. Tariqur Rahman=rahmantariqdu@gmail.com
 Tauhidur Rahman=tauhid@ag.arizona.edu
 Mohieddine RAHMOUNI=rahmouni_mo@yahoo.fr
 Dil Bahadur Rahut=dilrahut@yahoo.com
 Alan Rai=alan.rai@csiro.au
 Birendra Rai=birendra.rai@monash.edu
 Selim Raihan=sraihan_duecon@yahoo.com
 Răileanu Szeles Monica=monica.szeles@unitbv.ro
 Lukman Raimi=luq_man2001@yahoo.com
 Manuela Raimondi=manuela.raimondi@unipr.it
 Valentina Raimondi=valentina.raimondi@unimi.it
 Pascalis Raimondos-Møller=prm.eco@cbs.dk
 Helmut Rainer=rainer@ifo.de
 Rajesh Rai=rjerung@gmail.com
 Michele Raitano=michele.raitano@uniroma1.it
 Emilio Raiteri=emilio.raiteri@unito.it
 Michael Raith=raith@simon.rochester.edu
 Jagdish R. Raiyani=jrraiyani@gmail.com
 Gulasekaran Rajaguru=rgulasek@bond.edu.au
 Ramkishen S. Rajan=rrajan1@gmu.edu
 Sarath Rajapatirana=srajapatirana@gmail.com
 Ashish Rajbhandari=arajbhan@uci.edu
 Sameer Rajbhandary=sameer.rajbhandary@phac-aspc.gc.ca
 Miroslava Rajcaniova=miroslava.rajcaniova@uniag.sk
 Meenakshi Rajeev=meenakshirajeev2000@yahoo.com
 Srinivasulu R=srieconomist@gmail.com
 Madhusudan M. Raj=madhusudan_raj@yahoo.com
 Dr. Mukund Raj=raj@rajmukund.com
 Rajesh Raj=snrajeshraj@gmail.com
 David Alexander Rakowski=rakowski@cba.siu.edu
 Mukesh Ralhan=mralhan@uvic.ca
 Katherine L. Ralston=kralston@ers.usda.gov
 Dracea Raluca=ralucadracea@gmail.com
 M Ramachandran=ramchn2003@yahoo.co.in
 Ramakrishnan Ramachandran=ramakrish54@gmail.com
 Tarun Ramadorai=tarun.ramadorai@sbs.ox.ac.uk
 Eve Ramaekers=eve.ramaekers@uclouvain.be
 Julian Ramajo=ramajo@unex.es
 Esmeralda A. Ramalho=ela@uevora.pt
 Joaquim J. S. Ramalho=jsr@uevora.pt
 Abhijit Ramalingam=a.ramalingam@uea.ac.uk
 Ananth Ramanarayanan=ananth.ramanarayanan@gmail.com
 Shyama V. Ramani=shyama_ramani@yahoo.com
 Ruth Rama=ruth.rama@cchs.csic.es
 Bala Ramasamy=bramasamy@ceibs.edu
 Bharat Ramaswami=bharat@isid.ac.in
 K V. Ramaswamy=swamy@igidr.ac.in
 Arief Ramayandi=arief.ramayandi@fe.unpad.ac.id
 Dooruj Rambaccussing=dooruj.rambaccussing@gmail.com
 Alicia N. Rambaldi=a.rambaldi@uq.edu.au
 Salvador Cruz Rambaud, Sr.=scruz@ual.es
 Tina Rambonilaza=tina.rambonilaza@irstea.fr
 Rodney Ramcharan=rodney.ramcharan@frb.gov
 Valerie Ann Ramey=vramey@ucsd.edu
 Andres Ramirez=aramirez@bryant.edu
 Carlos Ramirez=cramire2@gmu.edu
 Francisco A. Ramirez=f.ramirez@bancentral.gov.do
 Mauricio Andrés Ramírez Gómez=maramire@eafit.edu.co
 Mauricio Ramírez Grajeda=maurmez@yahoo.com.mx
 Andrés Ramírez Hassan=aramir21@eafit.edu.co
 Manuel Ramirez=maramire@urosario.edu.co
 Maria Teresa Ramirez=mramirgi@banrep.gov.co
 Melitón Ramirez Mattos=melix@mail.com
 Miguel D. Ramirez=miguel.ramirez@trincoll.edu
 Nelson Ramirez Rondan=nramron@gmail.com
 Martin Ramirez-Urquidy=martinramirezurquidy@gmail.com
 Arturo Ramirez Verdugo=aramirez@protego.com.mx
 Ramon Mahia=ramon.mahia@uam.es
 Ramon Ramon-Muñoz=ramon@ub.edu
 Adrián Ramos=adrianhramos@gmail.com
 Célia M. Q. Ramos=cmramos@ualg.pt
 Francisco Ramos=ramosfs@gmail.com
 George Ramos=gramos@ipcb.pt
 José Ramos=jose.ramos@ivie.es
 Luis Moura Ramos=lmramos@fe.uc.pt
 Maria Priscila Ramos=maramos@uade.edu.ar
 Jesus Ramos-Martin=jesus.ramos@uab.es
 Fernando Ramos Palencia=fernando.ramos.palencia@gmail.com
 Pedro Ramos=pnramos@fe.uc.pt
 Raul Ramos=rramos@ub.edu
 Francisco Javier Ramos-Real=frramos@ull.es
 Julio Ramos-Tallada=julio.ramos@wanadoo.fr
 Xavi Ramos=xavi.ramos@uab.cat
 Adriano A. Rampini=rampini@duke.edu
 Tina Rampino=trampi@essex.ac.uk
 Lall Ramrattan=lallram@netscape.net
 Elaine Ramsey=e.ramsey@ulster.ac.uk
 John Mark Ramseyer=ramseyer@law.harvard.edu
 Arslan Tariq Rana=arslan.tariq@gmail.com
 Angelo Ranaldo=angelo.ranaldo@unisg.ch
 Francesco Ranalli, Sr.=ranalli@uniroma2.it
 Michela Rancan=michela.rancan@eui.eu
 Romain Rancière=romainranciere@gmail.com
 John Randal=john.randal@vuw.ac.nz
 Filippo Randelli=filippo.randelli@unifi.it
 John Rand=jra@foi.dk
 Susan Randolph=susan.randolph@uconn.edu
 Emanuela Randon=emanuela.randon@unibo.it
 Eva Ranehill=eva.ranehill@econ.uzh.ch
 Logan Rangasamy=logan.rangasamy@resbank.co.za
 Antonio Rangel=rangel@hss.caltech.edu
 Jose Gonzalo Rangel=jgrangell@gmail.com
 Leonardo Alves Rangel=leonardo.rangel@ipea.gov.br
 Dwijen Rangnekar=d.rangnekar@warwick.ac.uk
 Sharad Ranjan=sharadrtyagi@gmail.com
 Omid Ranjbar=o_rangbar@yahoo.com
 Wimal Rankaduwa=wrankaduwa@upei.ca
 Neil Rankin=nr524@york.ac.uk
 Neil Andrew Rankin=neil.rankin.za@gmail.com
 Ansgar Rannenberg=ansgar-rannenberg@boeckler.de
 Michael R Ransom=ransom@byu.edu
 Ananth Rao=arao@ud.ac.ae
 B. Bhaskara Rao=raob123@bigpond.com
 Govinda Marapalli Rao=mgovinda.rao@nipfp.org.in
 R Kavita Rao=kavita.rao@nipfp.org.in
 Ivana Raonic=i.raonic@city.ac.uk
 P. Madhava Rao=pmrao_42@rediffmail.com
 Ramesh P. Rao=ramesh.rao@okstate.edu
 Rekha Rao=rr262@bath.ac.uk
 Surekha Rao=skrao@iun.edu
 Ciro Rapacciuolo=c.rapacciuolo@confindustria.it
 Chiara Rapallini=chiara.rapallini@unifi.it
 Vassilis T. Rapanos,=vrapanos@econ.uoa.gr
 Martin Rapetti=m.g.rapetti@gmail.com
 Marcia Siqueira Rapini=msrapini@cedeplar.ufmg.br
 Ingo Rapold=rapold@daad-alumni.de
 Clara C. Raposo=clararaposo@iseg.utl.pt
 Mário Lino Barata Raposo=mraposo@ubi.pt
 Pedro Raposo=pedro.raposo@clsbe.lisboa.ucp.pt
 Jordan Rappaport=jordan.rappaport@kc.frb.org
 Hermann Rappen=rappen@rwi-essen.de
 Richard Tilden Rapp=richard.rapp@nera.com
 Thomas Rapp=thomas.rapp@parisdescartes.fr
 Manuel Rapun Garate=mrapun@unavarra.es
 Leroi Raputsoane=leroi.raputsoane@resbank.co.za
 Daniel A. Rascher=rascher@usfca.edu
 Robert H. Rasche=rasche@msu.edu
 Paul Anton Raschky=paul.raschky@monash.edu
 Simona Rasciute=s.rasciute@lboro.ac.uk
 Farooq Rasheed=farooqeco@yahoo.com
 Dr. Abdul Rashid=drabdulrashid@ymail.com
 Saman Rashid=saman.rashid@fhi.se
 Shahidur Rashid=s.rashid@cgiar.org
 Rajah Rasiah=rajah@um.edu.my
 Kolleen Joanne Rask=krask@holycross.edu
 Eric Rasmusen=erasmuse@indiana.edu
 Ole Dahl Rasmussen=odrasmussen@gmail.com
 Tobias Rasmussen=tnrasmussen@yahoo.com
 Siddhartha Kumar Rastogi=srastogi@iimahd.ernet.in
 Jean-Louis Rastoin=rastoin@supagro.inra.fr
 Imran Rasul=i.rasul@ucl.ac.uk
 Sungsup Ra=sungsupra@adb.org
 Nikita Ratanov=nratanov@urosario.edu.co
 Anita Ratcliffe=a.ratcliffe@sheffield.ac.uk
 Artatrana Ratha=aratha@stcloudstate.edu
 Dilip Ratha=dratha@worldbank.org
 Francis Xavier Rathinam=rfrancisxavier@gmail.com
 Tim Rathjen=rathjen@leuphana.de
 Alexander Rathke=alexander.rathke@econ.uzh.ch
 Sebastian Rathner=sebastian.rathner@sbg.ac.at
 Nazmun Nahar Ratna=nazmun.ratna@lincoln.ac.nz
 Jonathan Ratner=jonratner@westat.com
 Lev Ratnovski=ratnovski@gmail.com
 Remigio Ratti=remigio.ratti@usi.ch
 Marco Ratto=marco.ratto@jrc.ec.europa.eu
 Marisa Ratto=maria_luisa.ratto@dauphine.fr
 Ferdinand Rauch=ferdinand.rauch@economics.ox.ac.uk
 James E. Rauch=jrauch@ucsd.edu
 Michael T. Rauh=mtrauh@indiana.edu
 Holger Andreas Rau=holger.rau@fau.de
 Arnaud RAULT=arnaud.rault@oniris-nantes.fr
 Christophe Rault=chrault@hotmail.com
 Peter Raupach=peter.raupach@bundesbank.de
 Raghavendra Rau=r.rau@jbs.cam.ac.uk
 Xavier Raurich=xavier.raurich@ub.edu
 Michael Rauscher=michael.rauscher@uni-rostock.de
 Pau Rausell=pau.rausell@uv.es
 Lakshmi Raut=lakshmiraut@yahoo.com
 Tomás Rau=trau@uc.cl
 Nicolas Rautureau=nicolas.rautureau@univ-nantes.fr
 Charles Raux=charles.raux@let.ish-lyon.cnrs.fr
 Majah-Leah V. Ravago=mvravago@econ.upd.edu.ph
 Martin Ravallion=mr1185@georgetown.edu
 Francesco Ravazzolo=francesco.ravazzolo@norges-bank.no
 Federico Ravenna=federico.ravenna@hec.ca
 Bastian Ravesteijn=ravesteijn@ese.eur.nl
 Tilmann Rave=rave@ifo.de
 Adrián Osvaldo Ravier=adrianravier@yahoo.com.ar
 Navaratnam Ravinthirakumaran=navaravi@econ.cmb.ac.lk
 Shamika Ravi=shamika_ravi@isb.edu
 Geetha Ravishankar=geetha.ravishankar@ntu.ac.uk
 Alon Raviv=araviv@brandeis.edu
 Yaron Raviv=yraviv@cmc.edu
 Jacques-Laurent Ravix=jacques.ravix@gredeg.cnrs.fr
 Morten Ravn=m.ravn@ucl.ac.uk
 Vikas Rawal=vikasrawal@gmail.com
 Samantha B. Rawlings=s.b.rawlings@reading.ac.uk
 Achintya Ray=achintya.ray@gmail.com
 Trishita Ray Barman=trbarman@gmail.com
 Alain Michel Raybaut=raybaut@gredeg.cnrs.fr
 Ajitava Raychaudhuri=ajitava1@gmail.com
 Amrita Ray Chaudhuri=a.raychaudhuri@uwinnipeg.ca
 Debraj Ray=debraj.ray@nyu.edu
 Grégory Rayée=grayee@ulb.ac.be
 Indrajit Ray=i.ray@bham.ac.uk
 Jacques Raynauld=jacques.raynauld@hec.ca
 Subhash Ray=subhash.ray@uconn.edu
 Tapas K. Ray=cvt1@cdc.gov
 Bruce Rayton=b.rayton@bath.ac.uk
 Tridip Ray=tridip@isid.ac.in
 Syed Ali Raza=syed_aliraza@hotmail.com
 Wameq A. Raza=wameq.r@gmail.com
 Brahim Razgallah=brahim.x.razgallah@jpmorgan.com
 Assaf Razin=ar256@cornell.edu
 Mohammad A. Razzaque=razzaque_duecon@yahoo.com
 J James Reade=j.j.reade@reading.ac.uk
 Mark A. Reader=mar58@cam.ac.uk
 Robert Read=r.read@lancaster.ac.uk
 Mark J. Ready=mjready@wisc.edu
 Juan C. Real=jcreafer@upo.es
 Angelo Reati=angelo.reati@skynet.be
 Randall Reback=rr2165@columbia.edu
 Vincenzo Rebba=vincenzo.rebba@unipd.it
 Ken Rebeck=kcrebeck@stcloudstate.edu
 Luca Rebeggiani=rebeggiani@sopo.uni-hannover.de
 Nooman Rebei=nrebei@imf.org
 Robert Rebelein=rebelein@vassar.edu
 Carlos Andres Rebellon=rebeloni@hotmail.com
 Sergio Rebelo=s-rebelo@kellogg.northwestern.edu
 Vincent Rebeyrol=vincent.rebeyrol@tse-fr.eu
 Marcus Rebick=mark.rebick@nissan.ox.ac.uk
 Therese Rebiere=therese.rebiere@cnam.fr
 Cyril Rebillard=cyril.rebillard@banque-france.fr
 James B. Rebitzer=rebitzer@bu.edu
 Yolanda Rebollo Sanz=yfrebsan@upo.es
 Alessandro Rebucci=arebucci@jhu.edu
 Juan Recce=j.recce@caei.com.ar
 Alfred Reckendrees=are.mpp@cbs.dk
 Richard James Lowden Record=richardrecord@hotmail.com
 Laura Recuero Virto=laura.recuero-virto@diplomatie.gouv.fr
 Anugu Amarender Reddy=anugu.amarender.reddy@gmail.com
 Giulia Redigolo=gredigolo@unive.it
 Angela Redish=angela.redish@ubc.ca
 Gerry Redmond=gerry.redmond@flinders.edu.au
 Michela Redoano=michela.redoano@warwick.ac.uk
 Agustin Redonda=agustin.redonda@usi.ch
 Dominique Redor=redor@univ-mlv.fr
 Debra Dennis Reed=debra.reed@canterbury.ac.nz
 Lee Reed=reedl@uga.edu
 Luke Reedman=luke.reedman@csiro.au
 Robert R. Reed=rreed@cba.ua.edu
 W. Robert Reed=bobreednz@yahoo.com
 Daniel I. Rees=daniel.rees@ucdenver.edu
 Andrew F. Reeson=andrew.reeson@csiro.au
 Eoin Reeves=eoin.reeves@ul.ie
 Catherine Refait-Alexandre=catherine.refait-alexandre@univ-fcomte.fr
 Salim Refas=srefas@isdb.org
 Filippo Reganati=filippo.reganati@uniroma1.it
 André Regateiro=andreregateiro@ist.utl.pt
 Mark Regets=mregets@nsf.gov
 Carlo Reggiani=carlo.reggiani@manchester.ac.uk
 Iliana Reggio=ireggio@eco.uc3m.es
 Pierre Regibeau=pregibeau@crai.com
 Luca Regis=luca.regis@unito.it
 Charles Alan Register=charles.register@fau.edu
 Gábor Regős=regabor@freemail.hu
 Atiq-ur-Rehman=ateeqmzd@yahoo.com
 Günther Rehme=rehme@vwl.tu-darmstadt.de
 Arno Reichenvater=arno.reichenvater@gmail.com
 Felix Reichling=felixr@gmail.com
 Lucrezia Reichlin=lreichlin@london.edu
 Toke Reichstein=tr.ino@cbs.dk
 Claudia Rei=claudia.rei@vanderbilt.edu
 Gavin Reid=gcr@st-andrews.ac.uk
 Nicolas Reig Lorenzi=nicolas@decon.edu.uy
 Ernest Reig-Martínez=ernest.reig@uv.es
 Ard Den Reijer=ard.den.reijer@riksbank.se
 Hans Reijnierse=j.h.reijnierse@uvt.nl
 David Reiley=david@davidreiley.com
 Julia Reilich=reilich@uni-potsdam.de
 Barry Reilly=b.m.reilly@sussex.ac.uk
 Kevin Reilly=ktr@lubs.leeds.ac.uk
 Siobhan Reilly=sreilly@mills.edu
 Jeffrey J. Reimer=jeff.reimer@oregonstate.edu
 Matthew N Reimer=mreimer2@alaska.edu
 Malte Reimers=mreimer@uni-goettingen.de
 Christian Reiner=christian.reiner@ihs.ac.at
 David Michael Reiner=dmr40@cam.ac.uk
 Kenneth Reinert=kreinert@gmu.edu
 Jennifer Reinganum=jennifer.f.reinganum@vanderbilt.edu
 Dennis Reinhardt=dennis.reinhardt@bankofengland.co.uk
 Eric Reinhardt=erein@emory.edu
 Frank Reinhardt=reinhafs@gov.ns.ca
 Carmen Reinhart=carmen_reinhart@harvard.edu
 Vincent Raymond Reinhart=vincent.reinhart@morganstanley.com
 Steffen Reinhold=reinhold@e-ca.com
 Ritva Reinikka=reinikka.ritva@gmail.com
 Anne Reino=anne.reino@ut.ee
 Andreas Reinstaller=andreas.reinstaller@wifo.ac.at
 David A. Reinstein=drein@essex.ac.uk
 Ulf-Dietrich Reips=reips@ikerbasque.org
 Ana Balcão Reis=abr@fe.unl.pt
 Catarina Reis=creis@ucp.pt
 Markus Reischmann=reischmann@ifo.de
 Helmut Reisen=hr@shiftingwealth.com
 Haim Reisman=reisman@ie.technion.ac.il
 Nuno Rosa Reis=nuno.m.reis@ipleiria.pt
 Daniel Gersten Reiss=daniel.gersten@bcb.gov.br
 Markus Reiss=mreiss@math.hu-berlin.de
 Michael Reiter=michael.reiter@ihs.ac.at
 Stanley Reiter=s-reiter@kellogg.northwestern.edu
 Gerhard Reitschuler=gerhard.reitschuler@uibk.ac.at
 Stefan Reitz, Jr.=stefan.reitz@ifw-kiel.de
 Frank Reize=frank.reize@kfw.de
 Bruno Remillard=bruno.remillard@hec.ca
 Dr. Ravinder Rena=ravinder_rena@rediffmail.com
 Vincent Renard=vincent.renard@iddri.org
 Simon Renaud=sim.renaud@googlemail.com
 Thomas RENAUD=thomas.renaud.conseil@gmail.com
 Jérôme Renault=jerome.renault@tse-fr.eu
 Régis Renault=regis.renault@u-cergy.fr
 Pontus Rendahl=pontus.rendahl@gmail.com
 Silvio Rendon=srendon@ms.cc.sunysb.edu
 Luc Renneboog=luc.renneboog@uvt.nl
 Marie Renner=marie.renner@chaireeconomieduclimat.org
 Swetlana Renner=renner@iamo.de
 Klaus Rennings=rennings@zew.de
 Philip J. Reny=preny@uchicago.edu
 Yu Ren=reny@xmu.edu.cn
 Steven Renzetti=srenzetti@brocku.ca
 Stefano Renzi=stefano.renzi@unibocconi.it
 Luca Repetto=repetto@cemfi.es
 Terance Rephann=trephann@virginia.edu
 Alexandre Repkine=repkine@konkuk.ac.kr
 Reppa Zoltán=reppa.zoltan@exim.hu
 Rafael Repullo=repullo@cemfi.es
 Till Requate=requate@economics.uni-kiel.de
 Francisco Requena Silvente=f.requena@sheffield.ac.uk
 Vincent Réquillart=vincent.requillart@toulouse.inra.fr
 Patrick Rérat=patrick.rerat@unine.ch
 Moisés de Andrade Resende Filho=marf0013@gmail.com
 Guilherme Mendes Resende=guilherme.resende@ipea.gov.br
 Marcelo Resende=mresende@ie.ufrj.br
 Ariell Reshef=ariellr@virginia.edu
 Pramesti Resiandini=resiandini@gmail.com
 Budy P. Resosudarmo=budy.resosudarmo@anu.edu.au
 Marialuisa Restaino=mlrestaino@unisa.it
 Marina Resta=mresta@unige.it
 Romain Restout=romain.restout@univ-lorraine.fr
 Jorge A. Restrepo=jarestrepo@javeriana.edu.co
 Jose Manuel Restrepo=jrestrep@gmail.com
 Pascual Restrepo=pascual@mit.edu
 Sergio Restrepo=srestran@banrep.gov.co
 Diego A. Restrepo-Tobon=drestr16@eafit.edu.co
 Diego Restuccia=diego.restuccia@utoronto.ca
 Pranvera Jahollari Resulaj=pranveraresulaj@yahoo.com
 Ernesto Reuben=ereuben@columbia.edu
 Sergio Reuben Soto=reuben@ice.co.cr
 Adriana Reveiu=reveiua@ase.ro
 Alejandro Reveiz=alereveiz@hotmail.com
 Federico Revelli=federico.revelli@unito.it
 Javier Revilla-Diez=diez@wigeo.uni-hannover.de
 Ernesto Revilla=ernesto_revilla@hacienda.gob.mx
 Pablo Revilla=revilla@upo.es
 Daniel Revollo=drevollofer@gmail.com
 Cesar Luis Revoredo Giha=cesar.revoredo@sruc.ac.uk
 Julio Revuelta=julio.revuelta@unican.es
 Sascha Rexhäuser=rexhaeuser@zew.de
 Pedro Rey-Biel=pedro.rey@uab.es
 Alvaro Reyes=alvaro.reyes.duarte@gmail.com
 Byron Reyes=reyespad@msu.edu
 Javier A. Reyes=jreyes@walton.uark.edu
 José-Daniel Reyes=jdr49@georgetown.edu
 Luis Carlos Reyes=luiscarlosreyes@gmail.com
 Marcelo Reyes=mreyes@unizar.es
 Nidia Ruth Reyes=nresalomon@gmail.com
 Angel Mauricio Reyes Terrón, Sr.=angel.reyesterron@yahoo.com.mx
 Helene Rey=hrey@london.edu
 Mathias Reynaert=mathias.reynaert@econ.kuleuven.be
 Jo Reynaerts=jo.reynaerts@econ.kuleuven.be
 Nathalie REY=nathalie.rey@univ-paris13.fr
 Arnaud Reynaud=areynaud@toulouse.inra.fr
 Reynaud=benedicte.reynaud@ens.fr
 Julien Reynaud=jreynaud@imf.org
 Frédéric Reynès=frederic.reynes@tno.nl
 Curtis Lockwood Reynolds=creynol9@kent.edu
 John Randol Reynolds=john.reynolds@fsu.edu
 Kara Marie Reynolds=reynolds@american.edu
 Patrick Rey=patrick.rey@tse-fr.eu
 Serge Rey=serge.rey@univ-pau.fr
 Sergio Rey=sergio.rey@asu.edu
 luiz paulo fontes rezende, Sr.=luizpfrezende@yahoo.com.br
 András Rezessy=andras.rezessy@gmail.com
 Ioanna Reziti=ireziti@kepe.gr
 Anthony N. Rezitis=arezitis@upatras.gr
 Jiri Reznik=j.reznik@volny.cz
 Houda Rharrabti=houda.rharrabti@gmail.com
 Sangkyu Rhee=skrhee@cau.ac.kr
 Christoph M. Rheinberger=c.rheinberger@gmx.net
 Klaus Rheinberger=klaus.rheinberger@fhv.at
 Leonardo Rhenals=lrhenals@dnp.gov.co
 Thomas Rhoads=trhoads@towson.edu
 Andrew Rhodes=andrew.rhodes@tse-fr.eu
 James Richard Rhodes=rhodes@grips.ac.jp
 Matthew Rhodes-Kropf=mrhodeskropf@hbs.edu
 Sybil D. Rhodes=srhodes@cema.edu.ar
 Valerie Dawn Rhoe=vdrhoe01@gmail.com
 Peter A. Riach=peterriach@aol.com
 Alex Rialp=alex.rialp@uab.es
 Juan Felipe Riaño Rodríguez=jf.riano48@uniandes.edu.co
 Alvaro J. Riascos Villegas=ariascos@uniandes.edu.co
 Kashif Riaz=riaz@kasbit.edu.pk
 Elina Ribakova=eribakova@gmail.com
 David Ribar=dcribar@uncg.edu
 Alfonso Ribas=alfonso.ribas.alvarez@xunta.es
 Rafael Perez Ribas=rpribas.rs@gmail.com
 Joan Ribas-Tur=joan.ribas@esci.upf.edu
 Marc Owen Ribaudo=mribaudo@ers.usda.gov
 Antonio Ribba=antonio.ribba@unimore.it
 Eduardo Pontual Ribeiro=eribeiro@ie.ufrj.br
 Filipe Araújo Ribeiro=filipelipos@gmail.com
 Vamerson Schwingel Ribeiro=vamersonsr@yahoo.com.br
 Vitor Miguel Ribeiro=vmsrib@hotmail.com
 Alessandro Riboni=alessandro.riboni@polytechnique.edu
 Roland Ricart=roland.ricart@banque-france.fr
 Massimo Riccaboni=massimo.riccaboni@imtlucca.it
 Luca Riccetti=luca.riccetti@uniroma1.it
 Giorgio Ricchiuti=giorgio.ricchiuti@unifi.it
 Andrea Ricci=andrea.ricci@uniurb.it
 Francesco Ricci=francesco.ricci@univ-montp3.fr
 Lorenzo Ricci=lorenzo.ricci@ulb.ac.be
 Luca Antonio Ricci=lricci@imf.org
 Roberto Ricciuti=roberto.ricciuti@univr.it
 Giovanni Ricco=gricco@london.edu
 Lorien Rice=lrice@mills.edu
 Chrystelle RICHARD=richard@essec.fr
 Anthony Richards=richardsa@rba.gov.au
 Daniel J. Richards=dan.richards@tufts.edu
 Donald G. Richards=donald.richards@indstate.edu
 Gary Richardson=garyr@uci.edu
 James W. Richardson=jwrichardson@tamu.edu
 Jeff Ralph Richardson=jeffrey.richardson@monash.edu
 Martin Richardson=martin.richardson@anu.edu.au
 Peter Richardson=pete.w.richardson@gmail.com
 Daniel P. Rich=dprich@ilstu.edu
 Lionel Richefort=lionel.richefort@univ-nantes.fr
 Jeremiah Richey=jarichey80@gmail.com
 Matteo G. Richiardi=matteo.richiardi@unito.it
 Christine Richmond=crichmond@imf.org
 Robert Rich=robert.rich@ny.frb.org
 Alexander William Richter=arichter@auburn.edu
 André Richter=andre.richter@sofi.su.se
 Andries Richter=a.p.richter@bio.uio.no
 Christian R. Richter=christian.richter@beds.ac.uk
 Felix J. Richter=felix.richter@wiso.uni-hamburg.de
 Jan Richter=jan.richter@uni-muenster.de
 Knut Richter=richter@europa-uni.de
 Marcel K. Richter=willi044@hotmail.com
 Michael Richter=michael.richter@yu.edu
 Philipp M. Richter=prichter@diw.de
 Susan Margaret Richter=s.richter@cgiar.org
 Thomas Richter=richter@giga-hamburg.de
 Wolfram F. Richter=wolfram.richter@tu-dortmund.de
 Wilfried Rickels=wilfried.rickels@ifw-kiel.de
 Kyrre Rickertsen=kyrre.rickertsen@nmbu.no
 Johanna Karin Rickne=johanna.rickne@ifn.se
 Fernanda Ricotta=fernanda.ricotta@unical.it
 Massimo Ricottilli=massimo.ricottilli@unibo.it
 W. Craig Riddell=craig.riddell@ubc.ca
 Mary Riddel=mriddel@unlv.nevada.edu
 Ad Ridder=ad.ridder@vu.nl
 Geert Ridder=ridder@usc.edu
 Mark Rider=mrider@gsu.edu
 Thomas Rieck=rieck@uni-bonn.de
 Frank Riedel=friedel@uni-bielefeld.de
 James Riedel=jriedel@jhu.edu
 Nadine Riedel=nadine.riedel@rub.de
 Aleksandra Riedl=aleksandra.riedl@oenb.at
 Jesper Riedler=riedler@zew.de
 Maximilian Riedl=maximilian.riedl@wiwi.uni-goettingen.de
 Stefan Ried=stefanried@yahoo.de
 Bernd Riefler=bernd.riefler@gmail.com
 Arnaud Riegert=arnaud.riegert@ens.fr
 Stefano Riela=stefano.riela@gmail.com
 Cinzia Rienzo=c.rienzo@niesr.ac.uk
 Daniel Riera-Crichton=drieracr@bates.edu
 Martin Riese=martin.riese@jku.at
 John Ries=john.ries@sauder.ubc.ca
 Malte H. Rieth=mrieth@diw.de
 Katja Rietzler=katja-rietzler@boeckler.de
 Jan Riezebos=j.riezebos@rug.nl
 Amzul Rifin=amzul_rifin@yahoo.com
 Ricard Rigall-I-Torrent=ricard.rigall@udg.edu
 John Rigby=a.j.rigby@gmail.com
 Mary Rigdon=mrigdon@rci.rutgers.edu
 Marianna Riggi=marianna.riggi@bancaditalia.it
 Roberto Rigobon=rigobon@mit.edu
 Massimiliano Rigon=massimiliano.rigon@bancaditalia.it
 Luca Rigotti=luca@pitt.edu
 Christian Riis=christian.riis@bi.no
 Rainer Michael Rilke=rainer.rilke@uni-koeln.de
 Dagfinn Rime=dagfinn.rime@gmail.com
 Gustavo L. Rinaldi=gustavo.rinaldi@unito.it
 Rullan Rinaldi=rullan.rinaldi@fe.unpad.ac.id
 Johannes Rincke=johannes.rincke@wiso.uni-erlangen.de
 Hernan Rincon=hrincoca@banrep.gov.co
 Juan Pablo Rincón-Zapatero=jrincon@eco.uc3m.es
 Barbara Rindi=barbara.rindi@unibocconi.it
 Marcel Rindisbacher=rindisbm@bu.edu
 Fabio Rindone=frindone@unict.it
 Claudia Ringler=c.ringler@cgiar.org
 Ulf Rinne=rinne@iza.org
 Felix Rioja=prcfkr@langate.gsu.edu
 Fernando Rios-Avila=friosavila1@student.gsu.edu
 Francisco Javier Montoro Ríos, Sr.=fmontoro@ugr.es
 José-Víctor Ríos-Rull=vr0j@umn.edu
 Vanessa Rios-Salas=riossalas@wisc.edu
 Stéphane Riou=stephane.riou@univ-st-etienne.fr
 Laura A. Ripani=laurari@iadb.org
 Antti Ripatti=antti@ripatti.net
 Regina Therese Riphahn=regina.riphahn@wiso.uni-erlangen.de
 Jordi Ripollés=jripolle@eco.uji.es
 Marla Ripoll=ripoll@pitt.edu
 Aina M. Ripoll Penalva=aripollp@cre.sanostra.es
 Ronald D. Ripple=ripron@gmail.com
 Victor Gabriel Riquelme=vriquelme@bcentral.cl
 Alf Erling Risa=alf.risa@econ.uib.no
 Catherine Ris=catherine.ris@univ-nc.nc
 Mario Risso=mario.risso@uniroma2.it
 Annukka Ristiniemi=annukka.ristiniemi@gmail.com
 Felix Ritchie=felix.ritchie@virgin.net
 Archibald R. M. Ritter=arch_ritter@carleton.ca
 Hendrik Ritter=hendrik.ritter@ovgu.de
 Jay R. Ritter=jay.ritter@cba.ufl.edu
 Moritz Ritter=moritz@temple.edu
 Andrés Rius=arius@iecon.ccee.edu.uy
 Julio Riutort=jriutort@uc.cl
 Fabrice Riva=fabrice.riva@dauphine.fr
 Maud Rivard=rivard.maud@fin.gc.ca
 Eduardo Rivas=eduardorivas07@gmail.com
 Javier Rivas=j.rivas@bath.ac.uk
 M. Fernanda Rivas=rivas@metu.edu.tr
 Dorothee Rivaud-Danset=dorotheerivaud@noos.fr
 Luis F. Rivera-Galicia=luisf.rivera@uah.es
 Jorge Hernán Rivera Posso=jhrivera@javerianacali.edu.co
 Edward Rivera Rivera=riverarivera@uol.com.br
 Eduardo Rivera Vicencio=eduardo.rivera@uab.es
 Rodrigo Rivero=rodrigoriverocn@gmail.com
 Sergio Luiz de Medeiros Rivero=sergio.rivero@uol.com.br
 David A. Rivers=drivers2@uwo.ca
 Steven G. Rivkin=sgrivkin@uic.edu
 Elena Rivo López=rivo@uvigo.es
 Thomas Rixen=thomas.rixen@uni-bamberg.de
 Adrian van Rixtel=adrian.vanrixtel@bis.org
 Yohanes Eko Riyanto=yeriyanto@ntu.edu.sg
 Sayyid Salman Rizavi=salmanrizavi@yahoo.com
 Gianina Rizescu=grizescu@yahoo.com
 Marian Rizov=m.rizov@mdx.ac.uk
 Islam Rizvanoghlu=islam.rizvanoglu@zirve.edu.tr
 Syed Aun R. Rizvi=aun@rizvis.net
 Syed Kumail Abbas Rizvi=skrizavi@yahoo.com
 MariaOlivella Rizza=maria.rizza@unict.it
 Pietro Rizza=pietro.rizza@bancaditalia.it
 Salvatore Rizzello=salvatore.rizzello@unito.it
 Lucia Rizzica=lucia.rizzica@bancaditalia.it
 Dino Rizzi=dino.rizzi@unive.it
 Leonzio Rizzo=leonzio.rizzo@unife.it
 Ugo Rizzo=ugo.rizzo@unife.it
 Hatem Rjiba=hatemrjiba@gmail.com
 Mariano Eduardo Roark=marianoroark@hotmail.com
 David Alejandro Robalino=drobalino@worldbank.org
 Juan Robalino=robalino@catie.ac.cr
 Monica Robayo=mr493@georgetown.edu
 A. Leslie Robb=robb@mcmaster.ca
 Colleen Robb Post=colleenpost@me.com
 Michel Robe=mrobe@american.edu
 Barbara M. Roberts=bbr@le.ac.uk
 Colin Jeffrey Roberts=colin.roberts@ed.ac.uk
 David C. Roberts=david.c.roberts@ndsu.edu
 Helen H. Roberts=hroberts@uic.edu
 Joanne Roberts=robertjk@ucalgary.ca
 Leigh Roberts=leigh.roberts@vuw.ac.nz
 Mark Roberts=mroberts1@worldbank.org
 Mark J. Roberts=mroberts@psu.edu
 Michael James Roberts=mjrobert@hawaii.edu
 Michael R. Roberts=mrrobert@wharton.upenn.edu
 John Campbell Robertson=john.c.robertson@atl.frb.org
 Paul L. Robertson=plr090634@hotmail.com
 Peter Eric Robertson=peter.robertson@uwa.edu.au
 Richard D. Robertson=rrobertson@cgiar.org
 Richard Roberts=rick.x.roberts@gmail.com
 Robin W. Roberts=rroberts@bus.ucf.edu
 Verónica Robert=vrobert@gmail.com
 Benoit Robidoux=robidoux.benoit@fin.gc.ca
 Anne-Sophie Robilliard=robilliard@dial.prd.fr
 Jean-Marc Robin=jmarc.robin@gmail.com
 Catherine Robinson=c.robinson-501@kent.ac.uk
 David T. Robinson=davidr@duke.edu
 Jackie Robinson=robinson@uq.edu.au
 James Alan Robinson=jrobinson@gov.harvard.edu
 Joshua J. Robinson=jjr@uab.edu
 Kenneth James Robinson=kenneth.j.robinson@dal.frb.org
 Michael Dale Robinson=mirobins@mtholyoke.edu
 Sherman Robinson=s.robinson@cgiar.org
 Tim Robinson=robinsontimf@gmail.com
 Philip Kenneth Robins=probins@miami.edu
 Julio R. Robledo=julio.robledo@rub.de
 Vasja Roblek=vasja.roblek@gmail.com
 M. Dolores Robles Fernandez=mdrobles@ccee.ucm.es
 Jack Robles=jack.robles@vuw.ac.nz
 Luis Robles=teigeiro@uma.es
 Cesare Robotti=c.robotti@imperial.ac.uk
 Alex Robson=a.robson@griffith.edu.au
 Arthur Robson=robson@sfu.ca
 Mark Robson=mark.robson@bankofengland.co.uk
 William B.P. Robson=w_robson@cdhowe.org
 John Robst=jrobst@usf.edu
 Carlos Rocabado=rocabadoc@outlook.com
 Yvon Rocaboy=yvon.rocaboy@univ-rennes1.fr
 Eduardo Dacillo Roca=e.roca@griffith.edu.au
 Jordi Roca=jordiroca@ub.edu
 Mauro Roca=mauro.roca@caa.columbia.edu
 Benedetto Rocchi=benedetto.rocchi@unifi.it
 Lorenzo Rocco=lorenzo.rocco@unipd.it
 Silvia Rocha-Akis=silvia.rocha-akis@wifo.ac.at
 Bruno Rocha=brunor@cedeplar.ufmg.br
 Miguel Rocha de Sousa=miguelrochasousa@gmail.com
 Héctor Osvaldo Rocha=hrocha@iae.edu.ar
 Marcos Rocha=marcosrocha@gvmail.br
 Maurice John Roche=mroche@economics.ryerson.ca
 Guillaume Rocheteau=grochete@uci.edu
 Jean Charles Rochet=jean-charles.rochet@bf.uzh.ch
 Michael Rochlitz=michael.rochlitz@gmail.com
 Louis-Philippe Rochon=lprochon@laurentian.ca
 Duane Rockerbie=rockerbie@uleth.ca
 James Rockey=james.rockey@le.ac.uk
 Michael Rockinger=michael.rockinger@unil.ch
 Marc Rockmore=mrockmore@clarku.edu
 Hugh Rockoff=rockoff@econ.rutgers.edu
 Jean-Marc Roda=roda@cirad.fr
 Giorgio Rodano=giorgio.rodano@uniroma1.it
 Mario Rodarte, Sr.=mrodarte@cedeplar.ufmg.br
 Johannes Rode=rode@vwl.tu-darmstadt.de
 Carmen Ródenas=crodenas@ua.es
 Peter Rodenburg=p.rodenburg@uva.nl
 Ralf Rodepeter=ralf.rodepeter@bmw.de
 Cortney Stephen Rodet=cortneyrodet@gmail.com
 Dennis Rodgers=dennis.rodgers@glasgow.ac.uk
 Joan Rosalie Rodgers=joan_rodgers@uow.edu.au
 Oscar Rodil-Marzábal=oscar.rodil@usc.es
 Liliya Anatolievna Rodionova=lrodionova@hse.ru
 G. Chris Rodrigo=gcr2006@ieee.org
 Luis Miguel Rodrigo=lrodrigo@ucn.cl
 Joel Rodrigue=joel.b.rodrigue@vanderbilt.edu
 Ana Rodrigues=arodrigues@concorrencia.pt
 Anthony P. Rodrigues=tony.rodrigues@ny.frb.org
 Carlos Farinha Rodrigues=carlosfr@iseg.utl.pt
 Luis Fernandes Rodrigues=luisfr@estv.ipv.pt
 Mauro Rodrigues=mrodrigues@usp.br
 Miguel Palhoto Rodrigues=palhoto.rodrigues@gmail.com
 Paulo Rodrigues=pmrodrigues@bportugal.pt
 Pedro G. Rodrigues=pgr.economist@gmail.com
 Ricardo Gouveia Rodrigues=rgrodrigues@ubi.pt
 A. E. Rodriguez=arodriguez@newhaven.edu
 Carmelo Rodriguez-Alvarez=carmelor@ccee.ucm.es
 Alvaro Rodriguez=alvaror@andromeda.rutgers.edu
 Alejandro Rodríguez Arana=alejandro.rodriguez@uia.mx
 Carlos Vladimir Rodríguez Caballero=vrodriguez@creates.au.dk
 Carlos Alfredo Rodríguez=cr@cema.edu.ar
 Carlos Antonio Rodriguez=invecpr@yahoo.com
 Catherine Rodriguez=cathrodr@uniandes.edu.co
 Andres Rodriguez-Clare=andres1000@gmail.com
 Juan Carlos Rodríguez Cohard=jccohard@ujaen.es
 Jose Daniel Rodriguez-Delgado=jrodriguezdelgado@imf.org
 Diego Arturo Rodriguez=drodrigu@banrep.gov.co
 Diego Rodriguez Rodriguez=drodri@ccee.ucm.es
 Donita Rodríguez=donita.rodriguez@bcrp.gob.pe
 Edgard R. Rodriguez=erodriguez@idrc.ca
 Francisco Rodríguez Fernández=franrod@ugr.es
 Francisco Rodríguez=frrodriguezc@gmail.com
 Gabriel Rodríguez=gabriel.rodriguez@pucp.edu.pe
 Guillermo Rodríguez González=correo@guillermorodriguez.tk
 Hector German Rodriguez=hrodrig@uark.edu
 Joaquin Hernan Rodriguez=joaquin1982_dv@hotmail.com
 José María Rodríguez=jmr@eco.unc.edu.ar
 Jose S. Rodriguez=jrodrig@pucp.edu.pe
 Juan Carlos Rodríguez=j.c.rodriguez@uvt.nl
 Juan Gabriel Rodríguez=juangabr@pdi.ucm.es
 Paul Andrés Rodríguez Lesmes=p.lesmes.11@ucl.ac.uk
 Antonio Rodriguez-Lopez=jantonio@uci.edu
 Jesús Rodríguez-López=jrodlop@upo.es
 María Araceli Rodríguez=araceli@eco.uva.es
 Marius del Giudice Rodriguez=marius.rodriguez@sf.frb.org
 Mauricio Rodriguez=m.rodriguez@tcu.edu
 Mauricio Rodríguez=rodriguez.mauricio@ur.edu.co
 Hugo Rodriguez Mendizabal=hugo.rodriguez@iae.csic.es
 Miguel Rodriguez=miguel.r@uvigo.es
 Paula Rodríguez Modroño=prodmod@upo.es
 Sevi Rodríguez Mora=sevimora@gmail.com
 Norberto Rodríguez=nrodrini@banrep.gov.co
 Eduardo Rodriguez-Oreggia=eduardo.oreggia@gmail.com
 Pedro N. Rodriguez=email@pnrodriguez.com
 Núria Rodríguez-Planas=rodriguez-planas@iza.org
 Andrés Rodríguez-Pose=a.rodriguez-pose@lse.ac.uk
 Ramiro Rodriguez Revilla, Sr.=rrodriguezre@libertadores.edu.co
 Sandra Rodríguez=srodriguez@iecon.ccee.edu.uy
 Santiago Budria=sbudria@uma.pt
 Carlos Rodriguez-Sickert=crodrigs@puc.cl
 Isabel Rodriguez-Tejedo=isabelrt@unav.es
 Mario Rodríguez Vicente=mariorv@terra.es
 Javier E. Rodríguez Weber=jerweber@fcs.edu.uy
 Xosé Antón Rodríguez=xoseanton.rodriguez@usc.es
 Dani Rodrik=drodrik@ias.edu
 Kerstin Roeder=kerstin.roeder@lrz.uni-muenchen.de
 Thomas Roediger-Schluga=t.roediger@chello.at
 Knut Røed=knut.roed@frisch.uio.no
 Sebastian Roelands=sroela@bgsu.edu
 Keetie Roelen=k.roelen@ids.ac.uk
 Hein Roelfsema=h.j.roelfsema@econ.uu.nl
 John Roemer=john.roemer@yale.edu
 Christian Roessler=christian.roessler@csueastbay.edu
 Henk Roest=h.c.a.roest@uvt.nl
 Rafael Rofman=rrofman@worldbank.org
 Muriel Roger=muriel.roger@ens.fr
 Abbie Rogers=abbie.rogers@uwa.edu.au
 Carol Ann Rogers=rogersc@georgetown.edu
 John H. Rogers=john.h.rogers@frb.gov
 Richard Rogerson=rdr@princeton.edu
 Patricia Judith Rogers=patricia.rogers@rmit.edu.au
 William H. Rogers=rogerswil@umsl.edu
 Tristan Roger=tristan.roger@eurofidai.org
 Kenneth S Rogoff=krogoff@harvard.edu
 Nicholas C. Rohde=n.rohde@griffith.edu.au
 Cathy A. Roheim=croheim@uidaho.edu
 Moritz Rohling=rohlingm@ethz.ch
 Shawn Mark Rohlin=srohlin@kent.edu
 Ibrahim kholilul rohman=ibrahim.rohman@gmail.com
 Dominic Rohner=dominic.rohner@unil.ch
 Oliver Röhn=oliver.roehn@oecd.org
 Rene Rohrbeck=rene@rene-rohrbeck.de
 Sigrid Röhrs=sigrid.roehrs@hof.uni-frankfurt.de
 Anja Rohwer=rohwer@ifo.de
 Andreas Roider=andreas@roider.de
 Jesper Roine=nejr@hhs.se
 Pilar Ximena Rojas Gaviria=projas@ulb.ac.be
 Juan A. Rojas=juan.rojas@bde.es
 Luis Eduardo Rojas Dueñas=luis.rojas@eui.eu
 Mariano Rojas=mariano.rojas.h@gmail.com
 Julio Rojas-Mora=jcredberry@gmail.com
 Felipe Bernardo Rojas Pizarro=ferojas@ucm.es
 Hugo Rojas-Romagosa=h.rojas-romagosa@cpb.nl
 Liliana Rojas-Suarez=lrojas-suarez@cgdev.org
 Matija Rojec=matija.rojec@gov.si
 Roji George=rojigeo@gmail.com
 David Rojo Arjona=rojoarjo@chapman.edu
 Nikita Roketskiy=n.roketskiy@ucl.ac.uk
 Gérard Roland=groland@econ.berkeley.edu
 David Roland-Holst=dwrh@are.berkeley.edu
 Flavia Roldán=roldan@ort.edu.uy
 Heather Rolfe=h.rolfe@niesr.ac.uk
 Anne-Marie Rollin=anne-marie.rollin@statcan.gc.ca
 Neil Rollings=n.rollings@lbss.gla.ac.uk
 Kimberly S. Rollins=krollins@unr.edu
 Douglas Rolph=drolph@ntu.edu.sg
 John Romalis=john.romalis@sydney.edu.au
 Ignacio Escañuela Romana=ignacioesro@gmail.com
 Angela ROMAN=aboariu@uaic.ro
 Carolina Román=croman@iecon.ccee.edu.uy
 Candido Román Cervantes=croman@ull.edu.es
 Daniela Lidia Roman=danielaroman999@yahoo.com
 Mattia Romani=m.n.romani@lse.ac.uk
 Rustam Romaniuc=rustam.romaniuc@gmail.com
 Mihai Daniel Roman=romanm@ase.ro
 Monica Roman=monica.roman@csie.ase.ro
 Giulia Romano=g.romano@ec.unipi.it
 Livio Romano=livio.romano@eui.eu
 Oriana Romano=oromano@unior.it
 Richard Evans Romano=richard.romano@cba.ufl.edu
 João Romão=joao_romao@me.com
 Jeroen VK Rombouts=jeroen.rombouts@hec.ca
 David Romer=dromer@econ.berkeley.edu
 Alberto Romero=alromer@gmail.com
 Alfredo Alejandro Romero=aaromero@ncat.edu
 Arturo González Romero=agonzalez@cee.uned.es
 German Romero=gd.romero44@uniandes.edu.co
 Isidoro Romero=isidoro@us.es
 Javier Romero=javier.romero@udep.pe
 Desiderio Romero-Jordan=desiderio.romero@urjc.es
 Jose Vicente Romero=jose.romero@urosario.edu.co
 Julian Romero=jnromero@purdue.edu
 Mauricio Romero=mauricioromerolondono@gmail.com
 Antonio Romero Medina=aromero@eco.uc3m.es
 Andres Romeu=aromeu@um.es
 Laura Romeu Gordo=laura.romeu-gordo@dza.de
 Peter Romilly=peter@romilly.greenisp.org
 Roman Römisch=roemisch@wiiw.ac.at
 Jan Rommel=jan.rommel@soc.kuleuven.be
 Camelia ROMOCEA TURCU=camelia.turcu@univ-orleans.fr
 Leonidas Rompolis=rompolis@aueb.gr
 Lucas Ronconi=ronconilucas@gmail.com
 Francesca Rondina=frondina@uottawa.ca
 Concetta Rondinelli=concetta.rondinelli@bancaditalia.it
 Rong RONG=rongrong@weber.edu
 Zhao Rong=zhaorong@swufe.edu.cn
 David Malin Roodman=droodman@gmail.com
 Patrick Michael Rooney, Sr.=rooney@iupui.edu
 Jutta Roosen=jroosen@tum.de
 Michael Roos=michael.roos@rub.de
 Carole Ropars-Collet=carole.ropars@agrocampus-ouest.fr
 Tiziano Ropele=tiziano.ropele@bancaditalia.it
 Miguel Ángel Ropero=maropero@uma.es
 Olli Tapani Ropponen=olli.ropponen@vatt.fi
 Fabien Roques=fabien.roques@cantab.net
 Carlo Rosa=carlo.rosa@ny.frb.org
 Pedro Rosa Dias=p.rosa-dias@sussex.ac.uk
 Alfonso Rosa-García=arosa@ucam.edu
 Ramón Antonio Rosales Alvarez=rrosales@uniandes.edu.co
 Walter Rosales=walter75@yahoo.com
 Paulo Rui Beijinho Rosário=beijinhodorosario@gmail.com
 Andrés Rosas=andres.rosas@javeriana.edu.co
 Furio Camillo Rosati=frosati@ucw-project.org
 Julie Rosaz=rosaz@lameta.univ-montp1.fr
 Alicia S. Rosburg=alicia.rosburg@uni.edu
 Adam Zachary Rose=adamzros@price.usc.edu
 Andrew Rose=arose@haas.berkeley.edu
 David C. Rose=rose@umsl.edu
 Mark W. Rosegrant=m.rosegrant@cgiar.org
 Felix Rösel=roesel@ifo.de
 Ruth Rose-Lizee=rose-lizee.ruth@uqam.ca
 Juan Rosellon=juan.rosellon@cide.edu
 Adam Michael Rosen=adam.rosen@ucl.ac.uk
 Dan T. Rosenbaum=drosenbaum@omb.eop.gov
 Joshua Rosenberg=joshua.rosenberg@ny.frb.org
 David Rosenblatt=drosenblatt@worldbank.org
 Rina Rosenblatt-Wisch=rina.rosenblatt@snb.ch
 Joshua L. Rosenbloom=jrosenbloom@ku.edu
 Daniel Rosenblum=daniel.rosenblum@dal.ca
 Knut Einar Rosendahl=knut.einar.rosendahl@nmbu.no
 Daniel H. Rosen=dhrosen@mindspring.com
 Eric Rosengren=e.rosengren@comcast.net
 Harvey Rosen=hsr@princeton.edu
 Stephanie Rosenkranz=s.rosenkranz@econ.uu.nl
 Robert Edward Rosenman=yamaka@wsu.edu
 Samuel Rosen=sam.rosen23@gmail.com
 Sebastian Rosenschon=sebastian.rosenschon@iwh-halle.de
 Stacey Rosen=slrosen@ers.usda.gov
 Dale W.R. Rosenthal=daler@uic.edu
 Stuart S. Rosenthal=ssrosent@maxwell.syr.edu
 Joan R. Rosés=j.r.roses@lse.ac.uk
 Catarina Roseta-Palma=catarina.roseta@iscte.pt
 Deborah Roseveare=deborah.roseveare@oecd.org
 Yana Roshchina=yroshchina@hse.ru
 Israfil Roshdi=i.roshdi@gmail.com
 Michael Rosholm=rom@asb.dk
 Francisco Rosique=frosique@grre.net
 Matthew James Roskruge=mjroskruge@gmail.com
 Mariana Rösner=mariana.stamm@gmx.de
 Peter Rosner=peter.rosner@univie.ac.at
 Amanda Ross=amanda.ross@mail.wvu.edu
 Robert J. Rossana=r.j.rossana@wayne.edu
 Don Ross=don.ross931@gmail.com
 Koen Rossel-Cambier=koenrc@yahoo.com
 Jaume Rossello=jrossello@uib.es
 Barkley Rosser=rosserjb@jmu.edu
 Claudio Rossetti=crossetti@luiss.it
 Alessandro Rossi=arossi@cs.unitn.it
 Alessandro Rossi=alessandro.rossi@jrc.ec.europa.eu
 Andrea Rossi=andrea.rossi@gmail.com
 Barbara Rossi=barbara.rossi@upf.edu
 Eduardo Rossi=erossi@eco.unipv.it
 Enzo Rossi=enzo.rossi@snb.ch
 Federica Rossi=f.rossi@bbk.ac.uk
 Francesca Rossi=f.rossi@soton.ac.uk
 Francesco Rossi=francescorossi_@hotmail.com
 Jean-Luc Rossignol=jean-luc.rossignol@univ-fcomte.fr
 Esteban Rossi-Hansberg=erossi@princeton.edu
 Ianina Rossi=ianina@decon.edu.uy
 Lorenza Rossi=lorenza.rossi@eco.unipv.it
 Mariacristina Rossi=mariacristina.rossi@unito.it
 Maximo Rossi=maximo.rossi@gmail.com
 Renzo Rossini=renzo.rossini@bcrp.gob.pe
 Peter E. Rossi=perossichi@gmail.com
 Raffaele Rossi=r.rossi@lancaster.ac.uk
 Justin M. Ross=justross@indiana.edu
 Laura Rossouw=laura.rossouw@gmail.com
 Riaan Rossouw=riaan.rossouw@nwu.ac.za
 Stephanie Rossouw=stephanie.rossouw@aut.ac.nz
 Robert Brent Ross=rross@msu.edu
 Russell Ross=russell.ross@sydney.edu.au
 Stephen Ross=stephen.l.ross@uconn.edu
 Massimo Rostagno=massimo.rostagno@ecb.int
 Miklos Rosta=miklos.rosta@uni-corvinus.hu
 Katja Rost=katja.rost@uzh.ch
 Kasper Roszbach=kasper.roszbach@riksbank.se
 Francesca Silvia Rota=francesca.rota@polito.it
 Grégoire ROTA GRAZIOSI=gregoire.rota_graziosi@udamail.fr
 Mauro Rota=mauro.rota@uniroma1.it
 Lucia Rotaris=lucia.rotaris@econ.univ.trieste.it
 Ilie Rotariu=ilie.rotariu@ulbsibiu.ro
 Marius Petre Rotaru=contact@protranslatio.com
 Julio Rotemberg=jrotemberg@hbs.edu
 Waldemar Rotfuß=waldemar.rotfuss@freudenberg.de
 Albrecht Rothacher=albrecht.rothacher@eeas.europa.eu
 Frank T. Rothaermel=frank.rothaermel@mgt.gatech.edu
 Alvin Roth=aroth@hbs.edu
 Jonathan Louis Rothbaum=jonathan.l.rothbaum@census.gov
 Duncan Roth=duncan.roth@wiwi.uni-marburg.de
 Roy J. Rotheim=rrotheim@skidmore.edu
 Jacek Rothert=jacek.rothert@gmail.com
 Thomas Rothe=thomas.rothe@iab.de
 Michael Rothgang=rothgang@rwi-essen.de
 Lukas Roth=lukas.roth@ualberta.ca
 Philip Rothman=rothmanp@ecu.edu
 Casey Rothschild=crothsch@wellesley.edu
 Michael Rothschild=mrothsch@princeton.edu
 Jesse Rothstein=rothstein@berkeley.edu
 Paul Rothstein=prothstein1@gmail.com
 Geoffrey Rothwell=geoffrey.rothwell@oecd.org
 Daniele Rotolo=d.rotolo@sussex.ac.uk
 Stephane Rottier=stephane.rottier@ecb.int
 Horst Fritz Rottmann=h.rottmann@haw-aw.de
 Lorenzo Rotunno=lorenzo.rotunno@bsg.ox.ac.uk
 Léa Rouanet=lea.rouanet@gmail.com
 Wael Rouatbi=wael.rouatbi@ipag.fr
 Nouriel Roubini=nroubini@stern.nyu.edu
 Juliette Rouchier=juliette.rouchier@univ-amu.fr
 Philippe Rouchy=philippe.rouchy@bth.se
 Eric Rougier=rougier@u-bordeaux4.fr
 Jean-François Rouillard=j-f.rouillard@usherbrooke.ca
 Sébastien Rouillon=rouillon@u-bordeaux4.fr
 Bénédicte Rouland=brouland@econ.au.dk
 James Roumasset=jimr@hawaii.edu
 Fabrice Rousseau=fabrice.rousseau@nuim.ie
 Peter Rousseau=peter.l.rousseau@vanderbilt.edu
 Sandra Rousseau=sandra.rousseau@kuleuven.be
 Peter Rousseeuw=peter@rousseeuw.net
 Guillaume Roussellet=guillaume.roussellet@gmail.com
 Sébastien Roussel=roussel@lameta.univ-montp1.fr
 Olivier ROUSSE=olivier.rousse@upmf-grenoble.fr
 Donald Joseph Rousslang=donald.j.rousslang@hawaii.gov
 Matthew C Rousu=rousu@susqu.edu
 Himanshu Sekhar Rout=hsrout1970@gmail.com
 Bryan R. Routledge=routledge@cmu.edu
 Elodie ROUVIERE=elodie.rouviere@agroparistech.fr
 Jan Rouwendal=j.rouwendal@vu.nl
 Pascale Roux=pascale.roux@u-bordeaux4.fr
 Sébastien Roux=roux@ensae.fr
 Laura Rovegno=lrovegno@gmail.com
 Riccardo Rovelli=riccardo.rovelli@unibo.it
 Andrea Roventini=andrea.roventini@univr.it
 Colin Rowat=c.rowat@bham.ac.uk
 Francisco Rowe=f.rowegonzalez@uq.edu.au
 David Rowell=d.rowell@griffith.edu.au
 Nicholas Rowe=nick_rowe@carleton.ca
 Dane Rowlands=dane_rowlands@carleton.ca
 Anne Beeson Royalty=royalty@iupui.edu
 Chandan Roy=chandanroy70@gmail.com
 Prabal Roy Chowdhury=prabalrc@isid.ac.in
 Punarjit Roychowdhury=punarjitroychowdhury@gmail.com
 Sahana Roy Chowdhury=sahana.isi@gmail.com
 Devesh Roy=d.roy@cgiar.org
 Heather North Royer=royer@econ.ucsb.edu
 Jimmy Royer=jroyer@analysisgroup.com
 Jaideep Roy=jaideeproy1234@gmail.com
 Jayjit Roy=royj@appstate.edu
 Joyashree Roy=joyashreeju@gmail.com
 Joydeep Roy=jr3137@columbia.edu
 Paul-Martel Roy=roy.paul-martel@uqam.ca
 Sanjukta Roy=sroy3@worldbank.org
 Santanu Roy=sroy@smu.edu
 Satyaki Roy=satyaki.sat@gmail.com
 Souvik Roy=souvik_roy2004@yahoo.com
 Sunanda Roy=sunanda@iastate.edu
 Suryadipta Roy=sroy@highpoint.edu
 Thierry Roy=thierryroy@gmail.com
 Udayan Roy=uroy@liu.edu
 Vicente Royuela=vroyuela@ub.edu
 Stelios Rozakis=rozakis@aua.gr
 Ronald Rozenbaum=rozenbaum@gmail.com
 Julie Rozenberg=rozenberg@centre-cired.fr
 Kareen Rozen=kareen.rozen@yale.edu
 Elena Vladimirovna Rozhentsova=erozhentsova@hse.ru
 Marek Rozkrut=marek.rozkrut@sgh.waw.pl
 Petr Rozmahel=petr.rozmahel@mendelu.cz
 Gisela Rua=gisela.rua@frb.gov
 Frances Philomena Ruane=frances.ruane@esri.ie
 Luis Rubalcaba=luis.rubalcaba@uah.es
 Enrico Rubaltelli=enrico.rubaltelli@unipd.it
 Jens Rubart=jens.rubart@bakermckenzie.com
 Michał Rubaszek=mrubas@sgh.waw.pl
 Dirk T.G. Rübbelke=dirk.ruebbelke@vwl.tu-freiberg.de
 Gloria Rubert=gloriarubert@ub.edu
 Antoni Rubí-Barceló=antoni.rubi@uib.eu
 Anna Rubinchik=annarubinchik@gmail.com
 Raúl Rubin de Celis Cedro=raul.rc.loz@gmail.com
 Goulven Rubin=goulven.rubin@univ-lille2.fr
 Lauretta Rubini=lauretta.rubini@unife.it
 Loris Rubini=loris.rubini@asu.edu
 Jared Rubin=jrubin@chapman.edu
 Ofir David Rubin=orubin@bgu.ac.il
 Paul H. Rubin=paul.rubin@gmail.com
 Raphael Rubin=raphael.rubin@gmail.com
 Александр Александрович Рубинштейн (Alexander Alexandrovich Rubinstein)=rubinstein.alexander@gmail.com
 Ariel Rubinstein=rariel@post.tau.ac.il
 Jorge Luis Rubio Donet=rubio_jl@up.edu.pe
 Fernando Rubio Fernandez=fernando.rubio@uv.cl
 Margarita Rubio=margarita.rubio@nottingham.ac.uk
 María Catalina Rubio=mcatarubio@gmail.com
 Juan Antonio Rubio-Mondéjar=jarubio@ugr.es
 Juan F Rubio-Ramirez=juan.rubio-ramirez@duke.edu
 Santiago Jose Rubio=santiago.rubio@uv.es
 Rafael Rucha=rucha@uni-lueneburg.de
 Franz Ruch=franzruch@gmail.com
 Guillermo Rudas-Lleras=grudas@javeriana.edu.co
 Denis Patrick Rudd=rudd@rmu.edu
 Murray Alan Rudd=murray.rudd@york.ac.uk
 Glenn Rudebusch=glenn.rudebusch@sf.frb.org
 Stephan Rudolph=stephan.rudolph@tu-dresden.de
 Donald C. Rudow=drudow@comcast.net
 Kim Rueben=krueben@ui.urban.org
 José Manuel Rueda-Cantuche=jmruecan@upo.es
 Marie T. Ruel=m.ruel@cgiar.org
 Salomée Ruel=salomee.ruel@gmail.com
 Stefan Ruenzi=ruenzi@bwl.uni-mannheim.de
 Sophia Ruester=sophia.ruester@eui.eu
 Bernard Ruffieux=bernard.ruffieux@grenoble-inp.fr
 Bradley Ruffle=bradley@bgu.ac.il
 Hernán M. Ruffo=hruffo@utdt.edu
 Alexandra Rufini=alexandra.rufini@gredeg.cnrs.fr
 Francisco J. Ruge-Murcia=francisco.ruge-murcia@umontreal.ca
 Alan M. Rugman=a.rugman@henley.reading.ac.uk
 Kim Ruhl=kruhl@stern.nyu.edu
 Christopher Ruhm=ruhm@virginia.edu
 Jens Ruhose=ruhose@ifo.de
 Ralf Ruhwedel=rruhwedel@aol.com
 Joakim Ruist=joakim.ruist@economics.gu.se
 Javier Ruiz-Castillo=jrc@eco.uc3m.es
 Fernando Matias Manuel Ruiz=fernando.ruiz@fucam.ac.be
 Anne Ruiz-Gazen=anne.ruiz-gazen@tse-fr.eu
 Isabel Ruiz=isabel.ruiz@economics.ox.ac.uk
 Jesus Ruiz=jruizand@ccee.ucm.es
 Juan M. Ruiz=juan.ruiz@bbva.com
 Maria Jose Ruiz-Martos=martosm@eco.uji.es
 Claudia Ruiz Ortega=cruizortega@worldbank.org
 Daniel Ruiz Pérez=kirbygo@hotmail.com
 Jaime Ruiz-Tagle=jaimert@econ.uchile.cl
 José Ramón Ruiz-Tamarit=ramon.ruiz@uv.es
 Alberto Ruiz-Villaverde=albertorv@ugr.es
 Francesco Rullani=frullani@luiss.it
 Didier Rulliere=rulliere@univ-lyon1.fr
 Jean-Louis Rullière=rulliere@gate.cnrs.fr
 Fabio Rumler=fabio.rumler@oenb.at
 Ole Jens Rummel=ole.rummel@bankofengland.co.uk
 Mikhail I. Rumyantsev=shilka1959@rambler.ru
 Mariano Runco=mrunco@aum.edu
 Bianca Rundshagen=bianca.rundshagen@fernuni-hagen.de
 Armando Rungi=armando.rungi@imtlucca.it
 Paolo Rungo=prungo@udc.es
 Marco Runkel=marco.runkel@tu-berlin.de
 Emma Runnemark=emma.runnemark@nek.lu.se
 Gerhard Rünstler=gerhard.ruenstler@ecb.int
 Anna Ruocco=anna_ruocco@alice.it
 Anil Rupasingha=anil.rupasingha@atl.frb.org
 Peter Rupert=rupert@econ.ucsb.edu
 Nicholas G. Rupp=ruppn@ecu.edu
 Inder jit Ruprah=inderr@iadb.org
 Wilhelm Ruprecht=wilhelm.ruprecht@googlemail.com
 Karsten M. Rusche=karsten.rusche@ils-forschung.de
 John William Ruser=ruser_j@bls.gov
 Olga Rusetskaya=orusetskaya@hse.ru
 Horatiu A. Rus=hrus@uwaterloo.ca
 Michael Rusinek=miru@ccecrb.fgov.be
 Ridwan D. Rusli=rdrusli@ntu.edu.sg
 Frank S. Russek, Jr.=frank.russek@cbo.gov
 Bill Russell=w.r.russell@dundee.ac.uk
 Helen Russell=helen.russell@esri.ie
 Louise B. Russell=lrussell@ifh.rutgers.edu
 Noel Patrick Russell=noel.russell@manchester.ac.uk
 Katheryn Niles Russ=knruss@ucdavis.edu
 Alessia Russo=alessia.russo@econ.uio.no
 Antonio Russo=russo@kof.ethz.ch
 Benjamin Russo=brusso@uncc.edu
 Giuseppe Russo=intereco@tiscalinet.it
 Margherita Russo=margherita.russo@unimore.it
 Massimo Alfonso Russo=m.russo@unifg.it
 Paolo Russu=russu@uniss.it
 Emiliano Rustichelli=e.rustichelli@isfol.it
 John Philip Rust=jr1393@georgetown.edu
 Corina Rusu=corina.rusu@cantemircluj.ro
 Mihaela Loredana Rusu=loryrous@yahoo.com
 Andrzej Ruszczynski=rusz@rutcor.rutgers.edu
 Michele Ruta=mruta@imf.org
 Alasdair Rutherford=ar34@stir.ac.uk
 Thomas F. Rutherford=rutherford@aae.wisc.edu
 Emilie Rutledge=e.rutledge@uaeu.ac.ae
 Lamon Rutten=lamonrutten@gmail.com
 Tom David Rutter=tom.rutter@ucl.ac.uk
 James Rutt=james.m.rutt@gmail.com
 Pieter H.M. Ruys=ruys@uvt.nl
 Kamila Ruzickova=kamila.ruzickova@mendelu.cz
 Rodrigo Ruz Torres=rodrigo.ruztorres@inami.fgov.be
 Christian Alejandro Ruzzier=cruzzier@udesa.edu.ar
 venkatesh Murthy R=venkateshmurthyr@gmail.com
 Michael David Ryall=mdr@mikeryall.com
 David L. Ryan=david.ryan@ualberta.ca
 John Ryan=jmtryan@aol.co.uk
 Michael J. Ryan=michael.ryan@wmich.edu
 Stephen P. Ryan=sryan@utexas.edu
 Marina Rybalka=ryb@ssb.no
 Francois Rycx=frycx@ulb.ac.be
 John Ryding=ryding@rdqeconomics.com
 Ondrej Rydval=ondrej.rydval@cerge-ei.cz
 Soon Ryoo=sryoo@adelphi.edu
 Jakub Rysanek=jakub.rysanek@cnb.cz
 John Henry Ryskamp=philneo2001@yahoo.com
 Marc Rysman=mrysman@bu.edu
 Dmitry Ryvkin=dryvkin@fsu.edu
 Lotfi Rzigui=rzigui_lotfi@yahoo.fr
