 William Baah-Boateng=wbaahboat@post.harvard.edu
 Barbara E. Baarsma=barbara.baarsma@seo.nl
 Timo Baas=timo.baas@wiwinf.uni-due.de
 David Babbel=babbel@wharton.upenn.edu
 Ivan Baboucek=ivan.baboucek@cnb.cz
 Sahar Babri=sahar.babri@nhh.no
 Ana Babus=a.babus@imperial.ac.uk
 Maya Bacache-Beauvallet=maya.bacache@enst.fr
 Bogdan Bacanu=b.bacanu@unitbv.ro
 Jordi Bacaria=jordi.bacaria@uab.es
 Mariagiovanna Baccara=mbaccara@wustl.edu
 Sourour Baccar=sourour.baccar@fsegs.rnu.tn
 Philippe Bacchetta=philippe.bacchetta@unil.ch
 Alberto Bacchiega=alberto.bacchiega@ec.europa.eu
 Emanuele Bacchiega=emanuele.bacchiega@unibo.it
 Fabio Bacchini=bacchini@istat.it
 Emanuele Bacchiocchi=emanuele.bacchiocchi@unimi.it
 Silvia Bacci=silvia.bacci@stat.unipg.it
 Dorin Paul Bac=dbac@uoradea.ro
 Marius Bacescu=mariusbacescu@gmail.com
 Ray Bachan=rb2@bton.ac.uk
 Stefan Holst Bache=sbache@creates.au.dk
 Hrabrin Bachev Храбрин Башев (Hrabrin Bachev)=hbachev@yahoo.com
 Enrico Bachis=secretariat@iffo.net
 Daniel David Bachman=daniel.bachman@ihs.com
 Ruediger Bachmann=ruediger.bachmann@rwth-aachen.de
 Stefan Bach=sbach@diw.de
 José L. Bacigalupo=jbacigalupo@worldbank.org
 Mihai Florin Bacila=mihai.bacila@econ.ubbcluj.ro
 Livia BACIU=baciu_livia@yahoo.com
 Peter Backé=peter.backe@oenb.at
 Mickael Bäckman=mickael.backman@gmail.com
 David Backus=dbackus@stern.nyu.edu
 Daniel Badagnani=daniel@fisica.unlp.edu.ar
 Lucy Badalian=badalien00@gmail.com
 Cristina Badarau=florina-cristina.badarau@u-bordeaux4.fr
 Ahmed Abubakr Ali Badawi=ahmedbadawi72@yahoo.com
 Michelle Catherine Baddeley=m.baddeley@ucl.ac.uk
 Liana Badea=badea.liana@gmail.com
 Marc Badia-Miró=mbadia@ub.edu
 Luiza Badin=luizab@ase.ro
 Ihsan Badshah=ihsan.badshah@aut.ac.nz
 Alina Badulescu=abadulescu@uoradea.ro
 Laviniu-Aurelian Badulescu=laviniu_aurelian_badulescu@yahoo.com
 Олег Бадуненко (Oleg Badunenko)=obadunen@uni-koeln.de
 Chulwoo Baek=chulwoo100@gmail.com
 Seung-Jin Baek=jinyus.baek@gmail.com
 Lieven Baele=lieven.baele@uvt.nl
 Romain Baeriswyl=romain.baeriswyl@snb.ch
 Stijn Baert=stijn.baert@ugent.be
 Sang Hoo Bae=sbae@clarku.edu
 Gregor Baeurle=gregor.baeurle@snb.ch
 Yong-Kyun Bae=econbae1@gmail.com
 Youngsoo Bae=ysbae@uos.ac.kr
 Javier Eduardo Baez=jbaez@worldbank.org
 John Baffes=jbaffes@worldbank.org
 Enrico Baffi=baffienrico@hotmail.com
 John Baffoe-Bonnie=jbb10@psu.edu
 Igor Bagayev=igor.bagayev@univ-paris-est.fr
 Emilie Bagby=emiliebagby@gmail.com
 Sagnik Bagchi=bagchi.sagnik@gmail.com
 Shantanu Bagchi=sbagchi@towson.edu
 Sutirtha Bagchi=sbagchi@umich.edu
 Muhlis Bagdigen=muhlisbagdigen@hotmail.com
 Rytis Bagdziunas=rytis.bagdziunas@uclouvain.be
 Jesper Bagger=jesper.bagger@rhul.ac.uk
 Michele Baggio=michele.baggio@uconn.edu
 Rufin Sosthene Baghana=rufin.baghana@finances.gouv.qc.ca
 Fabio C. Bagliano=fabio.bagliano@unito.it
 Angelo Baglioni=angelo.baglioni@unicatt.it
 Alberto Bagnai=bagnai@unich.it
 Pantelis G. Bagos=pbagos@ucg.gr
 Pinaki Bag=pinakibag@gmail.com
 Manuel Bagues=manuel.bagues@aalto.fi
 Adama BAH=adamabah@gmail.com
 Dany Bahar=dbahar@fas.harvard.edu
 Ahmad Zubaidi Baharumshah=zubaidi@putra.upm.edu.my
 Eric Bahel=erbahel@vt.edu
 El-hadj M. Bah=e.bah@auckland.ac.nz
 Fousseynou Bah=fousseynoubah@gmail.com
 Godfrey Bones Bahiigwa=g.bahiigwa@cgiar.org
 Roy W. Bahl=rbahl@gsu.edu
 Pejman Bahramian=pejman.bahramian@gmail.com
 Scott L. Baier=sbaier@clemson.edu
 Tomas Baiget=baiget@sarenet.es
 Taimur Baig=taimur.baig@db.com
 Jennie Bai=jb2348@georgetown.edu
 Jinhui H. Bai=jinhui.bai@gmail.com
 Jushan Bai=jb3064@columbia.edu
 Alastair StJohn Bailey=a.bailey@kent.ac.uk
 Alison Bailey=a.p.bailey@reading.ac.uk
 DeeVon Bailey=deevon.bailey@usu.edu
 James Benjamin Bailey=jbailey@temple.edu
 James R. Bailey=jbailey@gwu.edu
 Linda A. Bailey=linda.baileymcweeney@csi.cuny.edu
 Mark Bailey=mf.bailey@ulster.ac.uk
 Martha J. Bailey=baileymj@umich.edu
 Ralph W. Bailey=r.w.bailey@bham.ac.uk
 Richard T. Baillie=baillie@msu.edu
 Jeannine Bailliu=jbailliu@bankofcanada.ca
 Aurelien Baillon=baillon@ese.eur.nl
 Mark Baimbridge=m.j.baimbridge@bradford.ac.uk
 Iain Bain=ibain@kpmg.com.au
 Subir Kanti Bairagi=subirkanti105@gmail.com
 Yan Bai=yan.bai@asu.edu
 Chris Bajada=chris.bajada@uts.edu.au
 Petra Baji=petra.baji@uni-corvinus.hu
 Emanuele Bajo=emanuele.bajo@unibo.it
 Oscar Bajo-Rubio=oscar.bajo@uclm.es
 Dimitrios Bakas=dbakas@econ.uoa.gr
 Matthew Baker=matthew.baker@hunter.cuny.edu
 Sasan Bakhtiari=sasan_bakhtiari@yahoo.com
 Toni Bakhtiar=tbakhtiar@ipb.ac.id
 Jon Bakija=jbakija@williams.edu
 Assoc. Prof. Dr.Tahsin Bakirtas=bakirtas@sakarya.edu.tr
 Einar Bakke=einar.bakke@gu.se
 Soham Baksi=s.baksi@uwinnipeg.ca
 Zoltán Bakucs=bakucs@econ.core.hu
 Valeria Arina Balaceanu=arina.balaceanu@gmail.com
 Balasingham Balachandran=b.balachandran@latrobe.edu.au
 Loukas Balafoutas=loukas.balafoutas@uibk.ac.at
 Joseph V. Balagtas=balagtas@purdue.edu
 Jacint Balaguer=jacint.balaguer@eco.uji.es
 Madhu Bala=madhu81@yahoo.com
 Adina Balan=adinaburicea@yahoo.com
 Ana Maria Balan=balan_ana84@yahoo.com
 Jean-Marie Baland=jean-marie.baland@fundp.ac.be
 Maria Cristina Balaneasa=cristinab@seap.usv.ro
 Andrei Cristian Balasan=balasanandrei@gmail.com
 Vladimir Alexeevich Balash=vladimirbalash@yandex.ru
 Yves Balasko=yves@balasko.com
 Steven Joseph Balassi=sbalassi@napavalley.edu
 Fabrizio Balassone=fbalassone@hotmail.com
 Vimal Balasubramaniam=vimsaa@gmail.com
 Lakshmi Balasubramanyan=lakshmi.balasubramanyan@clev.frb.org
 Vladimir Balaz=vbalaz@yahoo.com
 Stefano Balbi=stefano.balbi@bc3research.org
 Fabio Balboni=balboni.fabio@gmail.com
 Laia Balcells=laia.balcells@iae.csic.es
 Mehmet Balcilar=mehmet@mbalcilar.net
 Cinzia Baldan=cinzia.baldan@unipd.it
 Juventino Ulyses Balderas=balderj@stthom.edu
 Erik J. Balder=e.j.balder@uu.nl
 Chiara Balderi=chiara.balderi@sssup.it
 Lucia Baldi=lucia.baldi@unimi.it
 Christopher Balding=cbalding@uci.edu
 Alfredo Baldini=abaldini@imf.org
 Massimo Baldini=massimo.baldini@unimore.it
 Fridrik Mar Baldursson=fmb@ru.is
 Paolo Balduzzi=paolo.balduzzi@unicatt.it
 John Russel Baldwin=john.baldwin@statcan.gc.ca
 Richard Baldwin=baldwin@graduateinstitute.ch
 Rui Nuno Baleiras=rnbaleiras@cfp.pt
 Alessandro Balestrino=balestrino@sp.unipi.it
 Isaac Baley=isaac.baley@nyu.edu
 Tomas Baležentis=tomas@laei.lt
 Silvia Balia=silvia.balia@unica.it
 Sandeep Baliga=baliga@kellogg.northwestern.edu
 Michel Balinski=michel.balinski@polytechnique.edu
 Arsenio Balisacan=arsenio.balisacan@up.edu.ph
 Edward J. Balistreri=ebalistr@mines.edu
 Nathan Balke=nbalke@mail.smu.edu
 Pierre-Alexandre Balland=p.balland@uu.nl
 Charles Lincoln Ballard=ballard@msu.edu
 Christopher P. Ball=christopher.ball@quinnipiac.edu
 Almut Balleer=almut.balleer@iies.su.se
 Coralio Ballester=coralio@ua.es
 Miguel Angel Ballester=miguelangel.ballester@uab.es
 Ramon Ballester=ramon.ballester@udg.edu
 Faruk Balli=f.balli@massey.ac.nz
 Hatice Ozer Balli=h.ozer-balli@massey.ac.nz
 Clint Ballinger=clintballinger@cantab.net
 T. Parker Ballinger=pballinger@sfasu.edu
 Laurence Ball=lball@jhu.edu
 Paola Ballon=paola.ballon@qeh.ox.ac.uk
 Gérard Ballot=gerardballot@wanadoo.fr
 Philip Bokang Ball=philip_b_ball@yahoo.co.uk
 Ray Ball=ray.ball@chicagobooth.edu
 Steffan Ball=steffan.ball@citadel.com
 Felipe Balmaceda=fbalmace@gmail.com
 Alfons Balmann=balmann@iamo.de
 Roberto E. Balmer=roberto.balmer@bakom.admin.ch
 Asma Hyder Baloch=asmabaloch2000@yahoo.com
 Emmanuel Dele Balogun=edbalogun@yahoo.com
 Ana Inés Balsa=abalsa@um.edu.uy
 Anna Balsevich=anna.balsevich@gmail.com
 Badi Baltagi=bbaltagi@maxwell.syr.edu
 Carolina Troncoso Baltar=cbaltar@gmail.com
 Codruta Adina Baltescu=codruta.baltescu@unitbv.ro
 Nicolae Baltes=baltes_n@yahoo.com
 Guido Baltussen=baltussen@few.eur.nl
 Kenneth Baltzer=kb@ifro.ku.dk
 Florentina Olivia Balu=olivia_balu@yahoo.fr
 Ronald J. Balvers=balvers@mcmaster.ca
 Markus Balzat=markus_balzat@yahoo.de
 Matthias Balz=balz@ifo.de
 Mauro Bambi=mb607@york.ac.uk
 Charles Bamford=cbamford@bamfordassociates.com
 Albert Banal-Estanol=albert.banalestanol@upf.edu
 Georgios Banavas=banavas@otenet.gr
 Marta Banbura=marta.banbura@ecb.int
 Pablo Bandeira=pbandeira@ceu.es
 Roberto Bande=roberto.bande@usc.es
 Roger Bandick=roger@hih.au.dk
 Martin Bandulet=martin.bandulet@repower.com
 Arindam Bandyopadhyay=arindam@nibmindia.org
 Kaushik Ranjan Bandyopadhyay=kaushik.banerjee@gmail.com
 Sanghamitra Bandyopadhyay=s.bandyopadhyay@qmul.ac.uk
 Simanti Bandyopadhyay=simantib@gmail.com
 Subhayu Bandyopadhyay=subhayu.bandyopadhyay@stls.frb.org
 Anindya Banerjee=a.banerjee@bham.ac.uk
 Anurag Banerjee=a.n.banerjee@durham.ac.uk
 Swapnendu Banerjee (Bandyopadhyay)=swapnendu@hotmail.com
 Tanmoyee Banerjee (Chatterjee)=tanmoyee@hotmail.com
 Onil Banerjee=onilb@iadb.org
 Anirvan Banerji=anirvan@businesscycle.com
 Afua Branoah Banful=abanful@post.harvard.edu
 Chrysost Bangaké=chrysost.bangake@univ-orleans.fr
 Rashmi Banga=rashmibanga@yahoo.com
 Doowon Bang=doowoan@gmail.com
 James T. Bang=bangjamest@sau.edu
 Lansana Bangoura=labangoura@gmail.com
 Se Hoon Bang=bang@kdi.re.kr
 Joann Bangs=jmbangs@stkate.edu
 Dean A. Bangsund=d.bangsund@ndsu.edu
 Neil Bania=neil@bania.org
 Logica Bănică=olga.banica@upit.ro
 Arindam Banik=banik.arindam@gmail.com
 Nilanjan Banik=nilanjanbanik@gmail.com
 Edward Bankole=ebankole@globalsra.com
 Mariasole Bannò=mariasole.banno@unibs.it
 Anand Bansal=preetmillie@yahoo.com
 Martin Banse=martin.banse@vti.bund.de
 Michael Ba Banutu-Gomez=banutu-gomez@rowan.edu
 Ashraf A. Bany Mohammed=ashraf_bany@yahoo.com
 Spencer Banzhaf=hsbanzhaf@gsu.edu
 Yong Bao=ybao@purdue.edu
 Alexandre M. Baptista=alexbapt@gwu.edu
 Gualter Barbas Baptista=gualter@gaia.org.pt
 Rui Baptista=rui.baptista@ist.utl.pt
 Adela Bara=bara.adela@ie.ase.ro
 Angel Antonio Barajas=abarajas@uvigo.es
 A. Laura Baraldi=laura.baraldi@unina2.it
 Ilaski Barañano=ilaski.baranano@ehu.es
 Iwan Barankay=barankay@wharton.upenn.edu
 Anton Baranov=freejumper@yandex.ru
 Anna Baranowska-Rataj=anna.baranowska@sgh.waw.pl
 Zsofia Luca Barany=zsofia.barany@sciences-po.org
 Alessandro Barattieri=barattieri.alessandro@uqam.ca
 Giorgio Barba Navaretti=barba@unimi.it
 Nicola Barban=n.barban@rug.nl
 Alessandro Barbarino=alessandro.barbarino@frb.gov
 Salvatore Barbaro=salvatore.barbaro@mwvlw.rlp.de
 susana Barbeito roibal=susana.barbeito@udc.es
 Salvador Barberà=salvador.barbera@uab.cat
 Lorena G. Barberia Balboni=lorena.barberia@gmail.com
 William Barber=wbarber@wesleyan.edu
 Philippe Barbet=philippe.barbet@univ-paris13.fr
 Gianpaolo Barbetta=gianpaolo.barbetta@unicatt.it
 Federico Barbiellini Amidei=federico.barbielliniamidei@bancaditalia.it
 Edward B. Barbier=ebarbier@uwyo.edu
 Laura Barbieri=laura.barbieri@unicatt.it
 Magali Barbieri=barbieri@ined.fr
 Stefano Barbieri=sbarbier@tulane.edu
 Alessandro Barbiero=alessandro.barbiero@unimi.it
 Fernando C. Barbi=fcbarbi@gmail.com
 Massimiliano Barbi=massimiliano.barbi@unibo.it
 Antonio S. Pinto Barbosa=abarbosa@fe.unl.pt
 Evaldo Barbosa=evaldogb@ig.com.br
 Nelson Henrique Barbosa-Filho=nhbarbosa@gmail.com
 Natália Barbosa=natbar@eeg.uminho.pt
 James L. Barbour=barbour@elon.edu
 Laurentiu BARCAN=laurentiu@barcan.eu
 Cristina Barceló=barcelo@bde.es
 Elena Barcena-Martin=barcenae@uma.es
 Juan Carlos Bárcena-Ruiz=juancarlos.barcena@ehu.es
 Daniel Barczyk=daniel.barczyk@mcgill.ca
 Sylvain Barde=s.barde@kent.ac.uk
 David Bardey=david.bardey@gmail.com
 Gunnar Bårdsen=gunnar.bardsen@svt.ntnu.no
 Olivier Bargain=olivier.bargain@univ-amu.fr
 Andrés Barge-Gil=abarge@ccee.ucm.es
 Leonardo Bargigli=leonardo.bargigli@unifi.it
 Karim Barhoumi=barhoumi_karim@yahoo.fr
 Kaustuva Barik=kbarik@hotmail.com
 Ioana Barin - Olariu=ioana_barin@yahoo.com
 Heski Bar-Isaac=heski.bar-isaac@rotman.utoronto.ca
 Gover Barja Daza=gbarja@mpd.ucb.edu.bo
 Franz Barjak=franz.barjak@fhnw.ch
 sajad Barkhordari=sajadbarkhordari@gmail.com
 David Barkin=barkin@correo.xoc.uam.mx
 Andrew Barkley=barkley@ksu.edu
 John Barkoulas=jbarkoul@georgiasouthern.edu
 Drazen Barkovic=barkovic@efos.hr
 Anthony J. Barkume=barkume.anthony@bls.gov
 Philippe Barla=philippe.barla@ecn.ulaval.ca
 Yasemin Barlas=yasemin.barlas@tcmb.gov.tr
 Gadi Barlevy=gbarlevy@frbchi.org
 Mehmet Barlo=barlo@sabanciuniv.edu
 Dr. Arup Barman=abgeet@gmail.com
 Tim Barmby=tim.barmby@abdn.ac.uk
 Cristina Barna=cristina_barna1412@yahoo.com
 Geoff Barnard=geoff.barnard@oecd.org
 Thomas BARNAY=barnay@u-pec.fr
 Ole E. Barndorff-Nielsen=oebn@imf.au.dk
 Emanuel Barnea=barnea@econ.haifa.ac.il
 Andrew P Barnes=andrew.barnes@sac.ac.uk
 Paul Barnes=paul.a.barnes@btconnect.com
 Sebastian BARNES=sebastian.barnes@oecd.org
 Barry J. Barnett=barnett@agecon.msstate.edu
 Richard C. Barnett=rcb63@drexel.edu
 Vincent Barnett=vlbarnett@postmaster.co.uk
 William Barnett=barnett@ku.edu
 Sharon Marie Barnhardt=barnhardt@post.harvard.edu
 Adriana Barone=abarone@unisa.it
 Guglielmo Barone=guglielmo.barone@bancaditalia.it
 Michel Baroni=baroni@essec.fr
 Juan David Barón=juandbaron@gmail.com
 Bharat Barot=bharatbarot48@gmail.com
 Rafael Barquin=rbarquin@cee.uned.es
 Abigail Barr=abigail.barr@nottingham.ac.uk
 Luis Barragan=luis.barragan@ucsg.edu.ec
 Roxana Barrantes=roxbarrantes@iep.org.pe
 Alan Irwin Barreca=abarreca@tulane.edu
 Iván Barreda Tarrazona=ivan.barreda@eco.uji.es
 André Barreira da Silva Rocha=ar290@le.ac.uk
 Pedro Barreira=pedrobarreira@hotmail.com
 Fernando Barreiro-Pereira=fbarreiro@cee.uned.es
 Carlos R. Barrera Chaupis=carlos.barrera@bcrp.gob.pe
 Felipe Barrera-Osorio=felipe_barrera-osorio@harvard.edu
 Marie-Agnès Barrère-Maurisson=barrere@univ-paris1.fr
 Thomas Barré=tjbarre@ucdavis.edu
 Humberto Barreto=hbarreto@depauw.edu
 Carlos Alberto Barreto Nieto=carlosbarreto79@yahoo.com
 Raul Anibal Barreto=raul.barreto@adelaide.edu.au
 Alan Barrett=alan.barrett@esri.ie
 Christopher B. Barrett=cbb2@cornell.edu
 Garry F Barrett=garry.barrett@sydney.edu.au
 Jorge Barrientos Marin=jbarr@economicas.udea.edu.co
 Paola Andrea Barrientos Quiroga=pbarrientos@econ.au.dk
 Melina Barrio Martínez=melina.barrio@uah.es
 Carolina Barrios=cabala71@yahoo.com
 Javier A. Barrios García=jabarrio@ull.es
 Juan José Barrios=barrios@ort.edu.uy
 Salvador Barrios=salvadorbarrios@gmail.com
 Jason Barr=jmbarr@andromeda.rutgers.edu
 Diana Barro=d.barro@unive.it
 John Barron=barron@purdue.edu
 Manuel Barron=manuel.barron@berkeley.edu
 Patrick Barron=pbarron77@gmail.com
 Alexandre Rands Barros=alexandre.rands@datametrica.com.br
 João Barata Ribeiro Blanco Barroso=joao.barroso@bcb.gov.br
 Luiz Augusto Barroso=luiz@psr-inc.com
 Pedro Barros=ppbarros@novasbe.pt
 Luis-Diego Barrot=lbarrot@gmail.com
 Lisa Barrow=lbarrow@frbchi.org
 Jose Manuel Barrueco=barrueco@uv.es
 Levon Barseghyan=lb247@cornell.edu
 Robert Barsky=barsky@frbchi.org
 Flavia Barsotti=flavia.barsotti@unifi.it
 Fady Barsoum=fady.nagy-barsoum@uni-konstanz.de
 Talia Bar=taliabar97@gmail.com
 Rainer Bartel=rainer.bartel@jku.at
 Charlotte Bartels=charlotte.bartels@fu-berlin.de
 Koen Pieter Robert Bartels=k.bartels@bangor.ac.uk
 Eric J. Bartelsman=ebartelsman@alum.mit.edu
 Zoltán Bartha=zolib@hu.inter.net
 Daniel John Barth=dbarth@hamilton.edu
 Fabrice Barthélémy=fabrice.barthelemy@u-cergy.fr
 Jean Barthélemy=jean.barthelemy@banque-france.fr
 Sylvain BARTHELEMY=barth@tac-financial.com
 Jens Barthel=barthel@wiwi.hu-berlin.de
 Erling Barth=eba@socialresearch.no
 Jan Bartholdy=jby@asb.dk
 Florian W. Bartholomae=florian.bartholomae@unibw.de
 Timothy J. Bartik=bartik@upjohn.org
 Laura Bartiloro=laura.bartiloro@bancaditalia.it
 Matthew Bartleet=matthew.bartleet@med.govt.nz
 David Bartolini=d.bartolini@univpm.it
 Fabio Bartolini=fabio.bartolini@unipi.it
 Tjaša Bartolj=bartoljt@ier.si
 Dasa Bartosova=ygiah.dasa@gmail.com
 Lubica Bartova=lubica.bartova@uniag.sk
 Söhnke M. Bartram=sbartram@london.edu
 Anthony Bartzokas=bartzokas@intech.unu.edu
 Nikolaus Bartzsch=nikolaus.bartzsch@bundesbank.de
 Alokesh Barua=abarua@mail.jnu.ac.in
 Rashmi Barua=rashmibarua@smu.edu.sg
 Moreno Baruffini=moreno.baruffini@usi.ch
 Jozef Baruník=barunik@utia.cas.cz
 Panle Jia Barwick=panle.barwick@cornell.edu
 Luca Barzanti=luca.barzanti@unibo.it
 Suleyman Basak=sbasak@london.edu
 Esref Savas Basci=esavasbasci@hitit.edu.tr
 Sıdıka Başçı=sidika.basci@gmail.com
 Emiliano Basco=ebasco@gmail.com
 Giorgio Basevi=giorgio.basevi@unibo.it
 Omar HMN Bashar=omar.bashar@deakin.edu.au
 Md. Abul Basher=abasher@bids.org.bd
 Syed Abul Basher=syed.basher@gmail.com
 Sadaf Bashir=sadafbahmed@gmail.com
 Saima Bashir=saimabashir.82@gmail.com
 Achille Basile=basile@unina.it
 Roberto Basile=robertobasile66@yahoo.it
 Marcello Basili=basili@unisi.it
 Leilanie Basilio=bleilanie@yahoo.com
 Angathevar Baskaran=anga1@mdx.ac.uk
 Thushyanthan Baskaran=tbaskar@uni-goettingen.de
 Yusuf Soner Baskaya=soner.baskaya@tcmb.gov.tr
 Miia Bask=miia.bask@sos.uib.no
 Mikael Bask=mikael.bask@nek.uu.se
 Maurice Baslé=maurice.basle@univ-rennes1.fr
 Suren Basov=s.basov@latrobe.edu.au
 Muhammad Chatib Basri=cbasri@depkeu.go.id
 Andrea Bassanini=andrea.bassanini@oecd.org
 BEN SOLTANE Bassem=bensoltane.bassem@laposte.net
 Thomas Bassetti=thomas.bassetti@unipd.it
 Hans H. Bass=bass@fbn.hs-bremen.de
 Charbel Bassil=cbassil@ndu.edu.lb
 Matteo Bassi=matteo.bassi@gmail.com
 Henrique S. Basso=henrique.basso@bde.es
 Spencer Bastani=spencer.bastani@nek.uu.se
 Andrea Bastianin=andrea.bastianin@unimi.it
 Tomas Gabriel Bas=tomasgbas@gmail.com
 Luis Edgar Basto Mercado=le.basto21@uniandes.edu.co
 Amélia Bastos=abastos@iseg.utl.pt
 Paulo Bastos=pbastos@worldbank.org
 Rafael Rabelo Bastos=rafaelrabelobastos@yahoo.com.br
 Diego Alberto Bastourre=dbastourre@bcra.gov.ar
 Anirban Basu=basua@uw.edu
 Anup K. Basu=a.basu@qut.edu.au
 Arnab Basu=arnab.basu@cornell.edu
 Dipak Basu=bose66@hotmail.com
 Karna Basu=kbasu@hunter.cuny.edu
 Kisalaya Basu=kbasu@swufe.edu.cn
 Sudip Ranjan Basu=sudipranjan.basu@graduateinstitute.ch
 Sujata Basu=sujata.eco@gmail.com
 Suman Sambha Basu=sbasu2@imf.org
 Susanto Basu=susanto.basu@bc.edu
 Erdenebat Bataa=tsors79@gmail.com
 Amitrajeet Batabyal=aabgsh@rit.edu
 Partha Batabyal=partha53323@yahoo.co.in
 Sourav Batabyal=sourav.batabyal@fredonia.edu
 Yele Maweki Batana=ybatana@hotmail.com
 Roy Batchelor=r.a.batchelor@city.ac.uk
 Hazel Bateman=h.bateman@unsw.edu.au
 Ian J. Bateman=i.bateman@uea.ac.uk
 Joerg Baten=joerg.baten@uni-tuebingen.de
 Samuel Bates=samuel.bates@dauphine.fr
 Timothy Bates=tbates7893@gmail.com
 Winton Bates=winton_bates@msn.com.au
 Philippe Batifoulier=philippe.batifoulier@u-paris10.fr
 Nicoletta Batini=nicoletta.batini@tesoro.it
 Catia Batista=catia.batista@novasbe.pt
 Magno Vamberto Batista da Silva=magnobs@yahoo.com
 Svetlana Batrakova=s.batrakova@gmail.com
 Ghiorghe Batrinca=gbatrinca@imc.ro
 Maria Rosa Battaggion=maria-rosa.battaggion@unibg.it
 Marianna Battaglia=mbattaglia@ua.es
 Marco Battaglini=mbattagl@princeton.edu
 Jonathan Andrew Batten=jabatten@gmail.com
 Ernesto Batteta=batteta@unica.it
 Pierpaolo Battigalli=pierpaolo.battigalli@unibocconi.it
 Patrizia Battilani=patrizia.battilani@unibo.it
 Stefano Battilossi=stefano.battilossi@uc3m.es
 Giuliana Battisti=giuliana.battisti@wbs.ac.uk
 Michele Battisti=battisti@ifo.de
 Michele Battisti=michele.battisti@unipa.it
 Erich Battistin=erich.battistin@unipd.it
 Niccolò Battistini=niccolo.battistini@gmail.com
 Diego Battistón=d.e.battiston@lse.ac.uk
 Pietro Battiston=me@pietrobattiston.it
 Michael, Batuo Enowbi=enowbi71@yahoo.it
 Anna Batyra=annabatyra@yahoo.fr
 Dimitris Batzilis=batzilis@gmail.com
 Michael Benjamin Batz=mbatz@rff.org
 Manel Baucells=manel.baucells@upf.edu
 Didier Baudewyns=dib@plan.be
 Thomas Baudin=thomas.baudin@uclouvain.be
 marc Baudry=marc.baudry@u-paris10.fr
 Christian Bauer=bauer@uni-trier.de
 Christian J. Bauer=christian.j.bauer@gmail.com
 Gerrit Bauer=gerrit.bauer@soziologie.uni-muenchen.de
 Gregory H. Bauer=gbauer@bankofcanada.ca
 Michael Dominic Bauer=michael.bauer@sf.frb.org
 Michal Bauer=bauerm@fsv.cuni.cz
 Paul Bauer=bauerpw@oneonta.edu
 Philipp Bauer=philipp.bauer@economiesuisse.ch
 Thomas K. Bauer=bauer@rwi-essen.de
 Antoinette Baujard=antoinette.baujard@univ-st-etienne.fr
 Florian Baumann=fbaumann@dice.hhu.de
 Manuel Johann Baumann, Sr.=manuel.baumann@kit.edu
 Robert Baumann=rbaumann@holycross.edu
 Massimo Bau'=massimo.bau@uniud.it
 Christopher Baum=baum@bc.edu
 Christiane Baumeister=cbaumeister@bankofcanada.ca
 Hans J. Baumgartner=hans-joerg.baumgartner@bmf.bund.de
 Josef Baumgartner=josef.baumgartner@wifo.ac.at
 Stefan Baumgärtner=baumgaertner@uni.leuphana.de
 Katja Baum=katja.baum@freenet.de
 Eduard Baumöhl=eduard.baumohl@euke.sk
 William Baumol=william.baumol@nyu.edu
 Catherine Baumont=baumonc@u-bourgogne.fr
 Sabine Baum=baum@iamo.de
 Nathaniel Baum-Snow=nathaniel_baum-snow@brown.edu
 Assad Baunto=assadbaunto@gmail.com
 Dirk Baur=dirk.baur@uts.edu.au
 Maurizio Luigi Baussola=maurizio.baussola@unicatt.it
 Guillermo Bautista=gbautist@engmail.uwaterloo.ca
 Luc Bauwens=luc.bauwens@uclouvain.be
 Gilad Bavly=gilad.bavly@gmail.com
 Marianne Baxter=mbaxter@bu.edu
 Christian Bayer=christian.bayer@uni-bonn.de
 Ralph-C Bayer=ralph.bayer@adelaide.edu.au
 Basak Bayramoglu=basak.bayramoglu@grignon.inra.fr
 Ciro Eduardo Bazán Navarro=ciro_bazan@hotmail.com
 Cécile BAZART=cecile.bazart@lameta.univ-montp1.fr
 Santiago Bazdresch=santiago@umn.edu
 Stephen Bazen=stephen.bazen@univ-amu.fr
 Remi Bazillier=remi.bazillier@univ-orleans.fr
 Damien BAZIN=damien.bazin@unice.fr
 Guillaume Bazot=bazot@pse.ens.fr
 Monika Bazyl=monika.bazyl@doktorant.sgh.waw.pl
 Guido Maria Bazzani=g.bazzani@ibimet.cnr.it
 Robert Henry Beach, III=rbeach@rti.org
 Steven L. Beach=slbeach@radford.edu
 Sylvain Béal=sylvain.beal@univ-fcomte.fr
 Lori Beaman=l-beaman@northwestern.edu
 Emily Allison Beam=emilybeam@nus.edu.sg
 Rodney Beard=rodney.m.beard@gmail.com
 Peter Michael Bearse=bearse@uncg.edu
 Kevin Elie Beaubrun-Diant=kevin.beaubrun@dauphine.fr
 Kenneth Beauchemin=ken.beauchemin@mpls.frb.org
 Mickael Beaud=mbeaud@univ-montp1.fr
 Paul Beaudry=paulbe@interchange.ubc.ca
 Scott A. Beaulier=sbeaulier@troy.edu
 Eugene Beaulieu=beaulieu@ucalgary.ca
 Paul M. Beaumont=beaumont@fsu.edu
 Jonathan Beaverstock=jonathan.beaverstock@bristol.ac.uk
 Lucian Bebchuk=bebchuk@law.harvard.edu
 Ricardo N. Bebczuk=ricardo.bebczuk@gmail.com
 Ufuk Gunes Bebek=ugb3@kent.ac.uk
 Alessandro Beber=alessandro.beber.1@city.ac.uk
 Miroslav Beblavy=beblavy@governance.sk
 Leonardo Becchetti=becchetti@economia.uniroma2.it
 Franco Becchis=fbecchis@yahoo.it
 Peggy Bechara=peggy.bechara@rwi-essen.de
 Mickael Bech=mbe@sam.sdu.dk
 Morten L. Bech=morten.bech@bis.org
 Marco Becht=mbecht@ulb.ac.be
 Arne Beck=arne.beck@gmx.de
 Bettina Becker=b.becker@aston.ac.uk
 Daniel Becker=dbecker@europa-uni.de
 Nir Becker=nbecker@telhai.ac.il
 Randy A. Becker=randy.a.becker@census.gov
 Sascha O. Becker=s.o.becker@warwick.ac.uk
 André Beckershoff=andre.beckershoff@ercct.uni-tuebingen.de
 Tilman Cornelius Becker=tbecker@uni-hohenheim.de
 Walter Beckert=w.beckert@bbk.ac.uk
 William Edward Becker, Jr.=beckerw@indiana.edu
 Guenter W. Beck=gbeck@wiwi.uni-frankfurt.de
 John H. Beck=beck@jepson.gonzaga.edu
 Jonathan Beck=jonathan.beck@lmu.de
 Jayson Beckman=jbeckman@ers.usda.gov
 Daniela Beckmann=daniela.beckmann@kfw.de
 Joscha Beckmann=joscha.beckmann@uni-due.de
 Volker Beckmann=volker.beckmann@uni-greifswald.de
 Roland Beck=roland.beck@ecb.int
 Thorsten Beck=t.beck@uvt.nl
 David Beckworth=david.beckworth@gmail.com
 Kelly Bedard=kelly@econ.ucsb.edu
 Mathieu Bédard=mathieu.bedard@ut-capitole.fr
 Arthur G. Bedeian=abede@lsu.edu
 Birgit Bednar-Friedl=birgit.friedl@uni-graz.at
 Radek Bednarik=bednarik.radek@gmail.com
 Alejandro Bedoya=bedoya@alumni.lse.ac.uk
 Zsolt Bedo=zsoltbedo@ktk.pte.hu
 Özlem Bedre Defolie=ozlem.bedre@esmt.org
 Maria Viorica Bedrule-Grigoruta=mvgri@uaic.ro
 Nicolas Bédu=nicolas.bedu@yahoo.fr
 Meredith Beechey=meredith.beechey@riksbank.se
 Wendy Anne Beekes=w.beekes@lancaster.ac.uk
 Annika Beelitz=abs038@bangor.ac.uk
 Jim Been=j.been@law.leidenuniv.nl
 Michael Beenstock=msbin@mscc.huji.ac.il
 Krisztina Beer-Tóth=mail2@kbeer.ch
 John Beghin=beghin@iastate.edu
 Ismat Beg=ibeg@lahoreschool.edu.pk
 Alberto Behar=albertobehar31@gmail.com
 Alexander Behar=beharalex@gmail.com
 Nesha Beharry-Borg=n.c.beharry-borg@leeds.ac.uk
 Eric J. Beh=eric.beh@newcastle.edu.au
 Nadine Behncke=nadine.behncke@wiwi.uni-goettingen.de
 Stefanie Behncke=stefanie.behncke@snb.ch
 Kristian Behrens=behrens.kristian@uqam.ca
 Jan Behringer=jan-behringer@boeckler.de
 Michel Beine=michel.beine@uni.lu
 John Beirne=john.beirne@ecb.int
 Thomas Beissinger=beissinger@uni-hohenheim.de
 Arantza Beitia=arantza.beitia@ehu.es
 Edsel L. Beja Jr.=edsel.beja@gmail.com
 Maria Bejan=maria.bejan@rice.edu
 Hernan Daniel Bejarano=hbejainpenn@gmail.com
 Jesus Antonio Bejarano Rojas=jbejarro@banrep.gov.co
 Geert Bekaert=gb241@columbia.edu
 Pablo F. Beker=pablo.beker@warwick.ac.uk
 Victor A. Beker=victor.beker@ub.edu.ar
 Stelios Bekiros=stelios.bekiros@eui.eu
 Eddy Bekkers=eddy.bekkers@jku.at
 Lamia Bekkour=lamia.bekkour@uni.lu
 Jorge Belaire-Franch=jorge.belaire@uv.es
 Pascal Belan=pascal.belan@u-cergy.fr
 Ariel Rene Belasen=abelase@siue.edu
 Anatoliy Belaygorod=belaygorod@wustl.edu
 José Manuel Madeira Belbute=jbelbute@uevora.pt
 Maksim E. Belenkiy=mbelenky@gmail.com
 Sharon Belenzon=sharon.belenzon@duke.edu
 Fernando Paulo Belfo=fpbelfo@gmail.com
 Carl-Johan Belfrage=cjbelfrage@gmail.com
 Aymen Belgacem=aymen.belgacem@univ-orleans.fr
 Germà Bel=gbel@ub.edu
 Belghitar=yacine.belghitar@cranfield.ac.uk
 Antoine Belgodere=belgodere@univ-corse.fr
 Nadia Belhaj Hassine=nbelhaj@idrc.org.eg
 Mohamed Belhaj=mbelhaj@ec-marseille.fr
 Nazim Belhocine=nbelhocine@imf.org
 Alexis Belianin=icef-research@hse.ru
 Ansgar Belke=ansgar.belke@uni-due.de
 Giovanni Bella=bella@unica.it
 Christian Bellak=christian.bellak@wu.ac.at
 Nicolò Bellanca, Sr.=bellanca@unifi.it
 Don Bellante=dbellant@usf.edu
 Byron E. Bell=bbell2851@gmail.com
 David Bell=dnfb1@stir.ac.uk
 Paul Belleflamme=paul.belleflamme@uclouvain.be
 Charles Bellemare=charles.bellemare@ecn.ulaval.ca
 Marc F. Bellemare=marc.bellemare@gmail.com
 Giovanni Belletti=giovanni.belletti@unifi.it
 Giorgio Bellettini=giorgio.bellettini@unibo.it
 Héctor Bellido=hbellido10@gmail.com
 Annie BELLIER DELIENNE=annie.bellier@u-cergy.fr
 Edith Bellini=ebellini@us.es
 Elena Bellini=bellini.ele@tiscali.it
 Tiziano Bellini=tiziano.bellini@unipr.it
 Marianna Belloc=marianna.belloc@uniroma1.it
 José Francisco Bellod Redondo=bellodredondo@yahoo.com
 Benoit Bellone=benoit.bellone@ensae.org
 Flora Bellone=bellone@gredeg.cnrs.fr
 Michele Belloni=michele.belloni@carloalberto.org
 Andriana Bellou=andriana.bellou@umontreal.ca
 Peter Newton Bell=pnbell@uvic.ca
 Ruth Greenspan Bell=bell@rff.org
 William Paul Bell=williampaulbell@gmail.com
 Denis Belomestny=belomest@wias-berlin.de
 Michael T. Belongia=mvpt@earthlink.net
 Michèle Belot=michele.belot@ed.ac.uk
 Federico Belotti=federico.belotti@uniroma2.it
 Loudmila G. Belova=lgbelova@bk.ru
 Patrick Belser=belser@ilo.org
 David A. Belsley=belsley@bc.edu
 Theresa P. Beltramo=tbeltramo@impactcarbon.org
 Arlette Beltrán=beltran_acl@up.edu.pe
 Daniel O. Beltran=daniel.o.beltran@frb.gov
 Francisco J. Beltrán Tapia=francisco.beltran@nuffield.ox.ac.uk
 Constantin Belu=constantinbelu@yahoo.com
 Alexander Alexandrovich Belyaev=belyaev2a@gmail.com
 Christian Belzil=christian.belzil@polytechnique.edu
 Mohamed Ben Abdelhamid=abdelhamidster@gmail.com
 Roland Benabou=rbenabou@princeton.edu
 Mohamed Safouane BEN AISSA=safouane.benaissa@univ-amu.fr
 Jan Bena=jan.bena@sauder.ubc.ca
 Chiraz Ben Ali=chiraz.benali@ipag.fr
 Khadidja Benallou=khadidja.benallou@unicaen.fr
 Michael Benarroch=m.benarroch@ad.umanitoba.ca
 Mario Benassi=mario.benassi@unimi.it
 Jean-Pascal Benassy=benassy@pse.ens.fr
 Agnès Bénassy-Quéré=agnes.benassy@univ-paris1.fr
 Luca Benati=luca.benati@vwi.unibe.ch
 Julián Benavides Franco=jbenavid@icesi.edu.co
 Martín Benavides=mbenavides@grade.org.pe
 Hazar BEN BARKA=benbarkahazar@yahoo.fr
 Benbouziane=m_benbouziane@mail.univ-tlemcen.dz
 Nidhaleddine Ben Cheikh=nbcheikh@gmail.com
 Hassan Benchekroun=hassan.benchekroun@mcgill.ca
 Jonathan Benchimol=jonathan@benchimol.name
 Michal Bencik=michal.bencik@nbs.sk
 Valerie R. Bencivenga=benciven@eco.utexas.edu
 Istvan Benczes=istvan.benczes@uni-corvinus.hu
 Peter Benczur=benczurp@ceu.hu
 Dan Ben-David=danib@post.tau.ac.il
 Nissim Ben David=nissimb@yvc.ac.il
 Keith A. Bender=kabender@abdn.ac.uk
 Jonathan Bendor=bendor_jonathan@gsb.stanford.edu
 Simona Benedettini=sbenedettini@gmail.com
 Mauricio Benegas=mauriciobenegas@yahoo.com.br
 Pilar Beneito=pilar.beneito@uv.es
 Christine Benesch=christine.benesch@unisg.ch
 Agustín S. Bénétrix=benetria@tcd.ie
 Rui Benfica=benficar@msu.edu
 Luigi Benfratello=luigi.benfratello@unina.it
 Michael Ben-Gad=mbengad@city.ac.uk
 Saoussen Ben Gamra=saoussen77@yahoo.fr
 Enrique Bengoechea=enrique.bengoechea@credit-suisse.com
 Ingemar Bengtsson=ingemar.bengtsson@lantm.lth.se
 Niklas Bengtsson=niklas.bengtsson@nek.uu.se
 Jess Benhabib=jess.benhabib@nyu.edu
 Bassem BEN HALIMA=bassem.ben-halima@univ-lille1.fr
 Hakim Ben Hammouda=hakim.benhammouda@wto.org
 Eric Benhamou=benhamou_e@yahoo.com
 Francoise Benhamou=francoise.benhamou@univ-paris13.fr
 Kenza Benhima=kenza.benhima@unil.ch
 James K A Benhin=james.benhin@plymouth.ac.uk
 Klaas Beniers=kbeniers@minszw.nl
 Francisco Benita=francisco_benita@hotmail.com
 Daniel Alberto Benitez=dbenitez@worldbank.org
 Andrew Benito=andrew.benito@gs.com
 Gabriel R.G. Benito=gabriel.r.g.benito@bi.no
 Juan Miguel Benito=jon.benito@unavarra.es
 David Benjamin=dmbenjamin@gmail.com
 Dwayne Benjamin=dwayne.benjamin@utoronto.ca
 George Benjamin=georgebenjamin2001@yahoo.co.in
 Mehdi Ben Jebli=benjebli.mehdi@gmail.com
 رياض بن جليلي (Riadh Ben Jelili)=riadh@dhaman.org
 Monia Ben-Kaabia=monia@posta.unizar.es
 Mohamed Tahar Benkhodja=benkhodja@gate.cnrs.fr
 Konstantins Benkovskis=benkovskis@gmail.com
 Serkan BENK=serkanbenk@yahoo.com
 Szilárd Benk=benk.szilard@gmail.com
 Abderrazak Ben maatoug=abderrazak.benmaatoug@isg.rnu.tn
 Mamoun BenMamoun=vmamoun@yahoo.com
 Mohamed Ben Mimoun=mohamed.benmimoun@malix.univ-paris1.fr
 Ezzeddine Ben Mohamed=benmohamed.ezzeddine@yahoo.fr
 Ben Naceur=sbennaceur@imf.org
 Hamza Bennani=hamza.benna@gmail.com
 Adnen Ben Nasr=adnen.bennasr@isg.rnu.tn
 Avner Ben-Ner=benne001@umn.edu
 Christopher J. Bennett=chris.bennett@bateswhite.com
 John Bennett=john.bennett@brunel.ac.uk
 Moez Bennouri=mzb@rouenbs.fr
 Khaled Bennour=khaledbennour@yahoo.fr
 Walid Ben Omrane=wbenomrane@brocku.ca
 Aymen Ben Rejeb=benredjeb_aymen@yahoo.fr
 Bernard Bensaid=bensaid@me.com
 Ousama Ben Salha=oussama.bensalha@isgs.rnu.tn
 Bensalma Ahmed=bensalma.ahmed@enssea.dz
 Sami Bensassi=bensassi.sami@gmail.com
 Faouzi Bensebaa=faouzi.bensebaa@wanadoo.fr
 Bernard Ben Sita=bernard.bensita@lau.edu.lb
 Mehrez BEN SLAMA=mehrez.benslama@gmail.com
 Alan Benson=alanmb@mit.edu
 Bruce L. Benson=bbenson@garnet.acns.fsu.edu
 Earl D. Benson=earl.benson@wwu.edu
 Todd D Benson=t.benson@cgiar.org
 Benjamin Bental=bbental@econ.haifa.ac.il
 Pierre Nicolas Jean Bentata=pierre.bentata@yahoo.fr
 Chiara Bentivogli=chiara.bentivogli@bancaditalia.it
 Antonio M. Bento=amb396@cornell.edu
 Guilhem Bentoglio=guilhem.bentoglio@ensae.org
 Samuel Bentolila=bentolila@cemfi.es
 El Mostafa Bentour=embentour@gmail.com
 Jeanet Sinding Bentzen=jeanet.bentzen@econ.ku.dk
 Michele Benvenuti=michele.benvenuti@bancaditalia.it
 Slim Ben Youssef=slim.benyoussef@gnet.tn
 Annamária Benyovszki=benyovszkiannamaria@gmail.com
 Younes Ben Zaied=benzaiedyounes@yahoo.fr
 Nadav Ben Zeev=nadavbz@bgu.ac.il
 Jose Benzinho=jbenzinho@iscac.pt
 Anil Kumar Bera=anil@ragnar.econ.uiuc.edu
 Sergio Beraldo=s.beraldo@unina.it
 Pablo Beramendi=pablo.beramendi@duke.edu
 Andrea Berardi=andrea.berardi@univr.it
 Michele Berardi=michele.berardi@manchester.ac.uk
 Alain Beraud=alain.beraud@u-cergy.fr
 Enrico Berbenni=enrico.berbenni@unicatt.it
 Metin Berber=berber@ktu.edu.tr
 José J. Bercoff=jbercoff@herrera.unt.edu.ar
 Ana-Maria Bercu=bercu@uaic.ro
 Julio A. Berdegue=jberdegue@rimisp.org
 Binyamin Berdugo=berdugob@bgu.ac.il
 Sophie Béreau=sophie.bereau@uclouvain.be
 Eduard Berenguer=eduard.berenguer@ub.edu
 David Berenguer Herrero=david.berenguer@urjc.es
 Vanessa Berenguer-Rico=vanessa.berenguer-rico@nuffield.ox.ac.uk
 Aleksander Berentsen=aleksander.berentsen@unibas.ch
 Daniel Beres=beres.daniel@gtk.szie.hu
 Arie Beresteanu=arie@pitt.edu
 Irina V. Berezinets=berezinets@gsom.pu.ru
 Andrew Gouinlock Berg=aberg@imf.org
 Peter A.G. van Bergeijk=bergeijk@iss.nl
 Dirk Bergemann=dirk.bergemann@yale.edu
 Allen N. Berger=aberger@moore.sc.edu
 Axel Berger=axel.berger@die-gdi.de
 Eva M. Berger=eva.berger@uni-mainz.de
 Helge Berger=hberger@imf.org
 Michel Bergeron=bergeron.michel@uqam.ca
 Thor Berger=thor.berger@ekh.lu.se
 Ulrich Berger=ulrich.berger@wu.ac.at
 Wolfram Berger=bergerw@tu-cottbus.de
 Fabian Bergès=fabian.berges@toulouse.inra.fr
 Niclas Berggren=niclas.berggren@ifn.se
 Pii Elina Berghäll=elina.berghall@vatt.fi
 Andreas Bergh=andreas.bergh@ifn.se
 Drago Bergholt=drago.bergholt@bi.no
 Adele Bergin=adele.bergin@esri.ie
 Janine Marie Berg=berg@ilo.org
 Lennart Berg=lennart.berg@nek.uu.se
 Erik Berglof=berglofe@ebrd.com
 Edward M. Bergman=edward.bergman@gmail.com
 Karin Bergman=karin.bergman@nek.lu.se
 Margo Bergman=margo.bergman@gmail.com
 Eric Ariel Bergmann=eabergmann@dundee.ac.uk
 Thomas Bergman=thomas.bergman@regeringskansliet.se
 M. Douglas Berg, Jr.=dberg@shsu.edu
 Nathan Berg=prof.berg@gmail.com
 Raphael Bergoeing=rbergoeing@fen.uchile.cl
 Rolf Bergs=rolfb@prac.de
 Jeffrey H. Bergstrand=bergstrand.1@nd.edu
 Daniel Baird Bergstresser=dberg@brandeis.edu
 Carl Bergstrom=cbergst@u.washington.edu
 Pål Bergström=pabe01@handelsbanken.se
 Ted Bergstrom=tedb@econ.ucsb.edu
 Tim Oliver Berg=berg@ifo.de
 Jason S. Bergtold=bergtold@ksu.edu
 Gunseli Berik=berik@economics.utah.edu
 Valdete Berisha-Krasniqi=vberisha@worldbank.org
 Ales S. Berk=ales.berk@ef.uni-lj.si
 Martin Berka=m.berka@auckland.ac.nz
 Burcu Berke=burcuberke@nigde.edu.tr
 Leon Berkelmans=berkelm@post.harvard.edu
 Enrico Berkes=enrico.berkes@u.northwestern.edu
 Gökhan Berk=gokhan.berk@cevreyapi.net
 Maurice Berk=maurice.berk01@imperial.ac.uk
 Tomer Berkovitz=tb2122@columbia.edu
 Michael Berlemann=michael.berlemann@hsu-hh.de
 Marcus Berliant=berliant@artsci.wustl.edu
 Edina Berlinger=edina.berlinger@gmail.com
 Francesco Berlingieri=berlingieri@zew.de
 Giuseppe Berlingieri=g.berlingieri@lse.ac.uk
 Mitchell Berlin=mitchell.berlin@phil.frb.org
 Gabriella Berloffa=gabriella.berloffa@unitn.it
 Eli Berman=elib@ucsd.edu
 Nicolas Berman=nicolas.berman@graduateinstitute.ch
 Jose Reyes Bernal Bellon=jrbernalb@unal.edu.co
 Alejandro Bernales=abernales@dii.uchile.cl
 Humberto Bernal, Sr.=zhumber@gmail.com
 L Arturo Bernal=larturo.bernal@itesm.mx
 Raquel Bernal=rbernal@uniandes.edu.co
 Lorenzo Ernesto Bernal-Verdugo=lebernal@banxico.org.mx
 Andrew B. Bernard=andrew.b.bernard@tuck.dartmouth.edu
 Luigi Bernardi, Sr.=eunice2010@unipv.it
 Thiago Bernardino de Carvalho, Sr.=tbcarval@cepea.org.br
 Jean-Grégoire Bernard=jean-gregoire.bernard@vuw.ac.nz
 Jean-Thomas Bernard=jbernar3@uottawa.ca
 John C. Bernard=jbernard@udel.edu
 Giovanni Bernardo=g.bernardo@ec.unipi.it
 Sophie Bernard=sophie.bernard@polymtl.ca
 Gian Maria Bernareggi=gm.bernareggi@unimi.it
 Claudia Bernasconi=claudia.bernasconi@econ.uzh.ch
 Michele Bernasconi=bernasconi@unive.it
 Wim Bernasco=wbernasco@nscr.nl
 Luisa Fernanda Bernat=lbernat@icesi.edu.co
 Bastien Bernela=bastien.bernela@univ-poitiers.fr
 Dan Bernhardt=danber@uiuc.edu
 B. Douglas Bernheim=bernheim@stanford.edu
 Daniel M. Bernhofen=dbernhof@american.edu
 Joshua P. Berning=jberning@uga.edu
 Kerstin Bernoth=kbernoth@diw.de
 Paul H. Bern=phbern@syr.edu
 Michael Alan Bernstein=mbernstein@tulane.edu
 Richard Haines Bernsten=bernsten@msu.edu
 Claude Berrebi=claude.berrebi@gmail.com
 David Berre=d.berre@ieseg.fr
 Eric Berr=berr@u-bordeaux4.fr
 David J. Berri=berri@suu.edu
 Tiago C. Berriel=tberriel@econ.puc-rio.br
 Pascual Berrone=pberrone@iese.edu
 Remigio Berruto=remigio.berruto@unito.it
 James Berry=jwb295@cornell.edu
 Steven Berry=steven.berry@yale.edu
 Clémence Berson=clemence.berson@univ-paris1.fr
 Enrico Bertacchini=enrico.bertacchini@unito.it
 Marco Bertaglia=m.bertaglia@imperial.ac.uk
 Alain Bertaud=duatreb@msn.com
 Ata Can Bertay=a.bertay@uvt.nl
 Ariane Berthoin Antal=abantal@wzb.eu
 Antoine Berthou=antoine.berthou@banque-france.fr
 Richard Berthoud=berthoud@essex.ac.uk
 Carlotta Berti Ceroni=carlotta.berticeroni@unibo.it
 Alexandre Bertin=bertin.alexandre2010@gmail.com
 Giovanni Bertin=giovanni.bertin@unive.it
 Graziella Bertocchi=graziella.bertocchi@unimore.it
 Giancarlo Bertocco=giancarlo.bertocco@uninsubria.it
 Jefferson Donizeti Pereira Bertolai=jdonizeti@fgvmail.br
 Paolo Bertoletti=paolo.bertoletti@unipv.it
 Paola Bertolini=paola.bertolini@unimore.it
 Simone Bertoli=sb3151@gmail.com
 Jeremy Bertomeu=jeremy.bertomeu@baruch.cuny.edu
 Fabienne Berton=fabienne.berton@cnam.fr
 Fabio Berton=fabio.berton@laboratoriorevelli.it
 Fabio Bertoni=bertoni@em-lyon.com
 Marco Bertoni=marco.bertoni@unipd.it
 Ivo Geoffrey Bertram=geoff.bertram@vuw.ac.nz
 Daniëlle Bertrand-Cloodt=d.cloodt@alumni.maastrichtuniversity.nl
 Olivier Bertrand=olivier.bertrand@skema.edu
 Vincent Bertrand=vincent.bertrand@univ-fcomte.fr
 Fabio Bertranou=bertranou@ilo.org
 Christoph Bertsch=christoph.bertsch@riksbank.se
 Hakan Berument=berument@bilkent.edu.tr
 Sebastian Bervoets=sebastian.bervoets@univ-amu.fr
 Damien Besancenot=besancenot.damien@univ-paris13.fr
 Tibor Besedes=besedes@gatech.edu
 Martin Besfamille=mbesfamille@uc.cl
 Gregory Besharov=gb293@cornell.edu
 Timothy Besley=t.besley@lse.ac.uk
 Marie Bessec=marie.bessec@dauphine.fr
 Hendrik Bessembinder=finhb@business.utah.edu
 James Bessen=jbessen@researchoninnovation.org
 Donata Bessey=dbessey@yonsei.ac.kr
 David A. Bessler=d-bessler@tamu.edu
 Vladimir A. Bessonov=bessonov@hse.ru
 Alan Bester=cbester@uwo.ca
 Michael H. Best=michael_best@uml.edu
 Roger Betancourt=betancou@econ.umd.edu
 Yanneth Rocio Betancourt=ybetanga@banrep.gov.co
 Edmundo Beteta=ebeteta@pucp.pe
 Carlos Bethencourt=cbethenc@ull.es
 Timo Bettendorf=t.bettendorf@kent.ac.uk
 Gianni Betti=betti2@unisi.it
 Eric P. Bettinger=ebettinger@stanford.edu
 Giulia Bettin=g.bettin@univpm.it
 Regina Annette Betz=r.betz@unsw.edu.au
 Diether Wolfgang Beuermann=dietherbe@iadb.org
 Sjoerd Beugelsdijk=s.beugelsdijk@rug.nl
 Julie Beugnot=julie.beugnot@univ-fcomte.fr
 Daniel Beunza=daniel.beunza@gmail.com
 David J. Bevan=david.bevan@rhul.ac.uk
 David L. Bevan=david.bevan@economics.ox.ac.uk
 Pieter Bevelander=pieter.bevelander@mah.se
 Cosimo Beverelli=cosimo.beverelli@wto.org
 Sondra Beverly=sbeverly@ku.edu
 Carmen Bevia=carmen.bevia@uab.es
 Oluwasegun Olatunde Bewaji=segun.bewaji@gmx.com
 Helen Bewley=h.bewley@niesr.ac.uk
 Arielle Beyaert=arielle@um.es
 Fekadu Beyene=keneefbk@gmail.com
 Andreas Beyer=andreas.beyer@ecb.int
 Joanna Bęza-Bojanowska=joanna.beza-bojanowska@mf.gov.pl
 Vladimir Bezdek=vladimir.bezdek@generali.sk
 Dirk Bezemer=d.j.bezemer@rug.nl
 Χρήστος Μπεζιρτζόγλου (Christos Bezirtzoglou)=christos.bezirtzoglou@ec.europa.eu
 Henri Bezuidenhout=henri.bezuidenhout@nwu.ac.za
 Sosina Bezu=sosinac@yahoo.com
 Dipasis Bhadra=dipasis.bhadra@faa.gov
 Saumitra N. Bhaduri=saumitra@mse.ac.in
 Rohit Bhakar=rohitbhakar@gmail.com
 Sonia Bhalotra=s.bhalotra@bristol.ac.uk
 Dr. Amit Kumar Bhandari=amitbhandari2@rediffmail.com
 Jayant Bhandari=contact@jayantbhandari.com
 Niyati Bhanja=niyati.eco@gmail.com
 Bhanumurthy N R=nrbmurthy@gmail.com
 Geetesh Bhardwaj=geetesh.bhardwaj@gmail.com
 Alok Bhargava=bhargava@umd.edu
 Saurabh Bhargava=sbhar@andrew.cmu.edu
 Vijay Bhasin=bvbhasin@yahoo.com
 Vijay Kumar Bhasin=vbhasin96@yahoo.com
 Jai Bhatia=jai.bhatia@oxfordbusinessalumni.org
 Kul Bhatia=kbhatia@uwo.ca
 Avinash Singh Bhati=avibhati@gmail.com
 Chandra Shekhar Bhatnagar=csbhatnagar@gmail.com
 Ramesh Bhat=rbhat@post.harvard.edu
 Aditya Bhattacharjea=aditya@econdse.org
 Arnab Bhattacharjee=a.bhattacharjee@hw.ac.uk
 Manojit Bhattacharjee=manojit850@gmail.com
 Sanjoy Bhattacharjee=bhutu1@gmail.com
 Anasua Bhattacharya=abhattacharya1@cdc.gov
 Angshuman Bhattacharya=angshubh@rediffmail.com
 Joydeep Bhattacharya=joydeep@iastate.edu
 Jyotirmoy Bhattacharya=jyotirmoy@jyotirmoy.net
 Kaushik Bhattacharya=kaushik3210@yahoo.com
 Dr Mita Bhattacharya=mita.bhattacharya@monash.edu
 Prasad Sankar Bhattacharya=prasbhat@deakin.edu.au
 Utpal Bhattacharya=ubhattac@indiana.edu
 Asish K. Bhattacharyya=asish.bhattacharyya@gmail.com
 Chandril Bhattacharyya=chandrilbhattacharyya@gmail.com
 Malay Bhattacharyya=malayb@iimb.ernet.in
 Surajit Bhattacharyya=surajit75@gmail.com
 Guna Raj Bhatta=bhatta.gunaraj@gmail.com
 Gandhi Raj Bhattarai=grbhattarai@gmail.com
 Keshab Bhattarai=k.r.bhattarai@hull.ac.uk
 Muhammad Ishaq Bhatti=i.bhatti@latrobe.edu.au
 Shiv Raj Bhatt=bhattshivraj@yahoo.com
 Vipul Bhatt=bhattvx@jmu.edu
 Sumon K. Bhaumik=s.k.bhaumik@sheffield.ac.uk
 Kornpob Bhirombhakdi=bkornpob@yahoo.com
 Haroon Bhorat=haroon.bhorat@uct.ac.za
 Manudeep Bhuller=manudeep.bhuller@ssb.no
 Amalendu Bhunia=bhunia.amalendu@gmail.com
 Samyukta Bhupatiraju=bhupatiraju@merit.unu.edu
 Mohammad Harunur Rashid Bhuyan=mohammad.bhuyan@monash.edu
 Rafiqul Bhuyan=rafiq_economics@yahoo.com
 Bianca Biagi=bbiagi@uniss.it
 Bruno R Biais=bruno.biais@univ-tlse1.fr
 Michela Bia=michela.bia@sp.unipmn.it
 Ana Maria Bianchi=amafbian@usp.br
 Carlo Luigi Bianchi=cbianchi@ec.unipi.it
 Carlos Bianchi=cbianchi@iecon.ccee.edu.uy
 Carmine Bianchi=bianchi@unipa.it
 Francesco Bianchi=francesco.bianchi@duke.edu
 Javier Bianchi=javieribianchi@gmail.com
 Milo Bianchi=milo.bianchi@dauphine.fr
 Sergio Bianchi=sbianchi@eco.unicas.it
 Sara Biancini=sara.biancini@unicaen.fr
 Antonio Bianco=bia.anto@gmail.com
 Dominique Bianco=dominique.bianco@u-bourgogne.fr
 Marcelo Bianconi=marcelo.bianconi@tufts.edu
 Claudia Biancotti=claudia.biancotti@bancaditalia.it
 Barbara Biasi=bbiasi@stanford.edu
 Costanza Biavaschi=biavaschi@iza.org
 Sami Bibi=sami.bibi@videotron.ca
 Nicolae Aurelian BIBU=nick.bibu@gmail.com
 Zorobabel Tamoué Bicaba=zorobabelbicaba@gmail.com
 David Bicchetti=david.bicchetti@unctad.org
 Frank Bickenbach=frank.bickenbach@ifw-kiel.de
 Christian BIDARD=christian.bidard@u-paris10.fr
 Prasad V. Bidarkota=bidarkot@fiu.edu
 Rhys Bidder=rhys.bidder@sf.frb.org
 Jeff E. Biddle=biddle@msu.edu
 Nicholas Biddle=nicholas.biddle@anu.edu.au
 Chris Bidner=cbidner@sfu.ca
 Katarzyna Bien-Barkowska=katarzyna.bien@sgh.waw.pl
 Manfred Alfons Bienefeld=manfred_bienefeld@carleton.ca
 Carsten Bienz=carsten.bienz@nhh.no
 Florian Michael Biermann=f.biermann@iset.ge
 Simona Bigerna=simona.bigerna@unipg.it
 Mario Biggeri=mario.biggeri@unifi.it
 Lucio Biggiero=algorithm@libero.it
 Andrew George Biggs=andrew.biggs@aei.org
 Céline Bignebat=bignebat@supagro.inra.fr
 Enrique Bigné=enrique.bigne@uv.es
 Vincent Bignon=vincent.bignon@banque-france.fr
 Maria Bigoni=maria.bigoni@unibo.it
 Arne Bigsten=arne.bigsten@economics.gu.se
 Jochen Bigus=jochen.bigus@uni-osnabrueck.de
 Huixin Bi=hbi@bankofcanada.ca
 Govert Bijwaard=bijwaard@nidi.nl
 Landry BIKAI=lbikai2002@yahoo.fr
 Jacob Bikker=j.a.bikker@dnb.nl
 Christos Bilanakos=bilanakos.christos@ucy.ac.cy
 Jesús Mario Bilbao=mbilbao@us.es
 Firat Bilgel=firat.bilgel@okan.edu.tr
 Faik Bilgili=faik-bilgili@hotmail.com
 Ozge Bilgili=ozge.bilgili@maastrichtuniversity.nl
 Mehmet Huseyin Bilgin=bilginmh@gmail.com
 Cihan Bilginsoy=bilginsoy@economics.utah.edu
 Katarzyna Anna Bilicka=katarzyna.bilicka@sbs.ox.ac.uk
 Francesco C. Billari=francesco.billari@nuffield.ox.ac.uk
 Etienne Billette de Villemeur=etienne.de-villemeur@univ-lille1.fr
 Monica Billio=billio@unive.it
 Roberto M. Billi=roberto.billi@riksbank.se
 Andreas Billmeier=andreas.billmeier@eui.eu
 Margarita Billón=margarita.billon@uam.es
 Steve Billon=steve.billon@aalto.fi
 Soniya Billore=soniyavc@rediffmail.com
 Antoine Billot=billot@u-paris2.fr
 Marc Bilodeau=mbilodea@iupui.edu
 John F. O. Bilson=john.bilson@iit.edu
 Mohammed Mehrab Bin Bakhtiar=mehrab.bakhtiar@gmail.com
 Jacek Piotr Binda=jbinda@wsfip.edu.pl
 Martin Binder=m.binder@berlin.bard.edu
 Melissa Ann Binder=mbinder@unm.edu
 Michael Binder=mbinder@wiwi.uni-frankfurt.de
 Seth Binder=binder@stolaf.edu
 Yannick Bineau=yannick.bineau@univ-lille1.fr
 Chiara Binelli=c.binelli@soton.ac.uk
 Binet=marie-estelle.binet@univ-rennes1.fr
 Mahir Binici=mahir.binici@tcmb.gov.tr
 Johannes Binswanger=j.binswanger@uvt.nl
 Mathias Binswanger=mathias.binswanger@fhnw.ch
 Hans Peter Binswanger-Mkhize=binswangerh@gmail.com
 Christine Binzel=christine.binzel@awi.uni-heidelberg.de
 Yuri Biondi=yuri.biondi@gmail.com
 Erik Biorn=erik.biorn@econ.uio.no
 Guillaume Biot-Paquerot=biot.paquerot@free.fr
 Omer Biran=omer.biran@gmail.com
 Javier A. Birchenall=jabirche@econ.ucsb.edu
 Urs W. Birchler=birchler@bf.uzh.ch
 Richard M. Bird=rbird@rotman.utoronto.ca
 Ron Bird=ron.bird@uts.edu.au
 Nancy Birdsall=nbirdsall@cgdev.org
 Daniel Birke=mail@daniel-birke.com
 Jack Birner=jack.birner@unitn.it
 Regina Birner=regina.birner@uni-hohenheim.de
 Ekin Birol=e.birol@cgiar.org
 Adriano Birolo=adriano.birolo@unipd.it
 Péter Biró=peter.biro@krtk.mta.hu
 Pratap Singh Birthal=psbirthal@ncap.res.in
 Dileep K. Birur=dbirur@rti.org
 Claudio Biscaro=claudio.biscaro@unive.it
 Gian-Italo Bischi=gian.bischi@uniurb.it
 Ivo Bischoff=bischoff@wirtschaft.uni-kassel.de
 Oliver Bischoff=obischoff@fb3.fh-frankfurt.de
 David M. Bishai=dbishai@jhsph.edu
 Monisankar Bishnu=mbishnu@isid.ac.in
 Christophe BISIÈRE=bisiere@univ-tlse1.fr
 Alberto Bisin=alberto.bisin@nyu.edu
 Marco Bisogno=mbisogno@unisa.it
 Marie-Edith Bissey=bissey@sp.unipmn.it
 Luc Bissonnette=luc.bissonnette@ecn.ulaval.ca
 Rishav Bista=bistar@marshall.edu
 Basudeb Biswas=biswas@econ.usu.edu
 Rongili Biswas=rongilibiswas@hotmail.com
 Tapan Kumar Biswas=t.k.biswas@hull.ac.uk
 Marianne P. Bitler=mbitler@uci.edu
 George C. Bitros=bitros@aueb.gr
 Vera Bitsch=bitsch@tum.de
 Gustavo Bittencourt=gustavo.bittencourt@cienciassociales.edu.uy
 Mauricio Vaz Lobo Bittencourt=mbittencourt@ufpr.br
 Aristidis P. Bitzenis=bitzenis@yahoo.com
 Jürgen Bitzer=jbitzer@uni-oldenburg.de
 David G. Bivin=dbivin@iupui.edu
 Xiang Bi=xiangbi@ufl.edu
 Carmen Bizzarri=carmen.bizzarri@gmail.com
 David James Bjerk=david.bjerk@claremontmckenna.edu
 Olav Bjerkholt=olav.bjerkholt@econ.uio.no
 Anders Bjorklund=anders.bjorklund@sofi.su.se
 Tomas Bjork=tomas.bjork@hhs.se
 Endre Jostein Bjørndal=endre.bjorndal@nhh.no
 Hilde Christiane Bjørnland=hilde.c.bjornland@bi.no
 Christian Bjørnskov=chbj@asb.dk
 Roger Bjørnstad=roger.bjornstad@samfunnsokonomisk-analyse.no
 Carl Magnus Bjuggren=carl.magnus.bjuggren@ifn.se
 Per-Olof Bjuggren=per-olof.bjuggren@jibs.hj.se
 Guillaume Blache=guillaume.blache@gmail.com
 David James Hart Blackburn=davidblackburn@gmail.com
 Keith Blackburn=keith.blackburn@man.ac.uk
 McKinley L. Blackburn=blackbrn@moore.sc.edu
 Dan Black=danblack@uchicago.edu
 Paul Blacklow=paul.blacklow@utas.edu.au
 Allen Blackman=blackman@rff.org
 Charles Blackorby=c.blackorby@warwick.ac.uk
 Sandra E. Black=sblack@austin.utexas.edu
 Calvin Blackwell=blackwellc@cofc.edu
 Melanie Ann Blackwell=mblackwe@artsci.wustl.edu
 Yury E. Blagov=blagov@gsom.pu.ru
 Adam Blake=ablake@bournemouth.ac.uk
 Andrew Peter Blake=andrew.blake@bankofengland.co.uk
 David Blake=d.blake@city.ac.uk
 Garrick Blalock=garrick.blalock@cornell.edu
 Sotiris Blanas=sotirios.blanas@uclouvain.be
 Stéphane Blancard=sblancard@dijon.inra.fr
 Emily J. Blanchard=emily.blanchard@tuck.dartmouth.edu
 michel BLANCHARD=michel.blanchard@dauphine.fr
 Olivier Blanchard=blanchar@mit.edu
 Pierre Blanchard=pierre.blanchard@u-pec.fr
 Didier BLANCHET=didier.blanchet@insee.fr
 Bertrand Blancheton=bertrand.blancheton@u-bordeaux4.fr
 David Blanchflower=david.blanchflower@dartmouth.edu
 Christian Blanco=chblancoj@gmail.com
 Emilio Fernando Blanco=emilio.blanco@bcra.gov.ar
 Mariana Blanco=mariana.blanco@urosario.edu.co
 Cristina Blanco-Perez=cristina.blanco@uib.cat
 Carl Rudolf Blankart=rudolf.blankart@wiso.uni-hamburg.de
 Charles B. Blankart=charles@blankart.net
 William Blankenau=blankenw@ksu.edu
 Jos Blank=j.l.t.blank@tudelft.nl
 Rebecca M. Blank=rblank@chancellor.wisc.edu
 Steven C. Blank=scblank@vt.edu
 Sven Blank=sven.blank@bundesbank.de
 Andrea Blasco=andrea.blasco@unibo.it
 Sylvie Blasco=sylvie.blasco@univ-lemans.fr
 Francisco A. A. Blasques=f.blasques@vu.nl
 Asher A. Blass=asher@ercg.co.il
 Christopher Blattman=chrisblattman@columbia.edu
 David Blau=blau.12@osu.edu
 Francine Blau=fdb4@cornell.edu
 Joaquin Blaum=joaquin_blaum@brown.edu
 Bogusław Bławat=boguslaw.blawat@yahoo.com
 Maite Blázquez=maite.blazquez@uam.es
 Jorge Blazquez=blazquezlidoy@telefonica.net
 Szabolcs Blazsek=sblazsek@ufm.edu
 Hoyt Bleakley=bleakley@uchicago.edu
 Robert A. Blecker=blecker@american.edu
 Thorsten Blecker=blecker@ieee.org
 Mercedes Bleda=mercedes.bleda@mbs.ac.uk
 Jason R. Blevins=jrblevin@sdf.org
 Uwe Blien=uwe.blien@iab.de
 Moussa P. Blimpo=moussa.blimpo@nyu.edu
 Christopher J.E. Bliss=christopher.bliss@nuffield.ox.ac.uk
 Francis Bloch=francis.bloch@univ-paris1.fr
 Harry Bloch=h.bloch@curtin.edu.au
 Joern H. Block=block@uni-trier.de
 Steven A. Block=steven.block@tufts.edu
 Hans Bloemen=hbloemen@feweb.vu.nl
 Jacqueline Bloemhof=jacqueline.bloemhof@wur.nl
 Andreas Blom=ablom@worldbank.org
 Stephen Brock Blomberg=bblomberg@cmc.edu
 Glenn Blomquist=gcblom@uky.edu
 Magnus Blomstrom=magnus.blomstrom@gmail.com
 Sveinbjorn Blondal=sveinbjorn.blondal@oecd.org
 Nicholas Bloom=nbloom@stanford.edu
 Chris Bloor=chris.bloor@rbnz.govt.nz
 Christophe Blot=christophe.blot@sciencespo.fr
 Max Blouin=blouin.max@uqam.ca
 Svetlana Nikolaevna Bludova=bludosveta@gmail.com
 Dmitri Blueschke=dmitri.blueschke@aau.at
 Margaret Blume-Kohout=meg@newmexicoconsortium.org
 Lawrence Blume=lb19@cornell.edu
 Christian Blümelhuber=christian@cerem.info
 Matthias Blum=matthias.blum@tum.de
 Ulrich Blum=ulrich.blum@wiwi.uni-halle.de
 Niels-Hugo Blunch=blunchn@wlu.edu
 Richard Blundell=r.blundell@ucl.ac.uk
 Juan Blyde=juanbl@iadb.org
 Robin Boadway=boadwayr@econ.queensu.ca
 Anthony Edward Boardman=anthony.boardman@sauder.ubc.ca
 Oliver James Board=ojboard@nyu.edu
 Simon Board=sboard@econ.ucla.edu
 Mircea Boari=aecrim@upcmail.ro
 Marlon G. Boarnet=boarnet@usc.edu
 Nuno Filipe França Gouveia Boavida=nunoboavida@gmail.com
 Matteo Bobba=matteob@iadb.org
 Ingo Böbel=ibobel@wanadoo.fr
 Eugenio Sebastian Antonio Bobenrieth=ebobenrieth@uc.cl
 Ana Bobirca=ana.bobirca@rei.ase.ro
 Nina Bobkova=nina.bobkova@googlemail.com
 Cristina Boboc=cristina.boboc@csie.ase.ro
 Lionel BOBOT=lionel.bobot@wanadoo.fr
 Catherine Bobtcheff=catherine.bobtcheff@univ-tlse1.fr
 Yuri Bobylev=bobylev@iet.ru
 Dorothee Boccanfuso=dorothee.boccanfuso@usherbrooke.ca
 Nicolas Boccard=nicolas.boccard@udg.edu
 Alan Ainer Boccato-Franco=alanboccato@gmail.com
 Claudiu George Bocean=boceanclaudiu@yahoo.com
 Victor Pavlovich Bocharnikov=bocharnikovvp@yandex.ru
 Olivier Bochet=olivier.bochet@vwi.unibe.ch
 Marija Bockarjova=m.bockarjova@vu.nl
 Petri Böckerman=petri.bockerman@labour.fi
 Julia Bock-Schappelwein=julia.bock-schappelwein@wifo.ac.at
 Stefan Bock=sbock@winfor.de
 Rachel BOCQUET=rachel.bocquet@univ-savoie.fr
 Philippe N.L. Bocquier=philippe.bocquier@uclouvain.be
 Eckhardt Bode=eckhardt.bode@ifw-kiel.de
 Howard Bodenhorn=bodnhrn@clemson.edu
 Zvi Bodie=zbodie@bu.edu
 Ronald G. Bodkin=rgbodkin@uottawa.ca
 Philip Bodman=p.bodman@uq.edu.au
 Olivier Body=olivier.body@gmail.com
 Jef Boeckx=jef.boeckx@nbb.be
 Frédéric Boehm=frederic.boehm@yahoo.fr
 Catherine BOEMARE=boemare@centre-cired.fr
 Tito Boeri=tito.boeri@unibocconi.it
 Kira Boerner=kira@dr-boerner.de
 Lars Boerner=l.boerner@lse.ac.uk
 Gianna Boero=gianna.boero@warwick.ac.uk
 Riccardo Boero=riccardo@lanl.gov
 Stefan Boes=stefan.boes@unilu.ch
 Stefan Boeters=s.boeters@cpb.nl
 Peter J. Boettke=pboettke@gmu.edu
 Marcello Bofondi=marcello.bofondi@bancaditalia.it
 Olga V. Bogach=olga.bogach@byu.edu
 Dan Bogart=dbogart@uci.edu
 Bogdan Bogdanov=bogdanovb@alumni.sdabocconi.it
 Marc Bogdanowicz=marc.bogdanowicz@ec.europa.eu
 Dieter Bögenhold=dieter.boegenhold@aau.at
 Zeljko Bogetic=zbogetic@worldbank.org
 Francesco Bogliacino=francesco.bogliacino@gmail.com
 Christian Bogmans=c.w.j.bogmans@vu.nl
 Martin Bøg=mbog@few.eur.nl
 Giuseppe Bognetti=giuseppe.bognetti@unimi.it
 Jane Bogoev=j.bogoev@staffs.ac.uk
 Michael Boguslavsky=michael@boguslavsky.net
 Radim Bohacek=radim.bohacek@cerge-ei.cz
 René Böheim=rene.boeheim@jku.at
 Heinrich Rudi Bohlmann=heinrich.bohlmann@up.ac.za
 Mary Elizabeth Bohman=mbohman@ers.usda.gov
 Enrico Böhme=boehme@econ.uni-frankfurt.de
 Frank Bohn=f.bohn@fm.ru.nl
 Henning Bohn=bohn@econ.ucsb.edu
 Hong Bo=hb22@soas.ac.uk
 J. Aislinn Bohren=abohren@sas.upenn.edu
 Hana Bohušová=uchana@mendelu.cz
 Mauro Boianovsky=mboianovsky@gmail.com
 John C. Boik=john.boik@principledsocietiesproject.org
 Martin Boileau=martin.boileau@colorado.edu
 Frédéric Boissay=frederic.boissay@ecb.int
 Denis BOISSIN=d.boissin@skema.edu
 Romain Boissin=rboissin@hotmail.com
 Jean-Marie Boisson=jean-marie.boisson@univ-montp1.fr
 Andrea Boitani=andrea.boitani@unicatt.it
 Jean Boivin=jboivin@bankofcanada.ca
 Rafael Boix=rafael.boix@uv.es
 Antonio N. Bojanic=antonio.bojanic@unslp.edu.bo
 Elena BOJESTEANU=elena.bojesteanu@fin.ase.ro
 Божидар Виолинов Божинов (Bojidar Violinov Bojinov)=bobi@uni-svishtov.bg
 Farasat A.S. Bokhari=f.bokhari@uea.ac.uk
 Madhavi Bokil=madhavi.bokil@moodys.com
 Fanwell Fredrick Kenala Bokosi=fanwell@afrodad.co.zw
 Raushan Bokusheva=bokushev@ethz.ch
 Lawrence A. Boland=boland@sfu.ca
 Michael A. Boland=boland@umn.edu
 Rodrigo Alberto Bolaños=bolanosr@yahoo.com
 Bogdan Ion BOLDEA=bogdan.boldea@feaa.uvt.ro
 Otilia Boldea=o.boldea@uvt.nl
 Francesco Boldizzoni=francesco.boldizzoni@unito.it
 Michele Boldrin=mboldrin@artsci.wustl.edu
 Francois Boldron=francois.boldron@labanquepostale.fr
 Denis Bolduc=denis.bolduc@ecn.ulaval.ca
 Ivan A. Boldyrev=iboldyrev@hse.ru
 Kristian Bolin=kristian.bolin@economics.gu.se
 Valter Boljunčić=vbolj@unipu.hr
 Christina Boll=boll@hwwi.org
 Johannes Bollen=jcb@cpb.nl
 Tim Bollerslev=boller@duke.edu
 Carlo Andrea Bollino=carloandrea.bollino@unipg.it
 Thomas Bolli=bolli@alumni.ethz.ch
 Pierluigi Bologna=pierluigi.bologna@bancaditalia.it
 Ilya Bolotov=ilya.bolotov@gmail.com
 Gary E. Bolton=gbolton@utdallas.edu
 Wilko Bolt=w.bolt@dnb.nl
 Anders Boman=anders.boman@economics.gu.se
 Nebojsa Bomestar=nbomestar@live.com
 Pedro Duarte Bom=p.r.duartebom@gmail.com
 Olivier P. Bomsel=bomsel@ensmp.fr
 Adrien BONACHE=adriens_cachan@yahoo.fr
 Carmen Giorgiana Bonaci=carmen.bonaci@econ.ubbcluj.ro
 Federico Bonaglia=federico.bonaglia@oecd.org
 Jean Pietro Bonaldi=bonaldi@uchicago.edu
 Jacopo Bonan=j.bonan@campus.unimib.it
 Giacomo Bonanno=gfbonanno@ucdavis.edu
 Graziella Bonanno=graziella.bonanno@unical.it
 Jean-Philippe Bonardi=jean-philippe.bonardi@unil.ch
 Mariangela Bonasia=mariangela.bonasia@uniparthenope.it
 Leo Bonato=lbonato@imf.org
 Luigi Bonaventura=lbonaventura@lex.unict.it
 Leonardo Boncinelli=l.boncinelli@ec.unipi.it
 Валентина Михайловна Бондаренко (Valentina Mikhailovna Bondarenko)=bondarenko@inecon.ru
 Anton A. Bondarev=abondarev@wiwi.uni-bielefeld.de
 Derek Bond=d.bond@ulster.ac.uk
 Eric W. Bond=eric.bond@vanderbilt.edu
 Maria-Daniela Bondoc=daniela.bondoc@upit.ro
 Daniele Bondonio=daniele.bondonio@sp.unipmn.it
 Steven Bond-Smith=sbondsmith@gmail.com
 Aurélie Bonein=aurelie.bonein@univ-rennes1.fr
 Sara Bonesso=bonesso@unive.it
 Dominique Bonet Fernandez=dominique.bonet-fernandez@ipag.fr
 Jaime Alfredo Bonet=jbonetmo@banrep.gov.co
 Roberto Bonfatti=roberto.bonfatti@nottingham.ac.uk
 Alessandra Bonfiglioli=alessandra.bonfiglioli@upf.edu
 Diana Bonfim=dbonfim@bportugal.pt
 Lumengo Bonga-Bonga=lbonga@uj.ac.za
 Annette Bongardt=annette.bongardt@eui.eu
 Paola Agnese Bongini=paola.bongini@unimib.it
 Carl S Bonham=bonham@hawaii.edu
 Stéphane Bonhomme=bonhomme@cemfi.es
 Jose Luis Bonifaz, Sr.=jbonifaz@up.edu.pe
 Andrea Gabriela Bonilla Bolaños=bonilla@gate.cnrs.fr
 Claudio Bonilla=cbonilla@fen.uchile.cl
 Leonardo Bonilla Mejia=leonardobonilla84@gmail.com
 Roberto Bonilla=roberto.bonilla@ncl.ac.uk
 Holger Bonin=bonin@zew.de
 Hubert Bonin=h.bonin@sciencespobordeaux.fr
 Stefano Bonini=stefano.bonini@unibocconi.it
 Peter Bönisch=peter.boenisch@wiwi.uni-halle.de
 Jens Bonke=jb@rff.dk
 Timm Bönke=timm.boenke@fu-berlin.de
 Antoine Bonleu=antoine.bonleu@hotmail.fr
 Michaël Bonnal=michael-bonnal@utc.edu
 Pierre A. Bonnal=pierre.bonnal@cern.ch
 Patrick BONNEL=patrick.bonnel@entpe.fr
 Clemens Bonner=c.bonner@dnb.nl
 carole Bonnet=carole.bonnet@ined.fr
 Jean Bonnet=jean.bonnet@unicaen.fr
 Jean-Marc BONNISSEAU=jean-marc.bonnisseau@univ-paris1.fr
 Sylvie BONNY=bonny@grignon.inra.fr
 Giovanni Bono=giovanni.bono.70@gmail.com
 James W. Bono=jwbono@gmail.com
 Paolo Bonomolo=paolo.bonomolo@riksbank.se
 Marco Bonomo=bonomo@fgv.br
 Morrison M. Bonpasse=morrison@singleglobalcurrency.org
 Roberta Bon=roberta.bon@unimi.it
 Olivier Bonroy=olivier.bonroy@grenoble.inra.fr
 Maria Elena Bontempi=mariaelena.bontempi@unibo.it
 Christian Bontemps=christian.bontemps@tse-fr.eu
 Christophe Bontemps=christophe.bontemps@toulouse.inra.fr
 Werner Bönte=boente@wiwi.uni-wuppertal.de
 Bernhard Boockmann=bernhard.boockmann@iaw.edu
 Nina Boogen=nboogen@ethz.ch
 James F. Booker=jbooker@siena.edu
 Jeff Bookwalter=jeff.bookwalter@mso.umt.edu
 Anette Boom=ab.eco@cbs.dk
 Laurence Boone=lau_boone@yahoo.fr
 Arnoud Boot=a.w.a.boot@uva.nl
 Alison Booth=alison.booth@anu.edu.au
 Eric A Booth=ebooth@ppri.tamu.edu
 Philip Booth=pbooth@iea.org.uk
 Timo Boppart=timo.boppart@iies.su.se
 Yari Borbon-Galvez=yari_borbon@yahoo.com
 Rainald Borck=rainald.borck@uni-potsdam.de
 Patrice Borda=patrice.borda@univ-ag.fr
 Ovidiu Niculae Bordean=ovidiu.bordean@econ.ubbcluj.ro
 Michael David Bordo=bordo@econ.rutgers.edu
 Severin Borenstein=borenste@haas.berkeley.edu
 Scott C. Borger=scottborger@gmail.com
 Tilman Börgers=tborgers@umich.edu
 Tobias Börger=tobo@pml.ac.uk
 Ana Pinto Borges=aborges@por.ulusiada.pt
 Maria Rosa Borges=mrborges@iseg.utl.pt
 Simone Borghesi=simone.borghesi@unisi.it
 Elisa Borghi=eborghi@liuc.it
 Riccardo Borgoni=riccardo.borgoni@unimib.it
 Dino BORIE=dino.borie@gredeg.cnrs.fr
 Anne Boring=anne.boring@sciencespo.fr
 Claudio BORIO=claudio.borio@bis.org
 Tatiana Borisova=tborisova@ufl.edu
 Kirill Borissov=kirill@eu.spb.ru
 George Borjas=gborjas@harvard.edu
 Surajit Borkotokey=surajitbor@yahoo.com
 Jeff Borland=jib@unimelb.edu.au
 Andrea Borlizzi=borlizzi@email.arizona.edu
 Michael Bormotov=mbormotov@gmail.com
 Peter Borm=pemborm@uvt.nl
 Fabian Bornhorst=fbornhorst@imf.org
 Kateryna Bornukova=kateryna.bornukova@gmail.com
 Peter Janos Borocz=boroczp@sze.hu
 Vani Borooah=vk.borooah@ulster.ac.uk
 Jaroslav Borovička=jaroslav.borovicka@nyu.edu
 Karol Jan Borowiecki=kjb@sam.sdu.dk
 Jakub Borowski=jakub_borowski@poczta.onet.pl
 Ricardo Bórquez=rborquec@uc.cl
 Cristina Borra=cborra@us.es
 Fernando Borraz=fborraz@bcu.gub.uy
 Joan-Ramon Borrell=jrborrell@ub.edu
 Jörg Borrmann=joerg.borrmann@univie.ac.at
 Mihály Tamás Borsi=borsimihaly@ua.es
 Jethro Borsje=research@jborsje.nl
 Stefan Borsky=stbo@sam.sdu.dk
 Francesca Bortolami=fbortolami@ucn.cl
 Bernardo Bortolotti=bortolotti@feem.it
 Stefania Bortolotti=stefania.bortolotti@unibo.it
 Flavio Boscacci=flavio.boscacci@polimi.it
 José Emilio Boscá=jose.e.bosca@uv.es
 Charles Bos=c.s.bos@vu.nl
 Melisso Boschi=meli.boschi@gmail.com
 Mariano Bosch=mbosch@iadb.org
 Luigi Bosco=bosco@unisi.it
 Maria Giovanna Bosco=mariagiovanna.bosco@unibocconi.it
 Arup Bose=bosearu@gmail.com
 Niloy Bose=nbose@uwm.edu
 Simon Halphen Boserup=simon.h.boserup@econ.ku.dk
 Subir Bose=subir.bose@le.ac.uk
 Valentina Bosetti=valentina.bosetti@feem.it
 Frits Bos=f.bos@cpb.nl
 Venelin Boshnakov=venelinb@unwe.bg
 Willem H. Boshoff=wimpie2@sun.ac.za
 Giulio Bosio=giulio.bosio@unimi.it
 Maarten Bosker=bosker@ese.eur.nl
 Predrag Boskovic=ministar.mrss@mrss.gov.me
 Niels Bosma=n.s.bosma@uu.nl
 Clement Bosquet=c.bosquet@lse.ac.uk
 Peter L. Bossaerts=pbs@rioja.caltech.edu
 Walter Bossert=walter.bossert@umontreal.ca
 Andrew Bossie=andrew.a.bossie@gmail.com
 Luca Bossi=boluca@econ.upenn.edu
 Ionel Bostan=ionel_bostan@yahoo.com
 Maria Bostenaru Dan=maria.bostenaru-dan@alumni.uni-karlsruhe.de
 H. Peter Boswijk=h.p.boswijk@uva.nl
 Barry P. Bosworth=bbosworth@brookings.edu
 Marius Bota=marius.bota@tbs.ubbcluj.ro
 Lucian Botea=lucian.botea@rau.ro
 Jesus Botero=jabotero@eafit.edu.co
 Ferdi Botha=f.botha@ru.ac.za
 Valerija Botric=vbotric@eizg.hr
 Nicolas Luis Bottan=bottan2@illinois.edu
 Anna Bottasso=bottasso@economia.unige.it
 Giulio Bottazzi=bottazzi@sssup.it
 Laura Bottazzi=bottazzi@unibocconi.it
 Lucie Bottega=lucie.bottega@tse-fr.eu
 Fabrizio Botti=fabrizio.botti@unipg.it
 Karima BOUAISS=karima.bouaiss@univ-tours.fr
 Hafedh Bouakez=hafedh.bouakez@hec.ca
 Imen Bouallegui=imen_bou2001@yahoo.fr
 Salima Bouayad-Agha-Hamouche=salima.bouayad-agha@univ-lemans.fr
 Zied Bouaziz=ziedbouazi@yahoo.fr
 Sabri Boubaker=sabri.boubaker@get-mail.fr
 Olivier Bouba-Olga=obouba@univ-poitiers.fr
 Raouf Boucekkine=raouf.boucekkine@univ-amu.fr
 Pier-André Bouchard St-Amant=web@pabsta.qc.ca
 Christophe Boucher=christophe.boucher@univ-lorraine.fr
 Vincent Boucher=vincent.boucher@ecn.ulaval.ca
 Brahim Boudarbat=brahim.boudarbat@umontreal.ca
 Chahnez Boudaya=boudaya@univ-paris1.fr
 Fabienne Boudier=fabienne.boudier@u-pec.fr
 James W. Boudreau=boudreaujw@utpa.edu
 Maxim Bouev=mbouev@eu.spb.ru
 Patrice Bougette=patrice.bougette@gmail.com
 Spiros Bougheas=spiros.bougheas@nottingham.ac.uk
 Douadia Bougherara=douadia.bougherara@supagro.inra.fr
 Duncan H. Boughton=boughton@msu.edu
 Zouhair Bouhsina=bouhsina@supagro.inra.fr
 Cesar Patricio Bouillon=cesarb@iadb.org
 Nabila Boukef Jlassi=nabila.boukef-jlassi@etu.univ-orleans.fr
 Rafik Bouklia-Hassane=rbouklia_hassane@yahoo.fr
 Catherine A. Boulatoff broadhead=boulatoff@dal.ca
 Jacques BOULAY=jacques.boulay@essca.fr
 Béatrice Boulu-Reshef=boulu-reshefb@virginia.edu
 Marcel Boumans=m.j.boumans@uva.nl
 Kene Boun My=bounmy@unistra.fr
 Jamal Bouoiyour=jamal.bouoiyour@univ-pau.fr
 Taoufik BOURAOUI=taoufik.bouraoui@esc-rennes.fr
 Steven C. Bourassa=steven.bourassa@louisville.edu
 Lise Bourdeau-Lepage=lblepage@gmail.com
 Françoise Bourdon=francoise.bourdon@u-bourgogne.fr
 Jean Bourdon=jbourdon@u-bourgogne.fr
 Enrique Alberto Bour=enrique@fiel.org.ar
 Jean-Marc Bourgeon=bourgeon@agroparistech.fr
 Yann Bourgueil=bourgueil@irdes.fr
 Sylvain Bourjade=s.bourjade@esc-toulouse.fr
 Renaud Bourlès=renaud.bourles@centrale-marseille.fr
 Ioannis Bournakis=i.bournakis@mdx.ac.uk
 Marc Bourreau=marc.bourreau@enst.fr
 Alain Bousquet=alain.bousquet@univ-tours.fr
 Jihene Bousrih=jihen.bousrih@gmail.com
 Jean-Marc BOUSSARD=jean-marc.boussard@laposte.net
 Jocelyn Boussard=jocelyn.boussard@gmail.com
 Jean-Philippe Boussemart=jp.boussemart@ieseg.fr
 Leah Platt Boustan=lboustan@econ.ucla.edu
 Michel Boutillier=michel.boutillier@u-paris10.fr
 François Boutin-Dufresne=fboutin_dufresne@hotmail.com
 Laurent Bouton=boutonllj@gmail.com
 Vincent Bouvatier=vbouvatier@u-paris10.fr
 Antoine Bouveret=antoine.bouveret@ofce.sciences-po.fr
 Laurens Bouwer=laurens.bouwer@deltares.nl
 Christa H.S. Bouwman=christa.bouwman@case.edu
 Sylvain Bouyon=sylvain.bouyon@ceps.eu
 Denis Bouyssou=bouyssou@lamsade.dauphine.fr
 Mohamed Bouzahzah=mobouzahzah@gmail.com
 Salim BOUZEBDA=salim.bouzebda@utc.fr
 Houssam Bouzgarrou=h.bouzgarrou@hotmail.fr
 Bechir Bouzid=bechirbouzid@gmail.com
 Tony Bovaird=tonybovaird@hotmail.com
 A.L.Bovenberg=a.l.bovenberg@uvt.nl
 Olympia Bover=bover@bde.es
 Maurizio Bovi=mbovi@istat.it
 Mark P. Bowden=mbowden@swin.edu.au
 Sue Bowden=sb522@york.ac.uk
 Christopher Bowdler=christopher.bowdler@economics.ox.ac.uk
 Harry P. Bowen=bowenh@queens.edu
 Jake Bowers=jwbowers@illinois.edu
 Audra J. Bowlus=abowlus@uwo.ca
 Chad P. Bown=chad.p.bown@gmail.com
 Clive Bowsher=c.bowsher@bristol.ac.uk
 Christophe Boya-Musitelli=cboyagui@univ-montp1.fr
 Svetlana Boyarchenko=sboyarch@eco.utexas.edu
 Dmitriy Boyarkin=boyarkin@bk.ru
 Derick Boyd=derickboyd@gmail.com
 James W. Boyd=boyd@rff.org
 John H. Boyd, III=boydj@fiu.edu
 Marcel Boyer=marcel.boyer@umontreal.ca
 M. Martin Boyer=martin.boyer@hec.ca
 Richard Boylan=rboylan@rice.edu
 Olivier Boylaud=olivier_boylaud@yahoo.fr
 Gerard Eugene Boyle=gerry.boyle@teagasc.ie
 Glenn Boyle=glenn.boyle@canterbury.ac.nz
 Barry Bozeman=bbozeman@uga.edu
 Emine Boz=eboz@imf.org
 Ant Bozkaya=bozkaya@mit.edu
 Nils Braakmann=nils.braakmann@ncl.ac.uk
 Enrico Bracci=enrico.bracci@unife.it
 Emanuele Bracco=e.bracco@lancaster.ac.uk
 Matthias Brachert=matthias.brachert@iwh-halle.de
 Tanguy Brachet=tbrachet@cal.berkeley.edu
 Juergen Bracht=juergenbracht@gmail.com
 Philippe Bracke=p.bracke@lse.ac.uk
 Frederique Bracoud=f.bracoud@economics.uq.edu.au
 Josef C. Brada=josef.brada@asu.edu
 Bruce William Bradbury=b.bradbury@unsw.edu.au
 Mathew B. Bradbury=mathew.bradbury@gmail.com
 Derek L. Braddon=derek.braddon@uwe.ac.uk
 Scott Bradford=bradford@byu.edu
 W. David Bradford=bradfowd@uga.edu
 Elizabeth Suzanne Bradley=elizabeth.s.bradley@gmail.com
 John Bradley=john.bradley@iol.ie
 Steven W. Bradley=steve_bradley@baylor.edu
 Ryan R. Brady=rbrady@usna.edu
 Ailton Braga=abraga@senado.gov.br
 Michela Braga=michela.braga@unimi.it
 Viorina Braga, Sr.=viobraga@yahoo.com
 Iver Bragelien=iver.bragelien@nhh.no
 Fabio Braggion=f.braggion@uvt.nl
 Zacharias Bragoudakis=zabrag@yahoo.com
 Serguey Braguinsky=sbrag@andrew.cmu.edu
 Luis H. B. Braido=lbraido@fgv.br
 Peghe (Chrissopighi) Braila=peghe.braila@ec.europa.eu
 Jeanine Braithwaite=jdb6bc@virginia.edu
 Steven Brakman=s.brakman@rug.nl
 Carlos Brambila=carlos.brambila@itesm.mx
 Carlo Brambilla=carlo.brambilla@uninsubria.it
 Irene Brambilla=irene.brambilla@gmail.com
 Yann Bramoullé=ybramoulle@ecn.ulaval.ca
 Jens-Martin Bramsen=jensm@foi.dk
 Steven J. Brams=steven.brams@nyu.edu
 Pablo Brañas-Garza=pbg@ugr.es
 Sophie Brana=sophie.brana@u-bordeaux.fr
 Emiliano Brancaccio=emiliano.brancaccio@unisannio.it
 Giacomo Branca=branca@unitus.it
 Emanuele Brancati=ebrancati@luiss.it
 Raffaele Brancati=r.brancati@met-economia.it
 William A. Branch=wbranch@uci.edu
 Amélia Branco=ameliab@iseg.ulisboa.pt
 Martin Branda=branda@karlin.mff.cuni.cz
 Jose Brandão de Brito=jose.brandaobrito@millenniumbcp.pt
 Luis Brandao Marques=lmarques@imf.org
 Claudiu BRANDAS=claudiu.brandas@feaa.uvt.ro
 Lina Isabel Brand=librand@unal.edu.co
 Leif Brandes=leif.brandes@business.uzh.ch
 Henk J.E.M. Brand=henk.brand@yahoo.com
 Vinicius Ratton Brandi=vinicius.brandi@gmail.com
 Tobias Brändle=tobias.braendle@iaw.edu
 Andrea Brandolini=andrea.brandolini@bancaditalia.it
 Olivier Brandouy=olivier.brandouy@u-bordeaux4.fr
 Loren Brandt=brandt@chass.utoronto.ca
 Michael Brandt=brandtm@wharton.upenn.edu
 Sylvia Brandt=brandt@resecon.umass.edu
 Urs Steiner Brandt, Sr.=usb@sam.sdu.dk
 Florina Bran=florinabran@yahoo.com
 Kurt Brännäs=kurt.brannas@econ.umu.se
 Lance Brannman=lbrannma@yahoo.com
 David Brasington=david.brasington@uc.edu
 Iulian Viorel Brasoveanu=viorel_brasoveanu@yahoo.com
 Aloysius Gunadi Brata=aloy.gb@gmail.com
 Espen Bratberg=espen.bratberg@econ.uib.no
 Bernt Bratsberg=bernt.bratsberg@frisch.uio.no
 George John Bratsiotis=george.bratsiotis@manchester.ac.uk
 Massimiliano Bratti=massimiliano.bratti@unimi.it
 Jurgen Brauer=jbrauer@gru.edu
 Christoph Braun=christoph.braun@tu-dortmund.de
 Pontus Brodde Braunerhjelm=pontus.braunerhjelm@indek.kth.se
 Jennifer L N Brauner=jbrauner@ems.bbk.ac.uk
 Frauke Gabriele Braun=fraukebraun@gmail.com
 Michael Bräuninger=braeuninger@hwwi.org
 Matias Braun=matias.braun@uai.cl
 Phillip A. Braun=phillip-braun@kellogg.northwestern.edu
 R. Anton Braun=r.anton.braun@gmail.com
 Sebastian Braun=sebastian.braun@ifw-kiel.de
 Elissa Braunstein=elissa.braunstein@colostate.edu
 Rinaldo Brau=brau@unica.it
 Hans-Ulrich Brautzsch=ulrich.brautzsch@iwh-halle.de
 Francesco Bravo=francesco.bravo@york.ac.uk
 Jorge Miguel Bravo=jbravo@uevora.pt
 Claudio Bravo-Ortega=clbravo@econ.uchile.cl
 Adriana Breaban=breaban@uji.es
 Dorothée Brécard=dorothee.brecard@univ-tln.fr
 Emanuele Breda=emanuele.breda@bancaditalia.it
 Thomas Breda=thomas.breda@ens.fr
 Christian Bredemeier=bredemeier@wiso.uni-koeln.de
 Don Bredin=don.bredin@ucd.ie
 Julia Bredtmann=julia.bredtmann@rwi-essen.de
 Francis Breedon=f.breedon@qmul.ac.uk
 Stefan Brehm=stefan.brehm@ace.lu.se
 Philipp Breidenbach=breidenbach@rwi-essen.de
 Pavel Breinek=breinek@node.mendelu.cz
 Clemens Breisinger=c.breisinger@cgiar.org
 Marthinus Christoffel Breitenbach=martin.breitenbach@up.ac.za
 Andreas Breitenfellner=andreas.breitenfellner@ec.europa.eu
 Yves Breitmoser=yves.breitmoser@hu-berlin.de
 Michael H. Breitner=breitner@iwi.uni-hannover.de
 Heiko Breitsohl=breitsohl@wiwi.uni-wuppertal.de
 Jörg Breitung=breitung@uni-bonn.de
 Kurt Richard Brekke=kurt.brekke@nhh.no
 Dipl.-Kfm. Prof. Dr. rer. pol. Alexander Brem=brem@idee-innovation.de
 Elenka Brenna=elenka.brenna@unicatt.it
 Niamh M. Brennan=niamh.brennan@ucd.ie
 Jan Brenner=kassenboehmer@rwi-essen.de
 Thomas Brenner=brenner@innopoli.de
 Robert John Brent=brent@fordham.edu
 Stefano Breschi=stefano.breschi@unibocconi.it
 Timothy Bresnahan=tbres@stanford.edu
 Aureliano Angel Bressan=bressan@face.ufmg.br
 Luiz Carlos Bresser-Pereira=bresserpereira@gmail.com
 Florent Bresson=florent.bresson@udamail.fr
 Georges BRESSON=bresson-georges@orange.fr
 Breton Albert=albert@albertbreton.com
 Francisco Díaz-Bretones=fdiazb@ugr.es
 Theodore Richard Breton=tbreton@eafit.edu.co
 Stuart Bretschneider=sibretsc@maxwell.syr.edu
 Craig Brett=cbrett@mta.ca
 Adela Breuer=adela1209@yahoo.com
 Janice Boucher Breuer=boucher@moore.sc.edu
 Marie-Laure Breuillé=breuille@dijon.inra.fr
 Robert Vincent Breunig=robert.breunig@anu.edu.au
 Trevor Breusch=trevor.breusch@anu.edu.au
 Fritz Breuss=fritz.breuss@wifo.ac.at
 Anthony Brewer=a.brewer@bristol.ac.uk
 Mike Brewer=mbrewer@essex.ac.uk
 Chris Brewster=c.j.brewster@henley.reading.ac.uk
 Friedrich Breyer=friedrich.breyer@uni-konstanz.de
 Arjana Brezigar Masten=arjanabm@gmail.com
 Elise S. Brezis=elise.brezis@biu.ac.il
 Damien Bricard=damien.bricard@dauphine.fr
 Hernán Ricardo Briceño Avalos=hrbricenoa@hotmail.com
 Sorin Briciu=briciusorin@gmail.com
 Jean-Charles Bricongne=jean-charles.bricongne@banque-france.fr
 Juan Gabriel Brida=juangabriel.brida@unibz.it
 Benjamin Bridgman=benjamin.bridgman@bea.gov
 Visvaldis A. Briedis=vbriedis@lanet.lv
 Mircea Brie=mirceabrie@gmail.com
 Marie Brière=marie.briere@amundi.com
 Jason Briggeman=jason.briggeman@gmail.com
 Paola Brighi=paola.brighi@unibo.it
 Damiano Brigo=damiano.brigo@gmail.com
 Povilas Brilius=povilas@baifoteka.com
 Alex Brill=alex.brill@aei.org
 David Brillinger=brill@stat.berkeley.edu
 Ylenia Brilli=ylenia.brilli@eui.eu
 Pedro Miguel Soares Brinca=pedro.brinca@ne.su.se
 Lars Brink=brinkla@hotmail.com
 Roehlano Briones=roehlbriones@yahoo.com
 Sébastien Brion=sbrio@univ-savoie.fr
 Maria Sole Brioschi=brioschi@unibg.it
 Anahi Eugenia Briozzo=abriozzo@gmail.com
 Francesco Bripi=francesco.bripi@bancaditalia.it
 Ferri Briquet=ferri.briquet@univ-nancy2.fr
 Neil Brisley=nbrisley@uwaterloo.ca
 Nicolas Brisset=nicolas.brisset@unil.ch
 Sophocles N. Brissimis=sofbris@unipi.gr
 Paulo B. Brito=pbrito@iseg.utl.pt
 Ricardo Dias Brito=ricardodob@insper.edu.br
 Hana Polackova Brixi=hbrixi@worldbank.org
 Zuzana Brixiova=z.brixiova@afdb.org
 Udo Brixy=udo.brixy@iab.de
 Maurizio Brizzi=maurizio.brizzi@unibo.it
 Stephen Broadberry=s.n.broadberry@lse.ac.uk
 David C. Broadstock=davidbroadstock@swufe.edu.cn
 Pierre Roy Brochu=pbrochu@uottawa.ca
 Ellen Brock=ellenarun@gmail.com
 Thibault Brodaty=thibault.brodaty@u-pec.fr
 Lisbeth Brøde=lbr@sam.sdu.dk
 Abraham Albert BRODER=abroder@club-internet.fr
 Abel Brodeur=abel.brodeur@psemail.eu
 Tomasz Brodzicki=t.brodzicki@ug.edu.pl
 Stijn Broecke=stijn.broecke@oecd.org
 Tom Broekel=broekel@wigeo.uni-hannover.de
 Peter Broer=d.p.broer@uvt.nl
 Athos Brogi=athos.brogi@unicredit.eu
 Fernanda Brollo=fernanda.brollo@gmail.com
 Udo Broll=udo.broll@mailbox.tu-dresden.de
 Stephen G. Bronars=sbronars@welchcon.com
 Javier Bronfman=javier.bronfman@uai.cl
 Martijn Reinout Eelco Brons=martijnbrons@yahoo.com
 Otto Brøns-Petersen=otto@cepos.dk
 Raffaello Bronzini=raffaello.bronzini@bancaditalia.it
 Andrew Michael Brooks=abrook6@emory.edu
 Bradley W. Brooks=brooksb@queens.edu
 Michael A. Brooks=michael.brooks@utas.edu.au
 Peter Brooks=peter.brooks@barclaysasia.com
 Robert Brooks=rbrooks@cba.ua.edu
 Wyatt James Brooks=wyattjbrooks@gmail.com
 John Broome=john.broome@philosophy.ox.ac.uk
 Simon Broome=simon.j.broome@nuim.ie
 Catherine Bros=catherine.bros-bobin@univ-mlv.fr
 Stephan Brosig=brosig@iamo.de
 Olivier Brossard=olivier.brossard@univ-tlse1.fr
 Carmen Broto=carmen.broto@bde.es
 Daniel Brou=dbrou@uwo.ca
 Eric Brouillat=eric.brouillat@u-bordeaux4.fr
 John Paul Broussard=john.broussard@rutgers.edu
 Eric Brousseau=eric@brousseau.info
 Damien Broussolle=damien.broussolle@unistra.fr
 Erik Brouwer=e.brouwer@uvt.nl
 Maria Brouwer=mariabrouwer251@msn.com
 Werner B.F. Brouwer=brouwer@bmg.eur.nl
 Alexander Lindale Brown=abrown@econmail.tamu.edu
 Cheryl Brown=cheryl.brown@mail.wvu.edu
 Christine Ann Brown=christine.brown@monash.edu
 Donald Brown=donald.brown@yale.edu
 Drusilla K. Brown=drusilla.brown@tufts.edu
 Heather Wendy Brown=heather.brown@ncl.ac.uk
 Henry Shelton Brown, III=h.shelton.brown@uth.tmc.edu
 James R. Brown=jrbrown@iastate.edu
 Jason P. Brown=jason.brown@kc.frb.org
 J. David Brown=j.david.brown@census.gov
 Jeffrey Robert Brown=brownjr@illinois.edu
 Kenneth Brown=ken.brown@uni.edu
 Kym Brown=kym.brown@monash.edu
 Laura K. Brown=lbrown@cc.umanitoba.ca
 Christian T. Brownlees=christian.brownlees@upf.edu
 Martin Brown=martin.brown@unisg.ch
 M. Gordon Brown=spacemg@gmail.com
 Richard P.C. Brown=r.brown@economics.uq.edu.au
 Sarah Brown=sarah.brown@sheffield.ac.uk
 Sebastian A. Brown=sebastian.brown@post.harvard.edu
 Stephen J. Brown=sbrown@stern.nyu.edu
 Tristan R. Brown=trb6c4@iastate.edu
 William Arthur Brown=william.brown@econ.cam.ac.uk
 William Mark Brown=mark.brown@statcan.gc.ca
 Géraldine BROYE=geraldine.broye@unistra.fr
 Tanja Broz=tbroz@eizg.hr
 Christopher Bruce=cjbruce@ucalgary.ca
 Donald Bruce=dbruce@utk.edu
 Pierre-Alain Bruchez=pierre-alain.bruchez@efv.admin.ch
 Herbert Brücker=herbert.bruecker@iab.de
 Markus Brückner=ecsbm@nus.edu.sg
 Jan K. Brueckner=jkbrueck@uci.edu
 Bjoern A. Bruegemann=b.a.brugemann@vu.nl
 Esther Bruegger=esther.bruegger@nera.com
 Ralf Brüggemann=ralf.brueggemann@uni-konstanz.de
 Agar Brugiavini=brugiavi@unive.it
 Jan Bruha=jan_bruha@yahoo.co.uk
 Adrian Bruhin=adrian.bruhin@unil.ch
 Miriam Bruhn=mbruhn@worldbank.org
 Ramona Bruhns=ramona@bruhns.info
 Pieter de Bruijn=p_de_bruijn@hotmail.com
 W. Allard Bruinshoofd=w.a.bruinshoofd@rn.rabobank.nl
 Franck Brulhart=franck.brulhart@univ-amu.fr
 Matias Brum=m.brum@qmul.ac.uk
 Harold J. Brumm=brummh@gao.gov
 Peter Brummund=peter.brummund@ua.edu
 Ethel Brundin=ethel.brundin@jibs.hj.se
 Joel Bruneau=joel.bruneau@usask.ca
 Julien Brunel=julien.brunel@let.ish-lyon.cnrs.fr
 Sandro Brunelli=brunelli@economia.uniroma2.it
 Giorgio Brunello=giorgio.brunello@unipd.it
 Carole Brunet=carole.brunet@univ-paris8.fr
 Celso Brunetti=celso.brunetti@frb.gov
 Marianna Brunetti=marianna.brunetti@uniroma2.it
 Andreas Brunhart=economics@brunhart.com
 Luigino Bruni=l.bruni@lumsa.it
 Michele Bruni=boromir_bm@libero.it
 Renato Bruni=bruni@dis.uniroma1.it
 Jean François Brun=j-f.brun@u-clermont1.fr
 Jürgen Brünjes=bruenjes@wigeo.uni-hannover.de
 Allan D. Brunner=allan_brunner@yahoo.com
 Daniel Brunner=brunner@wiwi.uni-marburg.de
 Eric J. Brunner=eric.brunner@uconn.edu
 Johann Brunner=johann.brunner@jku.at
 Markus K. Brunnermeier=markus@princeton.edu
 Christa N. Brunnschweiler=christa.brunnschweiler@ntnu.no
 Bruna Bruno=brbruna@unisa.it
 Giancarlo Bruno=giancarlo.bruno@istat.it
 Giovanni S.F. Bruno=giovanni.bruno@unibocconi.it
 Giuseppe Bruno=giuseppe.bruno@bancaditalia.it
 Randolph Luca Bruno=randolph.bruno@ucl.ac.uk
 Christian Bruns=cbruns@gwdg.de
 Tor Brunzell=tb@fek.su.se
 Viola Bruschi=bruschi@iamo.de
 Stefano Brusoni=sbrusoni@ethz.ch
 Xavier Brusset=xavier@brusset.fr
 Lisa V. Bruttel=lisa.bruttel@uni-konstanz.de
 Filippo Brutti=filippo.brutti@econ.uzh.ch
 Charlotte Bruun=bruun.charlotte@gmail.com
 Annegrete Bruvoll=agb@ssb.no
 Joanna Bruzda=joanna.bruzda@uni.torun.pl
 Gustaf Bruze=gbruze@econ.au.dk
 Aurelio Bruzzo=aurelio.bruzzo@unife.it
 Mark L Bryan=markb@essex.ac.uk
 Damon U Bryant=damonbry@gmail.com
 John Bryant=john.bryant@vocat.co.uk
 John Bryant=john.r.bryant@gmail.com
 William David Anthony Bryant=tbryant@efs.mq.edu.au
 Alex Bryson=a.bryson@niesr.ac.uk
 Janusz J. Brzeszczynski=janusz.brzeszczynski@northumbria.ac.uk
 Michał Brzeziński=mbrzezinski@wne.uw.edu.pl
 Michael Brzoska=brzoska@ifsh.de
 Michał Brzozowski=brzozowski@wne.uw.edu.pl
 Rachna Bsnerjee=dr.rachnab@gmail.com
 Daniela Bubboloni=daniela.bubboloni@dmd.unifi.it
 Elisabeth Bublitz=bublitz@hwwi.org
 Domenico Buccella=buccella@kozminski.edu.pl
 Alberto Bucci=alberto.bucci@unimi.it
 Alessandro Bucciol=alessandro.bucciol@univr.it
 Berno Büchel=berno.buechel@wiso.uni-hamburg.de
 Anne Bucher=anne.bucher@unistra.fr
 Raphael Bucher=raphbucher@bluewin.ch
 Wolfgang Buchholz=wolfgang.buchholz@ur.de
 Moshe Buchinsky=buchinsky@econ.ucla.edu
 Thomas Buchmueller=tbuch@umich.edu
 Charlotte I.R. Büchner=buechner@dipf.de
 Thierry Buchs=thierry.buchs@eda.admin.ch
 Laura Bucila=laura.bucila@tcu.edu
 Andrew J. Buck=buck@temple.edu
 Robert Allan Buckle=bob.buckle@vuw.ac.nz
 Kasey Buckles=kbuckles@nd.edu
 Gioia Buckley=buckle@mcmaster.ca
 Robert Michael Buckley=buckleyr@newschool.edu
 Sam Bucovetsky=sam@dept.econ.yorku.ca
 Jelena Budak=jbudak@eizg.hr
 Rodolphe Buda=rodolphe.buda@wanadoo.fr
 Richard John Buddin=dick.buddin@act.org
 John Budd=jbudd@umn.edu
 Budiono Budiono=budiono@fe.unpad.ac.id
 Katarzyna Barbara Budnik=katarzyna.budnik@nbp.pl
 Stefan Buehler=stefan.buehler@unisg.ch
 Matthias Buehlmaier=repec@buehlmaier.net
 Dionisio Buendía-Carrillo=dbuendia@ugr.es
 Guido Buenstorf=buenstorf@uni-kassel.de
 Francisco Javier Buera=fjbuera@econ.ucla.edu
 Ralf Buesser=ralf.buesser@snb.ch
 Sascha Buetzer=sascha.buetzer@econ.lmu.de
 Elisabeth Bügelmayer=ebuegelmayer@diw.de
 Markus M. Bugge=markus.bugge@nifu.no
 Walter H. W. Buhr=buhr@vwl.wiwi.uni-siegen.de
 Andrei Buiga=andrei.buiga@gmail.com
 Maarten L. Buis=maarten.buis@wzb.eu
 Marie-Charlotte Buisson=mc.buisson@gmail.com
 Willem Hendrik Buiter=whb1002@gmail.com
 Trung Thanh Bui=trungbui79@gmail.com
 Syed Kalim Hyder Bukhari=kalim.hyder@gmail.com
 Alexander V. Bukhvalov=bukhvalov@gsom.pu.ru
 Jorge BULA=jibulae@bt.unal.edu.co
 Marius Bulearcă=mariusbulearca@yahoo.com
 Bianca Buligescu=bianca.buligescu@maastrichtuniversity.nl
 Ales Bulir=abulir@imf.org
 George Bulkley=i.g.bulkley@exeter.ac.uk
 Jesse L. Bull=bullj@fiu.edu
 David Streed Bullock=dsbulloc@illinois.edu
 Erwin Bulte=erwin.bulte@wur.nl
 Harun Bulut=hbulut.phd@gmail.com
 Levent Bulut=bulut@uga.edu
 Maoliang Bu=bumaoliang@hotmail.com
 Donald L. Bumpass=eco_dlb@shsu.edu
 Daniel Buncic=daniel.buncic@unisg.ch
 Irina Bunda=ibunda@jvi.org
 Ntogwa Ng'habi Bundala=bundalantogwa@yahoo.com
 Brent Bundick=bundickb@bc.edu
 Cristina Aurora Bunea-Bontas=bontasc@yahoo.com
 Mathieu BUNEL=mathieu.bunel@u-bourgogne.fr
 Ovidiu-Constantin Bunget=ovidiu.bunget@feaa.uvt.ro
 Maurice Bun=m.j.g.bun@uva.nl
 Melinda Jean Beeuwkes Buntin=mbbuntin@gmail.com
 Dario Buono=dario.buono@gmail.com
 Ines Buono=ines.buono@bancaditalia.it
 Mariela Buonomo Zabaleta=mariela.buonomo@cepal.org
 Gustavo Burachik=gmb1917@yahoo.com.ar
 Babatunde Buraimo=b.buraimo@liverpool.ac.uk
 L. G. Burange=burange@economics.mu.ac.in
 Andrea Buraschi=a.buraschi@imperial.ac.uk
 Alessandra Buratto=buratto@math.unipd.it
 Enrique Javier Burbano Valencia=javenco@yahoo.com
 John Burbidge=jburbidg@uwaterloo.ca
 Konrad Burchard Burchardi=konrad.burchardi@iies.su.se
 Francesco Burchi=fburchi@uniroma3.it
 Martin Burda=martin.burda@utoronto.ca
 Michael Christopher Burda=burda@wiwi.hu-berlin.de
 Richard Burdekin=richard.burdekin@claremontmckenna.edu
 Gabriel Burdín=gburdin@iecon.ccee.edu.uy
 Tamara Burdisso=tburdisso@bcra.gov.ar
 Aleksandra Burdyak=aleksandra.burdyak@gmail.com
 David Burgalassi=david.burgalassi@irpet.it
 Claudia Burgard=burgard@rwi-essen.de
 Gregory S. Burge=gburge@ou.edu
 Cobus Burger=cobusburger@sun.ac.za
 Thierry BURGER-HELMCHEN=burger@unistra.fr
 Ronelle Burger=rburger@sun.ac.za
 Rulof P. Burger=rulof@sun.ac.za
 David F. Burgess=dburgess@uwo.ca
 Robin Burgess=r.burgess@lse.ac.uk
 Simon Burgess=simon.burgess@bristol.ac.uk
 Koen Burggraeve=koen.burggraeve@nbb.be
 Johann Burgstaller=johann.burgstaller@jku.at
 Aurore Burietz=a.burietz@ieseg.fr
 Paul Burkander=burkande@msu.edu
 Mike Burkart=mike.burkart@hhs.se
 Oliver Burkart=oliver.burkart@ensae.org
 Joseph Anthony Burke=joseph.burke@avemaria.edu
 Mary Alyssa Burke=mary.burke@bos.frb.org
 Paul J. Burke=paul.j.burke@anu.edu.au
 William J. Burke=burkewi2@stanford.edu
 Richard V. Burkhauser=rvb1@cornell.edu
 Irina Sergiu Burlacu=irinaburlacu@gmail.com
 Sorin Burlacu=sburlacu@man.ase.ro
 Lorenzo Burlon=lorenzo.burlon@gmail.com
 Antje Burmeister=antje.burmeister@ifsttar.fr
 James Wesley Burnett=jwburnett@mail.wvu.edu
 Kimberly M. Burnett=kburnett@hawaii.edu
 Andrew Burns=home@a-burns.com
 Craig Burnside=burnside@econ.duke.edu
 Patrick Burns=patrick@burns-stat.com
 Chrystie Burr=chrystie.burr@colorado.edu
 Peter Burridge=peter.burridge@york.ac.uk
 Pablo Burriel=pburriel@bde.es
 Francesco Busato=busato@uniparthenope.it
 Franz Robert Buscha=buschaf@wmin.ac.uk
 Lutz-Alexander Busch=lbusch@uwaterloo.ca
 Oliver Busch=busch@em.uni-frankfurt.de
 Thomas Busch=thomas.tbusch@gmail.com
 Thomas Buser=t.buser@uva.nl
 Fabio Busetti=fabio.busetti@bancaditalia.it
 James Bushnell=jbbushnell@ucdavis.edu
 Isabel Busom=isabel.busom@uab.es
 Ginters Buss=ginters.buss@gmail.com
 Matthieu Bussière=matthieu.bussiere@banque-france.fr
 Maurizio Bussolo=mbussolo@worldbank.org
 Pablo Bustelo=bustelop@ccee.ucm.es
 Alvaro Bustos=alvaro.bustos@uc.cl
 Javier Bustos Salvagno=javier.bustos@umayor.cl
 James L. Butkiewicz=jimb@udel.edu
 Jeffrey Vincent Butler=jeff.butler@eief.it
 Monika Bütler=monika.buetler@unisg.ch
 Thiess Büttner=thiess.buettner@wiso.uni-erlangen.de
 Patrick Button=pbutton@uci.edu
 Olivier Butzbach=obutzbach@libero.it
 Rita C. Butzer=ritabutzer@gmail.com
 Tomas Buus=buust@vse.cz
 Tim Buyse=tim.buyse@ugent.be
 Bahattin Buyuksahin=bahattin.buyuksahin@gmail.com
 Katalin Buzasi=k.buzasi@uu.nl
 Jean C. Buzby=jbuzby@ers.usda.gov
 David Byers=byersjd@cardiff.ac.uk
 Steven Lawrence Byers=byerss@sec.gov
 Igor Bykadorov=bykadorov.igor@mail.ru
 David P. Byrne=d.pr.byrne@gmail.com
 Desiree Kornrum Byrne=kornrumbde@yahoo.com
 Joseph P. Byrne=j.p.byrne@hw.ac.uk
 Liam Byrnes=l.byrnes@uq.edu.au
