 Tim Haab=haab.1@osu.edu
 Markus Haacker=mh@devgro.com
 Owen G. Haaga=ohaaga@urban.org
 Rinus Haaijer=r.haaijer@muconsult.nl
 Claus-Jochen Haake=claus-jochen.haake@wiwi.upb.de
 Marco Haan=m.a.haan@rug.nl
 Mika Haapanen=mika.p.haapanen@jyu.fi
 Anette Haas=anette.haas@iab.de
 Heiko Haase=post@heikohaase.de
 Markus Haas=markus.haas@qber.uni-kiel.de
 Deborah Haas-Wilson=dhwilson@smith.edu
 Florian Habermacher=florian.habermacher@unisg.ch
 Steffen Habermalz=s-habermalz@northwestern.edu
 Nader Habibi=nhabibi@brandeis.edu
 Mahdi Mohammad Habibpour=m.habibpour@staff.uni-marburg.de
 Muzafar Shah Habibullah=muzafar@upm.edu.my
 Helga Habis=helgahabis@yahoo.co.uk
 Alexis Habiyaremye=habiyaremye@merit.unu.edu
 Wolfgang Habla=wolfgang.habla@econ.lmu.de
 Emmanuel HACHE=emmanuel.hache@ifpen.fr
 Nizar Hachicha=hachicha_nizar@yahoo.fr
 Wafik Hachicha=wafik_hachicha@yahoo.fr
 Christophe Hachon=christophe_hac@yahoo.fr
 Burcu Hacibedel=hacibedel@gmail.com
 Gungor Hacioglu=gungor.hacioglu@gmail.com
 Franz Hackl=franz.hackl@jku.at
 Jonas Häckner=joh@ne.su.se
 Yael Shoshana Hadass=yhadass@post.harvard.edu
 Eduardo Haddad=ehaddad@usp.br
 Walid HADHRI=walid.hadhri@gmail.com
 Yuniarto Hadiwibowo=yhadiwibowo@gmail.com
 Kalina Dimitrova Hadjinedelcheva=dimitrova.ka@gmail.com
 Dimitar Vesselinov Hadjinikolov=dimitar.h@live.com
 Costas Hadjiyiannis=costash@ucy.ac.cy
 Lamara HADJOU=lhadjou@yahoo.fr
 Haykel Hadj Salem=haykelh@yahoo.fr
 Kaddour Hadri=k.hadri@qub.ac.uk
 Blaženka Hadrović Zekić=hadrovic@efos.hr
 Catherine Haeck=haeck.catherine@uqam.ca
 Christian Haefke=christian.haefke@ihs.ac.at
 Dennis N. Haensel=haensel@wiwi.uni-frankfurt.de
 Guillaume Haeringer=guillaume.haeringer@uab.es
 Christian Matthias Hafner=christian.hafner@uclouvain.be
 Kurt A. Hafner=kurt.hafner@hs-heilbronn.de
 Clemens Haftendorn=chaftendorn@diw.de
 Niclas Hagelin=niclas.hagelin@nordea.com
 Klaus Hagendorf=eurodos@gmail.com
 Kornelia Marie Luise Hagen=khagen@diw.de
 Rune Jansen Hagen=rune.hagen@econ.uib.no
 Steven Joe Haggblade=blade@msu.edu
 Akiko Terada- Hagiwara=ahagiwara@adb.org
 Franz Rudolf Hahn=franz.hahn@wifo.ac.at
 Jong-Hee Hahn=hahnjh@yonsei.ac.kr
 Markus H. Hahn=mhahn@unimelb.edu.au
 Tobias Hahn=tobias.hahn@euromed-management.com
 Volker Hahn=volker.hahn@uni-konstanz.de
 Youjin Hahn=youjin.hahn@monash.edu
 Jamal Ibrahim Haidar=jamal.haidar@parisschoolofeconomics.eu
 Adnan Haider=ahaider@iba.edu.pk
 Azad Haider=azadhaider@gmail.com
 Murtaza Haider=murtaza@regionomics.com
 Steven J. Haider=haider@msu.edu
 Getinet Astatike Haile=getinet.haile@nottingham.ac.uk
 Netsanet Haile=netsanet@snu.ac.kr
 Francisco Haimovich=fhaimovich@depeco.econo.unlp.edu.ar
 Daniel Stefan Hain=dsh@business.aau.dk
 Jean-Olivier Hairault=joh@univ-paris1.fr
 Peter Haiss=peter.haiss@wu.ac.at
 Gholamreza Hajargasht=g_hgasht@yahoo.com
 Tamás Hajdu=hajdu.tamas@krtk.mta.hu
 Vassilis Hajivassiliou=vassilis@econ.lse.ac.uk
 Stefan Hajkowicz=stefan.hajkowicz@csiro.au
 Hendrik Hakenes=hakenes@uni-bonn.de
 Jacco Hakfoort=jacco.hakfoort@acm.nl
 Abdelaziz Hakimi=abdelazizhakimi@yahoo.fr
 Md. Mahbubul Hakim=shovonhakim@gmail.com
 Simon Hakim=hakim@temple.edu
 Emmanuel Hakizimana=hakiza11@yahoo.fr
 Claudia Elizabeth Halabi=claudia.halabi@udp.cl
 Grzegorz Halaj=grzegorz.halaj@n-s.pl
 Daniel Halbheer=daniel.halbheer@unisg.ch
 Roxana Halbleib (Chiriac)=roxana.halbleib@uni-konstanz.de
 Dennis Halcoussis=dhalcoussis@csun.edu
 Sushil Kumar Haldar=sushil.haldar@gmail.com
 Niels Haldrup=nhaldrup@creates.au.dk
 Galina Hale=galina.b.hale@sf.frb.org
 Yoram Halevy=yoram.halevy@ubc.ca
 Michael Haliassos=haliassos@wiwi.uni-frankfurt.de
 Ferda HALICIOGLU=fhalicioglu@yeditepe.edu.tr
 John Halikias=jgh@aueb.gr
 George Emm. Halkos=halkos@uth.gr
 Issam Hallak=issam.hallak@unibocconi.it
 Juan Carlos Hallak=jchallak@udesa.edu.ar
 Arne Hallam=ahallam@iastate.edu
 Martin Halla=martin.halla@jku.at
 Andrew John Hall=andyhallmails@yahoo.com
 Anthony David Hall=tony.hall@uts.edu.au
 Daniel Hallberg=daniel.hallberg@inspsf.se
 Caroline Hall=caroline.hall@ifau.uu.se
 Stephane Hallegatte=shallegatte@worldbank.org
 Alina Haller=hallalina@yahoo.com
 Andreas Haller=andreas.haller@swiss-economics.ch
 Winfried Hallerbach=w.hallerbach@robeco.nl
 Mark Hallerberg=hallerberg@hertie-school.org
 Jochen Haller=haller@kopfundkapital.de
 George Hall=ghall@brandeis.edu
 Simon David Halliday=simon.d.halliday@gmail.com
 Marc Hallin=mhallin@ulb.ac.be
 Maximilian J.B. Hall=m.j.hall1@lboro.ac.uk
 Matthew Halloran=mah50@psu.edu
 Robert Hall=rehall@stanford.edu
 Kerstin Hallsten=kerstin.hallsten@finance.ministry.se
 Stephen George Hall=s.g.hall@le.ac.uk
 Thomas Hall=thomas.hall@cnu.edu
 Viv B. Hall=viv.hall@vuw.ac.nz
 Paul Hallwood=paulhallwood@msn.com
 Nicole Halmdienst=nicole.halmdienst@jku.at
 Christine Halmenschlager=chalmenschlager@u-paris2.fr
 Kornel Halmos=halmos.kornel@gmail.com
 Maija Halonen-Akatwijuka=maija.halonen@bristol.ac.uk
 Janice Halpern=jhalpern@crai.com
 Joseph Halpern=halpern@cs.cornell.edu
 László Halpern=halpern@econ.core.hu
 Jørn Inge Halvorsen=jorn.halvorsen@gmail.com
 Andrés Ham=hamgonz2@illinois.edu
 A. Javier Hamann=ahamann@imf.org
 Franz Hamann=fhamansa@banrep.gov.co
 Masashige Hamano=masashige.hamano@gmail.com
 Gerhard Hambusch=gerhard.hambusch@uts.edu.au
 Helmi HAMDI=helmi.hamdi@cbb.gov.bh
 Shahzad Hameed=toshahzad_1580@yahoo.com
 Christelle Hamel=christelle.hamel@ined.fr
 Anaïs Hamelin=anais.hamelin@unistra.fr
 Jean-François Hamel=jeanfrancois.hamel@chu-angers.fr
 Jean-Yves Hamel=jeanyveshamel@gmail.com
 Daniel Hamermesh=hamermes@eco.utexas.edu
 Naved Hamid=navedhamid@gmail.com
 Shahnaz Hamid=shahnaz@pide.org.pk
 Syed Abdul Hamid=s.a.hamid73@gmail.com
 Barton Hamilton=hamiltonb@olin.wustl.edu
 Dan Elson Hamilton=dhamilto@callutheran.edu
 Darrick Hamilton=hamiltod@newschool.edu
 James Hamilton=jhamilton@ucsd.edu
 Jonathan H. Hamilton=hamilton@ufl.edu
 Stephen F. Hamilton=shamilto@calpoly.edu
 Steven Daniel Hamilton=steveham@umich.edu
 Helene Hamisultane=helene.hamisultane@free.fr
 Mahamat Hamit-Haggar=mahamat.hamit-haggar@statcan.gc.ca
 Hakim Hammadou=hakim.hammadou@univ-lille1.fr
 Hammami Yacine=hammami_yacine@yahoo.fr
 John Robert Hamman=jhamman@fsu.edu
 Mats Hammarstedt=mats.hammarstedt@lnu.se
 Jeffrey Stuart Hammer=jhammer@princeton.edu
 Matthijs Hammer=m.h.m.hammermsc@saxion.nl
 Dr. Maik Hammerschmidt=maik.hammerschmidt@wiwi.uni-goettingen.de
 Christopher Hammond=c.j.hammond@hull.ac.uk
 George William Hammond=ghammond@eller.arizona.edu
 Peter Hammond=peter.hammond@stanford.edu
 Nacer-Eddine HAMMOUDA=nacereddine.hammouda@ensae.org
 Abdelhakim Hammoudi=hammoudi@ivry.inra.fr
 Jacques HAMON=jacques.hamon@dauphine.fr
 Balazs Hamori=bhamori@uni-corvinus.hu
 Shigeyuki Hamori=hamori@econ.kobe-u.ac.jp
 Foued Hamouda=foha2001@yahoo.fr
 Hamid Hamoudi=hamid.hamoudi@urjc.es
 Mark Hampton=m.hampton@kent.ac.uk
 Karen S. Hamrick=khamrick@ers.usda.gov
 Mohamed Essaied Hamrita=mhamrita@gmail.com
 Nobuyuki Hanaki=nobuyuki.hanaki@univ-amu.fr
 Tibor Paul Hanappi=hanappi@ihs.ac.at
 Matthias Hanauske=hanauske@wiwi.uni-frankfurt.de
 Chirok Han=chirok.han@gmail.com
 Jagdish Handa=jagdish.handa@mcgill.ca
 Chris Hand=c.hand@kingston.ac.uk
 Toby Handfield=toby.handfield@monash.edu
 Heinz Handler=heinz.handler@aon.at
 Rossanto Dwi Handoyo, Sr.=rossanto_dh@yahoo.com
 D. Wade Hands=hands@pugetsound.edu
 Shoko Haneda=shaneda@tamacc.chuo-u.ac.jp
 Barbara Hanel=bhanel@unimelb.edu.au
 Petr Hanel=petr.hanel@usherbrooke.ca
 Euna Han=eahan@gachon.ac.kr
 Katja Hanewald=hanewaldk@gmail.com
 Aoife Brophy Haney=abhaney@ethz.ch
 Ulrich Hange=u.hange@gmx.net
 Heejoon Han=heejoon@khu.ac.kr
 Dr. Muhammad Nadim Hanif=muhammadnadeemhanif@yahoo.com
 Markus Hanisch=hanischm@hu-berlin.de
 Jing Han=jing_han@fanniemae.com
 Jun Han=jhan@nankai.edu.cn
 William Bryce Hankins=wbhankins@crimson.ua.edu
 Kathleen Weiss Hanley=khanley@rhsmith.umd.edu
 Nick Hanley=n.d.hanley@stir.ac.uk
 Lihong Han=juliet.han@ic.edu
 Rema Hanna=rema_hanna@hks.harvard.edu
 Il-Horn Hann=hann@marshall.usc.edu
 Greg Hannsgen=hannsgen@levy.org
 Emily C. Hannum=hannumem@soc.upenn.edu
 Giora Hanoch=giora.hanoch@huji.ac.il
 Julien Hanoteau=julien_hanoteau@yahoo.fr
 Jan Hanousek=jan.hanousek@cerge-ei.cz
 Rui Han=rui.han.rh@gmail.com
 Benjamin Hansen=bchansen@uoregon.edu
 Bruce E. Hansen=behansen@wisc.edu
 Casper Worm Hansen=cworm@econ.au.dk
 Erwin Hansen=erwin.hansen@gmail.com
 Gary Hansen=ghansen@econ.ucla.edu
 Henrik Hansen=henrik.hansen@econ.ku.dk
 Jim Hansen=jhansen@ers.usda.gov
 Jorgen Hansen=jorgen.hansen@concordia.ca
 Lars Gårn Hansen=lgh@ifro.ku.dk
 Niels-Jakob Harbo Hansen=nielsjakobharbo.hansen@iies.su.se
 Peter Hansen=reinhardhansen@gmail.com
 Petter Vegard Hansen=pettervh@gmail.com
 Robert Shields Hansen=rob.hansen@tulane.edu
 Simon Lysbjerg Hansen=slh@sam.sdu.dk
 Seungjin Han=hansj@mcmaster.ca
 Sandra Hanslin=sandra.hanslin@snb.ch
 Kevin John Hanslow=khanslow@pc.gov.au
 Song Han=song.han@frb.gov
 Gordon Hanson=gohanson@ucsd.edu
 Kenneth A. Hanson=khanson@ers.usda.gov
 Matthew A. Hanson=hansonm@nber.org
 F. Andrew Hanssen=fhansse@clemson.edu
 Åsa M.E Hansson=asa.hansson@nek.lu.se
 Björn A. Hansson=bjorn.hansson@nek.lu.se
 Gustav Hansson=gustavhansson@hotmail.com
 Pär Hansson=par.hansson@oru.se
 Sukjin Han=sukjin.han@austin.utexas.edu
 Dr V. Basil Hans=vbasilhans@yahoo.com
 Horst Hanusch=horst.hanusch@wiwi.uni-augsburg.de
 Eric Hanushek=hanushek@stanford.edu
 Gerald A. Hanweck, Sr.=ghanweck@gmu.edu
 Xuehui Han=xuehuihan@adb.org
 Yongseung Han=yongseung.han@ung.edu
 Yutao Han=yutao.han@uni.lu
 Li Hao=lhao@gmu.edu
 Qianjin Hao=haoqianjin@fudan.edu.cn
 Rui Hao=ruihao@hotmail.com
 Kathrin Happe=kathrin.happe@leopoldina.org
 Munshi Masudul Haq=haqmm@aston.ac.uk
 Rashida Haq=rashida_haq@hotmail.com
 M. Emranul Haque=emranul.haque@manchester.ac.uk
 Nadeem Haque=nhaque_imf@yahoo.com
 Zahoor ul Haq=zahoor.haq1@gmail.com
 Najib M. Harabi=nharabi@swissonline.ch
 Chiaki Hara=hara@kier.kyoto-u.ac.jp
 Mariaflavia Harari=harari@mit.edu
 Rick Harbaugh=riharbau@indiana.edu
 William Harbaugh=wtharbaugh@gmail.com
 Nasri Harb=nasri.harb@gmail.com
 David Harbord=davidharbord@market-analysis.co.uk
 Tarek M. Harchaoui=t.m.harchaoui@rug.nl
 Erwin Hardianto=erwinhardianto@yahoo.com
 Don Harding=d.harding@latrobe.edu.au
 Torfinn Harding=torfinnh@gmail.com
 Jean-Benoit Hardouin=jean-benoit.hardouin@univ-nantes.fr
 Gikas A. Hardouvelis=gikas.hardouvelis@gmail.com
 Benoit Hardy-Vallee=benoithv@gmail.com
 Wojciech Hardy=hardywojciech@gmail.com
 Alon Harel=msalon@mscc.huji.ac.il
 Paul G. Hare=p.g.hare@hw.ac.uk
 Jarrad Harford=jarrad@uw.edu
 Colin Paul Hargreaves=colin.hargreaves@gmail.com
 Dietmar Harhoff=dietmar.harhoff@ip.mpg.de
 Alexander Harin=aaharin@gmail.com
 Elad Harison=eladha@shenkar.ac.il
 Carole Haritchabalet=carole.haritchabalet@univ-pau.fr
 Cyril Hariton=cyril.hariton@ec.europa.eu
 Jarkko Harju=jarkko.harju@vatt.fi
 David W. Harless=dwharles@vcu.edu
 Heike Harmgart=harmgarh@ebrd.com
 Nikolaj Arpe Harmon=nikolaj.harmon@econ.ku.dk
 Oskar R. Harmon=harmon@uconn.edu
 Marjolein J.W. Harmsen - van Hout=marjolein.harmsen@eonerc.rwth-aachen.de
 Johann Daniel Harnoss=johann.harnoss@post.harvard.edu
 Paul Harrald=paul.harrald@sc.com
 Nizar HARRATHI=nharrathi@gmail.com
 James Harrigan=james.harrigan@virginia.edu
 Jessica L. Harriger=jl-harriger@wiu.edu
 Joseph E. Harrington, Jr.=joe.harrington@jhu.edu
 Benjamin Cerf Harris=benjamin.c.harris@census.gov
 Bernard Harris=bernard.harris@strath.ac.uk
 Donna Donhatai Harris=donhatai.harris@economics.ox.ac.uk
 Douglas N. Harris=dharri5@tulane.edu
 Jeffrey H. Harris=jharris@american.edu
 Mark Harris=mark.harris@curtin.edu.au
 Milton Harris=milt@chicagobooth.edu
 Ann E. Harrison=annh@wharton.upenn.edu
 Glenn W. Harrison=gharrison@gsu.edu
 Mark Harrison=mark.harrison@warwick.ac.uk
 Richard John Harrison=richard.harrison@bankofengland.co.uk
 Robin William Harrison=robin.harrison@canterbury.ac.nz
 Sharon G. Harrison=sh411@columbia.edu
 Peter Harris=peter.harris@seattle.gov
 Richard D. F. Harris=r.d.f.harris@exeter.ac.uk
 Ronald M. Harstad=harstadr@missouri.edu
 Chad Hart=chart@iastate.edu
 Rudolf Harthoorn=r.harthoorn@chello.nl
 Daniel Aaron Hartley=daniel.hartley@clev.frb.org
 Jonathan Hartley=jhartley@uchicago.edu
 Monica E. Hartmann=mehartmann@stthomas.edu
 Matthew Hartogh=hartogh@hotmail.com
 Djoni Hartono=eui_dyton@yahoo.com
 Robert A. Hart=r.a.hart@stir.ac.uk
 Sergiu Hart=hart@huji.ac.il
 Anne Hartung=anne.hartung@gmail.com
 Christopher Andrew Hartwell=chartwel16@gmail.com
 Karl-Hans Hartwig=10kaha@wiwi.uni-muenster.de
 Madzli Bin Harun=madzli@umt.edu.my
 春山 鉄源 (Tetsugen Haruyama)=haruyama@econ.kobe-u.ac.jp
 Andrew Sydney Harvey=harvey@smu.ca
 Campbell Harvey=cam.harvey@duke.edu
 John Harvey=j.harvey@tcu.edu
 Iftekhar Hasan=ihasan@fordham.edu
 Karim Hasani=k.hasani@imps.ac.ir
 Md. Faruq Hasan=faruqhasan@yahoo.co.uk
 Fakhri Hasanov=fakhri.hasanov@gmail.com
 Mübariz Hasanov=mubariz.hasanov@okan.edu.tr
 Zubair Hasan=zubhasan@gmail.com
 Ivan Haščič=ivan.hascic@oecd.org
 Rainer Haselmann=rainer.haselmann@uni-bonn.de
 Nawar Hashem=n.hashem@damasuniv.edu.sy
 Iraj Hashi=i.hashi@staffs.ac.uk
 Aamir Rafique Hashmi=aamir@nus.edu.sg
 Jonathan E. Haskel=j.haskel@ic.ac.uk
 Joseph Haslag=haslagj@missouri.edu
 Augusto Hasman=augusto.hasman@graduateinstitute.ch
 Arshad hassan=dr.arshad.hassan@gmail.com
 Gazi Mainul Hassan=gazi.hassan@gmail.com
 Hisham Mohamed Hassan=hishamdr@yahoo.com
 Hossein Hassani=hassanih@cf.ac.uk
 Behrooz Hassani-Mahmooei=behrooz.hassani.mahmooei@monash.edu
 Louise M. Hassan=l.hassan@bangor.ac.uk
 Rubina Hassan=rubina.hassan@gmail.com
 Shakill Hassan=shakill.hassan@resbank.co.za
 Tarek Alexander Hassan=tarek.hassan@chicagobooth.edu
 Taufiq Hassan=taufiq_h@upm.edu.my
 Kevin Allen Hassett=khassett@aei.org
 John Hassler=john@hassler.se
 Nicole J. Hassoun=kikseven@gmail.com
 Fithra Faisal Hastiadi=fithra_faisal@yahoo.com
 Prof. Abdulnasser Hatemi-J=ahatemi@uaeu.ac.ae
 Koushik Kumar Hati=koushik_hati@hotmail.com
 Magnus Hatlebakk=magnus.hatlebakk@cmi.no
 Tatsuo Hatta=hatta@grips.ac.jp
 Timothy James Hatton=hatton@essex.ac.uk
 Dimitris Hatzinikolaou=dhatzini@cc.uoi.gr
 Aristides N. Hatzis=ahatzis@phs.uoa.gr
 Joseph Haubrich=jhaubrich@clev.frb.org
 Justus Haucap=haucap@dice.hhu.de
 Achim Hauck=achim.hauck@port.ac.uk
 Katharina Hauck=k.hauck@imperial.ac.uk
 Andreas Haufler=andreas.haufler@lrz.uni-muenchen.de
 Alfred A. Haug=alfred.haug@otago.ac.nz
 Karen Evelyn Hauge=k.e.hauge@frisch.uio.no
 Andre Yone Haughton=andre.haughton02@uwimona.edu.jm
 Jonathan Haughton=jhaughton@suffolk.edu
 Peter Haug=peter.haug@iwh-halle.de
 Harald Hau=prof@haraldhau.com
 Jan Hauke=jhauke@amu.edu.pl
 Esther Hauk=esther.hauk@iae.csic.es
 Johan Hauknes=johan.hauknes@broadpark.no
 William R. Hauk, Jr.=hauk@moore.sc.edu
 David Hauner=hauner@stanfordalumni.org
 Michael Haupert=mhaupert@uwlax.edu
 Harry Haupt=harry.haupt@uni-passau.de
 Andreas Hauptmann=andreas.hauptmann@iab.de
 Donald Richard Haurin=haurin.2@osu.edu
 Shmuel Hauser=shauser@ono.ac.il
 Kjell Hausken=kjell.hausken@uis.no
 Andreas Hauskrecht,=ahauskre@indiana.edu
 Ricardo Hausmann=ricardo_hausmann@harvard.edu
 William Hausman=wjhaus@wm.edu
 Carolin Häussler=carolin@sloan.mit.edu
 Pierre-Cyrille Hautcoeur=hautcoeur@pse.ens.fr
 Nikolaus Hautsch=nikolaus.hautsch@univie.ac.at
 Enkelejda Havari=e.havari@unive.it
 Attila Havas=attila.havas@krtk.mta.hu
 Jon Haveman=jon@haveman.org
 Jacqueline Haverals=jhaveral@ulb.ac.be
 Nathalie Havet=havet@gate.cnrs.fr
 Sokol Havolli=sokolhavolli@bqk-kos.org
 Tomas Havranek=tomas.havranek@ies-prague.org
 Olena Havrylchyk=olena.havrylchyk@cepii.fr
 Utku Havuç=uhavuc@metu.edu.tr
 Gabriel Hawawini=gabriel.hawawini@insead.edu
 Clifford B. Hawley=cbhawley@mail.wvu.edu
 Kazunobu Hayakawa=kazunobu_hayakawa@ide-jetro.org
 Motonari Hayashida=m-haya@criepi.denken.or.jp
 Muhammad Azmat Hayat=azmathayat.eco@pu.edu.pk
 Raphie Hayat=raphie.hayat@gmail.com
 Dermot Hayes=dhayes@iastate.edu
 Mark Gerard Hayes=mgh37@cam.ac.uk
 John Hayfron=john.hayfron@wwu.edu
 Bernd Hayo=hayo@wiwi.uni-marburg.de
 Aydin Hayri=ahayri@gmail.com
 Serge Hayward=serge.hayward@escdijon.eu
 Moshe Hazan=hazan.moshe@gmail.com
 Mihails Hazans=mihazan@lanet.lv
 Bharat R. Hazari=bhazari@gmail.com
 Allen Head=heada@qed.econ.queensu.ca
 Derek Dewey Headey=d.headey@cgiar.org
 Geoffrey Heal=gmh1@columbia.edu
 Andrew John Healy=ahealy@lmu.edu
 Paul J. Healy=healy.52@osu.edu
 Bob Hearne=robert.hearne@ndsu.edu
 Jonathan Heathcote=heathcote@minneapolisfed.org
 Chris Heaton=chris.heaton@mq.edu.au
 Robert Francis Hebert=rfhebert@cox.net
 Stephan Heblich=stephan.heblich@bristol.ac.uk
 Shafik Hebous=hebous@wiwi.uni-frankfurt.de
 Canfei He=canfei.he@gmail.com
 Jac Heckelman=heckeljc@wfu.edu
 Alain Hecq=a.hecq@maastrichtuniversity.nl
 Daifeng He=dhe@wm.edu
 Eric Hedberg=ech@uchicago.edu
 Dong He=dhe@hkma.gov.hk
 Burkhard Heer=burkhard.heer@wiwi.uni-augsburg.de
 Nico Heerink=nico.heerink@wur.nl
 Dennis Heffley=dennis.heffley@uconn.edu
 Scott William Hegerty=s-hegerty@neiu.edu
 Ulrich Hege=hege@hec.fr
 Ane Marte Heggedal=ane.marte.heggedal@enova.no
 Haoran He=haoran.he@bnu.edu.cn
 Burkhard Hehenkamp=burkhard.hehenkamp@wiwi.upb.de
 Hui He=he.hui@mail.shufe.edu.cn
 Bernd Heidergott=bheidergott@feweb.vu.nl
 Paul Heidhues=paul.heidhues@esmt.org
 Ben J. Heijdra=b.j.heijdra@rug.nl
 Hans Heijke=h.heijke@maastrichtuniversity.nl
 Pim Heijnen=p.heijnen@rug.nl
 Joost Heijs=joost@ccee.ucm.es
 Jaakko Heikkilä=jaakko.heikkila@mtt.fi
 Frank Heiland=frank.heiland@baruch.cuny.edu
 Inga Heiland=heiland@ifo.de
 Bradley T. Heim=heimb@indiana.edu
 Gaston Heimeriks=g.j.heimeriks@uu.nl
 Rawley Z. Heimer=rawley.heimer@researchfed.org
 Ulrich Heimeshoff=ulrich.heimeshoff@uni-duesseldorf.de
 John J. Heim=jheim@albany.edu
 Wolf Dieter Heinbach=wolf.heinbach@mwk.bwl.de
 Guido Heineck=guido.heineck@uni-bamberg.de
 Frank Heinemann=f.heinemann@ww.tu-berlin.de
 Friedrich Heinemann=heinemann@zew.de
 Hans Christian Heinemeyer=heinemeyer@qcons.com
 Eskil Heinesen=esh@rff.dk
 Craig W. Heinicke=cheinick@richmond.edu
 Gregor C. Heinrich=gregor.c.heinrich@bis.org
 Timo Heinrich=timo.heinrich@ibes.uni-due.de
 Sander Heinsalu=sander.heinsalu@yale.edu
 Scott E. Hein=scott.hein@ttu.edu
 Martin Daniel Heintzelman=mheintze@clarkson.edu
 Anja Heinze=heinze@zew.de
 Arne Heise=arne.heise@wiso.uni-hamburg.de
 Axel Heitmueller=aheitmueller@london.edu
 Jamal Hejazi=jamal.hejazi@gowlings.com
 Jie He=jie.he@usherbrooke.ca
 John P. Hejkal=john-hejkal@uiowa.edu
 Stig Helberg=stig.helberg@svt.ntnu.no
 Stefan Helber=stefan.helber@prod.uni-hannover.de
 Leshui He=leshui.he@gmail.com
 Rodolfo Helg=rhelg@liuc.it
 Mojmir Helisek=mojmir.helisek@vsfs.cz
 Eric Helland=eric.helland@claremontmckenna.edu
 Claudia Heller=hellerc@terra.com.br
 Lauren Raymer Heller=lheller@berry.edu
 Daniel M. Hellerstein=danielh@ers.usda.gov
 Judith K. Hellerstein=hellerst@econ.umd.edu
 Rebecca Hellerstein=rhellerstein@gmail.com
 Yuval Heller=yuval26@gmail.com
 Thomas Hellmann=hellmann@sauder.ubc.ca
 Christiane Hellmanzik=hellmanc@tcd.ie
 Ziv Hellman=zivyahel@gmail.com
 Klaus Hellwig=klaus.hellwig@uni-ulm.de
 Carsten Helm=carsten.helm@uni-oldenburg.de
 Dieter Helm=dieter@dhelm.co.uk
 Christian Helmers=christian.r.helmers@gmail.com
 Ernst Herrmann Helmstädter=helmste@uni-muenster.de
 Thomas Hemmelgarn=thomas.hemmelgarn@ec.europa.eu
 Hannah Sabine Hempell=hannah.hempell@ecb.int
 Hanene Henchiri=hanene.henchiri@gmail.com
 Timo Henckel=timo.henckel@anu.edu.au
 Dale William Henderson=dale.henderson@rcn.com
 Daniel J. Henderson=djhender@cba.ua.edu
 J. Vernon Henderson=j.v.henderson@lse.ac.uk
 Michele C. Henderson=michele.henderson@jwu.edu
 Lutz Hendricks=lutz@lhendricks.org
 Matthew D. Hendricks=matthewdhendricks@hotmail.com
 Joshua Hendrickson=jrhendr1@olemiss.edu
 John Hendrickx=john_hendrickx@yahoo.com
 Hans Hendrischke=hans.hendrischke@sydney.edu.au
 David F. Hendry=david.hendry@nuffield.ox.ac.uk
 Scott Hendry=shendry@bank-banque-canada.ca
 Stefan Heng=stefan.heng@db.com
 Brian T. Heninger=heninger.brian@epa.gov
 Witold Jerzy Henisz=henisz@wharton.upenn.edu
 Joachim Henkel=henkel@wi.tum.de
 Sam James Henkel=sjhenkel@unimelb.edu.au
 Roberto Henke=henke@inea.it
 Andrew Henley=a.g.henley@aber.ac.uk
 Hugh James Hennessy=hennessh@gmail.com
 Sebastian Henn=s_henn@ifl-leipzig.de
 Marc Henrard=marc.p.a.henrard@gmail.com
 Magnus Henrekson=magnus.henrekson@ifn.se
 Kevin E. Henrickson=henrickson@gonzaga.edu
 Fanny Henriet=fanny.henriet@psemail.eu
 Claudia A. Henriquez=cl.henriqug@gmail.com
 Claude Henry=ch2396@columbia.edu
 Darren John Henry=d.henry@latrobe.edu.au
 Jerome Henry=jerome.henry@ecb.int
 Ólan Thomas Henry=olan.henry@liverpool.ac.uk
 Peter Blair Henry=peter.henry@stern.nyu.edu
 Corinna Hentschker=corinna.hentschker@rwi-essen.de
 Cameron J. Hepburn=cameron.hepburn@new.ox.ac.uk
 Christian Hepenstrick=christian.hepenstrick@snb.ch
 Ping He=heping@sem.tsinghua.edu.cn
 Ralf Hepp=hepp@fordham.edu
 QING HE, Sr.=qinghe@ruc.edu.cn
 Gobind M. Herani=g_m_rathore@yahoo.com
 Jean-Alain Héraud=heraud@unistra.fr
 Nicolas Hérault=nicolas.herault@gmail.com
 Tryggvi Thor Herbertsson=tryggvi@tryggvithor.is
 Edward Herbst=edward.p.herbst@frb.gov
 Mikolaj Herbst=mherbst@uw.edu.pl
 José A. Herce=jherce@afi.es
 Zvi Hercowitz=zvih@post.tau.ac.il
 Mª Isabel Heredero de Pablos=maribel.heredero@uam.es
 Eunice Heredia-Ortiz=eunice_heredia-ortiz@dai.com
 Rahobisoa Herimalala=rahobisoa.herimalala@unicaen.fr
 Martin Hering=heringm@mcmaster.ca
 P. Jean-Jacques Herings=p.herings@maastrichtuniversity.nl
 Heriyaldi=heriyaldi@fe.unpad.ac.id
 Kyle Frederic Herkenhoff=kfh@ucla.edu
 Benjamin Hermalin=hermalin@haas.berkeley.edu
 Kristinn Hermannsson=kristinn.hermannsson@glasgow.ac.uk
 Julie Hermans=julie.hermans@fundp.ac.be
 Wawan Hermawan=wawan.hermawan@fe.unpad.ac.id
 Niels Hermes=c.l.m.hermes@rug.nl
 Aday Hernández=ahernandez@acciones.ulpgc.es
 Juan Nicolás Hernández Aguilera=jnh28@pitt.edu
 Monica Hernandez Alava=monica.hernandez@shef.ac.uk
 Cesareo Hernandez=cesareo@eis.uva.es
 Adrian Hernandez-del-Valle=ahdv@hotmail.com
 Alfredo G. Hernandez-Diaz=agarher@upo.es
 Izabel Diana Hernández González=idhg@yahoo.com
 Emilio Hernandez-Hernandez=emilio.hernandez@fao.org
 José A. Hernández=jhernandez@daea.ulpgc.es
 Juan M Hernandez=jhernandez@dmc.ulpgc.es
 Kolver Hernandez=kolver@udel.edu
 Lola Hernández=l.hernandez@dnb.nl
 Rosa M. Hernandez-Maestro=rosahm@usal.es
 Fernando Hernández-Martínez=fernandoh@bde.es
 Mauricio Hernández Monsalve=mauricio.hernandez@bbva.com
 Silverio Hernández-Moreno=silverhm2002@yahoo.com.mx
 Ruben Hernandez-Murillo=ruben.hernandez@stls.frb.org
 Pedro J. Hernandez=nani@um.es
 Cristina Hernández-Quevedo=c.hernandez-quevedo@lse.ac.uk
 Rodrigo Javier Hernandez=rjhernand@radford.edu
 Pedro Oswaldo Hernández Santamaría=po.hernandez92@uniandes.edu.co
 Paula L. Hernandez-Verme=paulaherver@gmail.com
 Angel Hernando-Veciana=angel.hernando@uc3m.es
 Roberto Hernán González=roberto.hernangonzalez@gmail.com
 Virginia Hernanz=virginia.hernanz@uah.es
 Tomislav Hernaus=thernaus@efzg.hr
 Thomas Herndon=therndon@econs.umass.edu
 Johannes Herold=johannes.herold.privat@gmail.com
 Risto Herrala=risto.herrala@ecb.int
 Annika Herr=annika.herr@dice.uni-duesseldorf.de
 Alfonso Herranz-Loncán=alfonso.herranz@ub.edu
 Ainhoa Herrarte Sanchez=ainhoa.herrarte@uam.es
 Dorothea K. Herreiner=dherreiner@lmu.edu
 Berthold Herrendorf=berthold.herrendorf@asu.edu
 Juan David Herreño=jherreno@iadb.org
 Ana María Herrera=amherrera@wayne.edu
 Pedro Herrera Catalan=p.p.herrera@lse.ac.uk
 Marcos Hernán Herrera Gómez=mherreragomez@gmail.com
 Helios Herrera=hhh2108@columbia.edu
 Javier Herrera=herrera@dial.prd.fr
 Eleonora Herrera-Medina=director.ceae@uan.edu.co
 Pablo Matías Herrera=pabloherrera@economicas.uba.ar
 Juan Pablo Herrera Saavedra=jpherrera@sic.gov.co
 Maria Jesus Herrerias=m.j.herrerias@bham.ac.uk
 Jose Manuel Herrerías-Velasco=jmherrer@ugr.es
 Carmen Herrero=carmen.herrero@ua.es
 Angel Herrero Crespo=herreroa@unican.es
 Luis César Herrero=herrero@emp.uva.es
 Bradley Herring=bherring@jhsph.edu
 Karolin Herrmann=kherrman@uni-potsdam.de
 Peter Herrmann=herrmann@esosc.eu
 Joni Hersch=joni.hersch@vanderbilt.edu
 Brad Hershbein=hershbein@upjohn.org
 Shareen Hertel=shareen.hertel@uconn.edu
 Thomas Warren Hertel=hertel@purdue.edu
 Matthias Sebastian Hertweck=matthias.hertweck@eui.eu
 Mark Hertzendorf=mhertzendorf@ftc.gov
 Tom Hertz=thertz@ers.usda.gov
 Aref A. Hervani=ahervani@csu.edu
 Fabrice Herve=fabrice.herve@u-bourgogne.fr
 Karine Herve=karine.herve@banque-france.fr
 Carlos Hervés Beloso=cherves@uvigo.es
 Aldrin Herwany=herwany@yahoo.com
 Fabian Herweg=fabian.herweg@uni-bayreuth.de
 Bernhard Herz=bernhard.herz@uni-bayreuth.de
 Thomas Herzfeld=herzfeld@iamo.de
 Mathias Herzing=mathias.herzing@ne.su.se
 Prof. Dr. Bodo Herzog=bodo.herzog@reutlingen-university.de
 Ryan W. Herzog=herzogr@gonzaga.edu
 Alexander Herzog-Stein=alexander-herzog-stein@boeckler.de
 Almas Heshmati=almas.heshmati@gmail.com
 Shu-Quan He=hsqwxy@mail.shu.edu.cn
 Frank Hespeler=frank.hespeler@hespeler.de
 Zohal Hessami=zohal.hessami@uni-konstanz.de
 Borge Hess=borge.hess@de.pwc.com
 Patrik Hesselius=patrik.hesselius@skandia.se
 Jolanda Hessels=joh@eim.nl
 Gregory D. Hess=hessg@wabash.edu
 Niall Hession=nhession@imsi.com
 Clemens Hetschko=clemens.hetschko@fu-berlin.de
 Steven Heubeck=heubeck.1@osu.edu
 Daniel F. Heuermann=daniel.heuermann@wiwi.uni-regensburg.de
 Jan Heufer=jan.heufer@tu-dortmund.de
 Mélanie HEUGUES=melanie.heugues@feem.it
 Marcel J. Heusinger=marcel.heusinger@icb.uni-due.de
 Clemens Heuson=clemens.heuson@ufz.de
 Dimosthenis Hevas=hevas@aueb.gr
 Xiaobo He=xiaobo.he@adelaide.edu.au
 Xinhua He=hexh@cass.org.cn
 Xuezhong He=tony.he1@uts.edu.au
 Eric Heyer=heyer@sciences-po.fr
 Anthony Giles Heyes=aheyes@uottawa.ca
 John Hey=john.hey@york.ac.uk
 Freddy Heylen=freddy.heylen@ugent.be
 Fredrik Heyman=fredrik.heyman@ifn.se
 Christophe Heyndrickx=christophe@tmleuven.be
 John S. Heywood=heywood@uwm.edu
 Zhongfang He=zhongfang.he@rbc.com
 Douglas A. Hibbs, Jr.=douglas@douglas-hibbs.com
 Akira Hibiki=hibiki.akira.env.econ@gmail.com
 Walid Hichri=hichri@gate.cnrs.fr
 Ross D. Hickey=rosshickey@gmail.com
 James T Hickman=james@alumni.cmu.edu
 Robin Hickman=r.hickman@ucl.ac.uk
 Michael J. Hicks=mhicks@bsu.edu
 Norman L. Hicks=nhicks4@cox.net
 Ana Hidalgo-Cabrillana=ana.hidalgo@uam.es
 Cesar A. Hidalgo=cesar_hidalgo@ksg.harvard.edu
 Marisa Hidalgo-Hidalgo=mhidalgo@upo.es
 Manuel Alejandro Hidalgo=mhidper@upo.es
 Minoru Higa=mhigar@gmail.com
 Matthew J. Higgins=matt.higgins@scheller.gatech.edu
 Sean Higgins=shiggins@tulane.edu
 Tim Higgins=tim.higgins@anu.edu.au
 Jannett Highfill=highfill@bradley.edu
 Alexander Hijzen=alexander.hijzen@oecd.org
 Joseph M. Hilbe=hilbe@asu.edu
 Vincent Alexandre Hildebrand=vincent@econ.yorku.ca
 Andreas Hildenbrand=andreas.hildenbrand@agrar.uni-giessen.de
 Katharina Hilken=khilken@vub.ac.be
 James H. Hilker=hilker@msu.edu
 Andrew J. Hill=andrew.hill@moore.sc.edu
 Andrew T. Hill=andrew.hill@phil.frb.org
 Russell Hillberry=rhillberry@worldbank.org
 Brian Hill=hill@hec.fr
 Brian C. Hill=bchill@salisbury.edu
 Adrian Hille=ahille@diw.de
 Eric Hillebrand=ehillebrand@creates.au.dk
 Evan Hillebrand=ehill2@uky.edu
 Julia Hillebrandt=julia.hillebrandt@isu.uzh.ch
 Elaine L. Hill=elh83@cornell.edu
 Sanne Hiller=sanne.hiller@rub.de
 Victor Hiller=victor.hiller@u-paris2.fr
 Claude Hillinger=hillinger@lmu.de
 Jonathan B. Hill=jbhill@email.unc.edu
 Joshua M. Hill=jmh6i@mtmail.mtsu.edu
 Arye L. Hillman=arye.hillman@biu.ac.il
 Marianne T. Hill=hillmarros@aol.com
 Robert J. Hill=robert.hill@uni-graz.at
 Steven C. Hill=shill@ahrq.gov
 Jens Hilscher=hilscher@brandeis.edu
 Brian John Hilton=brianhilton@theglobalsilkroad.com
 Rozana Himaz=rozana.himaz@googlemail.com
 Oliver Himmler=ohimmle@gwdg.de
 Jean Hindriks=jean.hindriks@uclouvain.be
 James R. Hines, Jr.=jrhines@umich.edu
 Timothy Hinks=timothy.hinks@uwe.ac.uk
 Beat Hintermann=b.hintermann@unibas.ch
 Julian Hinz=julian.hinz@univ-paris1.fr
 Rommell Andre Hippolyte=researchofficer@ccc.sr
 Ryoji Hiraguchi=rhira@fc.ritsumei.ac.jp
 Yasuhiko Hiraide=hiraide.yasuhiko@nist.gov
 Toshiaki Hirai=hirai-t@sophia.ac.jp
 Naohisa Hirakata=naohisa.hirakata@gmail.com
 Keisuke Hirano=hirano@eller.arizona.edu
 Tomohiro Hirano=thirano@e.u-tokyo.ac.jp
 Hideaki Hirata=h-hirata@hosei.ac.jp
 Daisuke Hiratsuka=daisuke_hiratsuka@ide.go.jp
 Celio Hiratuka=celio@eco.unicamp.br
 Fajar Bambang Hirawan=f_b_hirawan@yahoo.com
 Kenjiro Hirayama=hiraken@kwansei.ac.jp
 Gourishankar S. Hiremath=gsdastapur@gmail.com
 Yolande HIRIART=yolande.hiriart@univ-fcomte.fr
 Lorene Hiris=lorene.hiris@liu.edu
 Norbert Hirschauer=norbert.hirschauer@landw.uni-halle.de
 Barry Hirsch=bhirsch@gsu.edu
 Joseph Gerald Hirschberg=j.hirschberg@unimelb.edu.au
 Georg Hirte=georg.hirte@tu-dresden.de
 Lion Hirth=lion.hirth@vattenfall.com
 Kalle Hirvonen=k.hirvonen@cgiar.org
 Carlos Matías Hisgen=mhisgen@gmail.com
 Diane Hite=hitedia@auburn.edu
 Per Hjertstrand=per.hjertstrand@ifn.se
 Katrine Hjorth=khj@transport.dtu.dk
 Stéphane HLAIMI=hlaimi@gmail.com
 Michal Hlaváček=michal.hlavacek@cnb.cz
 Petr Hlaváč=petr4582.hlavac@cnb.cz
 Jaroslava Hlouskova=hlouskov@ihs.ac.at
 Carmen Hmelnitchi=hmelnitchi@yahoo.com
 Viktoria V. Hnatkovska=hnatkovs@interchange.ubc.ca
 Viet-Ngu (Vincent) Hoang=vincent.hoang@qut.edu.au
 Anson T. Y. Ho=atyho@ksu.edu
 Jean-François Hoarau=jfhoarau@univ-reunion.fr
 Cecile Hoareau=cecile.hoareau@fulbrightmail.org
 Benjamin F. Hobbs=bhobbs@jhu.edu
 Bart Hobijn=bart.hobijn@sf.frb.org
 Stefan Hochguertel=shochguertel@feweb.vu.nl
 Gal Hochman=gal.hochman@rutgers.edu
 Chong Mun Ho=cmho@ums.edu.my
 Eduard Hochreiter=eduard.hochreiter2@gmx.at
 Ronald Hochreiter=ronald.hochreiter@wu.ac.at
 Chun-Yu Ho=chunyu.ho@sjtu.edu.cn
 Jason M. Hockenberry=jason.hockenberry@emory.edu
 Heinrich Hock=hhock@mathematica-mpr.com
 Heinrich Hockmann=hockmann@iamo.de
 Daniel E. Ho=daniel.e.ho@gmail.com
 Jonathan Hoddenbagh=jon.hoddenbagh@gmail.com
 John Hoddinott=j.hoddinott@cgiar.org
 Stefan Hoderlein=stefan_hoderlein@yahoo.com
 Ian Hodge=idh3@cam.ac.uk
 Douglas James Hodgson=hodgson.douglas-james@uqam.ca
 Geoffrey M. Hodgson=g.m.hodgson@herts.ac.uk
 Robert James Hodrick=rh169@columbia.edu
 Annelies Hoebeeck=annelies.hoebeeck@ugent.be
 Marco Hoeberichts=m.m.hoeberichts@dnb.nl
 Andreas Hoefele=a.hoefele@lboro.ac.uk
 Anke Hoeffler=anke.hoeffler@economics.ox.ac.uk
 John P. Hoehn=hoehn@msu.edu
 Bernard Hoekman=bernard.hoekman@eui.eu
 Rutger Hoekstra=r.hoekstra@cbs.nl
 Peter Hoeller=peter.hoeller@oecd.org
 Michael Olaf Hoel=mihoel@econ.uio.no
 Alex R Hoen=gewoonwoord@xs4all.nl
 Steffen H. Hoernig=shoernig@fe.unl.pt
 Marie Hoerova=marie.hoerova@ecb.int
 Glenn Hoetker=glenn.hoetker@asu.edu
 Roy Hoevenaars=roy.hoevenaars@gmail.com
 Karla Hoff=khoff@worldbank.org
 Alexander W. Hoffmaister=alexhoffmaister@gmail.com
 Linwood Allen Hoffman=lhoffman@ers.usda.gov
 Michael E. S. Hoffman=mike.hoffman@gmail.com
 Bert Hoffmann=hoffmann@giga-hamburg.de
 Magnus Hoffmann=magnus.hoffmann@tu-berlin.de
 Marc Hoffmann=hoffmann@ceremade.dauphine.fr
 Mathias Hoffmann=mathias.hoffmann@econ.uzh.ch
 Mathias Hoffmann=mathias.hoffmann@bundesbank.de
 Nick Hoffmann=hoffmann.uhg@googlemail.com
 Robert Hoffmann=robert.hoffmann@nottingham.ac.uk
 Saul D. Hoffman=hoffmans@udel.edu
 Onno Hoffmeister=onno.hoffmeister@fao.org
 Marjan W. Hofkes=m.w.hofkes@vu.nl
 Anett Hofmann=a.hofmann1@lse.ac.uk
 Boris Hofmann=boris.hofmann@bis.org
 Robert Hofmeister=robert.hofmeister@uni-konstanz.de
 Markus Hofreither=markus.hofreither@boku.ac.at
 Stefanie Hof=hof.steffi@gmail.com
 Marc Hofstetter=mahofste@uniandes.edu.co
 Seamus Davie Hogan=seamus.hogan@canterbury.ac.nz
 Thomas L. Hogan=tlhogan@troy.edu
 Vincent Hogan=vincent.hogan@ucd.ie
 Robin Miles Hogarth=robin.hogarth@upf.edu
 Andreas Högberg=hogberg.andreas@gmail.com
 Jens Andreas Hogenacker=hogenacker@iza.org
 Christiaan Hogendorn=chogendorn@wesleyan.edu
 Jan Hogrefe=hogrefe@zew.de
 Karin Hoisl=hoisl@bwl.lmu.de
 Jerry Chienwei Ho=c.ho@massey.ac.nz
 Masakazu Hojo=hojo@econ.niigata-u.ac.jp
 Kong Weng Ho=ecshkw@nus.edu.sg
 James H. Holcomb=jholcomb@utep.edu
 Paul Holden=ph@erinstitute.org
 Richard Holden=richard.holden@unsw.edu.au
 Steinar Holden=steinar.holden@econ.uio.no
 Stein T. Holden=stein.holden@nmbu.no
 Tom Holden=thomas.holden@gmail.com
 Arne Hole=a.r.hole@sheffield.ac.uk
 Angus James Holford=ajholf@essex.ac.uk
 Nils Holinski=n.holinski@maastrichtuniversity.nl
 J Scott Holladay=jhollad3@utk.edu
 Adelheid Holl=a.holl@csic.es
 Dawn Holland=dawn.holland@esri.ie
 Hugo Hollanders=h.hollanders@maastrichtuniversity.nl
 Stephan Hollander=s.hollander@uvt.nl
 Márcio Holland=marcio.holland@fgv.br
 Stephen P. Holland=sphollan@uncg.edu
 Rolf Holle=holle@helmholtz-muenchen.de
 Burton Hollifield=burtonh@andrew.cmu.edu
 Bruce Hollingsworth=b.hollingsworth@lancaster.ac.uk
 Garth John Holloway=garth.holloway@reading.ac.uk
 Alberto Holly=alberto.holly@unil.ch
 Sean Holly=sean.holly@econ.cam.ac.uk
 Anders Holm=ah@soc.ku.dk
 Nancy E. Holman=n.e.holman@lse.ac.uk
 Pär Holmberg=par.holmberg@ifn.se
 Ulf Holmberg=ulf.e.holmberg@me.com
 james M. holmes=ecoholme@buffalo.edu
 Mark J. Holmes=holmesmj@waikato.ac.nz
 Peter Holmes=p.holmes@sussex.ac.uk
 Thomas Holmes=holmes@umn.edu
 Hakan J Holm=hakan.holm@nek.lu.se
 Bengt Holmstrom=bengt@mit.edu
 Lok Sang Ho=lsho@ln.edu.hk
 Jens Holscher=jholscher@bournemouth.ac.uk
 Lars Holstenkamp=holstenkamp@uni.leuphana.de
 Jens Holst=drjensholst@web.de
 Charles A. Holt=cah2k@virginia.edu
 Cornelia Holthausen=cornelia.holthausen@ecb.int
 Matthew T. Holt=mtholt@cba.ua.edu
 Bjart Holtsmark=bjj@ssb.no
 Tomas Holub=tomas.holub@cnb.cz
 Carsten A. Holz=carstenholz@gmail.com
 Harry J. Holzer=hjh4@georgetown.edu
 Franziska Holz=fholz@diw.de
 Werner Hölzl=werner.hoelzl@wifo.ac.at
 Robert Holzmann=robert.holzmann@gmail.com
 Mario Holzner=holzner@wiiw.ac.at
 Timotej Homar=t.homar@uva.nl
 Cars Hommes=c.h.hommes@uva.nl
 Daniel HOMOCIANU=dan.homocianu@gmail.com
 Dániel Homolya=dhomolya@enternet.hu
 Mun Sing Ho=ho@rff.org
 George Hondroyiannis=ghondroyiannis@bankofgreece.gr
 Dong-Pyo Hong=dphong@kimchang.com
 hao Hong=haohong755@hotmail.com
 Harrison Hong=hhong@princeton.edu
 Sok Chul Hong=shong@sogang.ac.kr
 Anja Hönig=anja.hoenig@wiso.uni-erlangen.de
 Seppo Mikko Sakari Honkapohja=seppo.honkapohja@bof.fi
 Mark T. Hon=markhon@uwalumni.com
 Satoshi Honma=honmasatoshi999@gmail.com
 Patrick Honohan=phonohan@eircom.net
 Maddalena Honorati=mhonorati@worldbank.org
 Neal Hooker=hooker.27@osu.edu
 Scott M. Hook=scottmhook@gmail.com
 David G. Hoopes=dhoopes@csudh.edu
 Thomas de Hoop=dehoopthomas@gmail.com
 Gary Hoover=ghoover@culverhouse.ua.edu
 Kevin D. Hoover=kd.hoover@duke.edu
 Chee-Wooi Hooy=cwhooy@usm.my
 Astrid Hopfensitz=hopfensitz@gmail.com
 Sandra Hopkins=s.hopkins@curtin.edu.au
 Gabriela Hoppe=mail@gabriela-hoppe.de
 Mohammad Monjurul Hoque=mmonju2003@yahoo.co.uk
 Conor P. Horan=conor.horan@dit.ie
 David Horan=david.horan@eui.eu
 Theodore M. Horbulyk=horbulyk@ucalgary.ca
 Peter Hördahl=peter.hoerdahl@bis.org
 Alex Ronen Horenstein=alexhorenstein@gmail.com
 Daniel Horgos=horgos@hsu-hh.de
 堀 勝彦 (Katsuhiko Hori)=khori@tezukayama-u.ac.jp
 Keiichi Hori=khori@ec.ritsumei.ac.jp
 Kenjiro Hori=k.hori@bbk.ac.uk
 Charles Yuji Horioka=horioka@iser.osaka-u.ac.jp
 Yusaku Horiuchi=yusaku.horiuchi@gmail.com
 J Daniela Horna=jdhorna@fastmail.fm
 Brady P. Horn=bhorn@unm.edu
 Daniel Horn=horn@econ.core.hu
 Jocelyn Horne=jocelyn.horne@mq.edu.au
 Henrik Horn=henrik.horn@ifn.se
 Nicoleta Hornianschi=hornianschi@yahoo.com
 Manfred Horn=mhorn@diw.de
 Abigail Susannah Hornstein=ahornstein@wesleyan.edu
 Erik Hornung=erik.hornung@tax.mpg.de
 Guillaume Horny=guillaume.horny@banque-france.fr
 Joel L. Horowitz=joel-horowitz@northwestern.edu
 John B. Horowitz=jhorowitz@bsu.edu
 John Keith Horowitz=john.horowitz@treasury.gov
 William C. Horrace=whorrace@maxwell.syr.edu
 Jonathan Mark Horridge=mark.horridge@gmail.com
 Anthony Horsley=andrew.wrobel@gmail.com
 Nicholas Jon Horton=nhorton@amherst.edu
 Sue Horton=sehorton@uwaterloo.ca
 Gerard Thomas Horvath=tom.horvath@gmx.net
 Gergely Horvath=horvathgergely@gmail.com
 Julius Horvath=horvathj@ceu.hu
 Michal Horvath=michal.horvath@economics.ox.ac.uk
 Sandra Horvat=shorvat@efzg.hr
 Mitduhide Hoshino=mithoshino@yahoo.co.jp
 Taeko Hoshino=hosino@ide.go.jp
 Takeo Hoshi=tkohoshi@stanford.edu
 Arthur Hosios=ahosios@chass.utoronto.ca
 Amr Sadek Hosny=amrsadek@uwm.edu
 Nobuhiro Hosoe=nhosoe@grips.ac.jp
 Laura Hospido=laura.hospido@bde.es
 Akhand Akhtar Hossain=akhtar.hossain@newcastle.edu.au
 AKM Rezaul Hossain=hossain@msmc.edu
 Monzur Hossain=monzur_h@yahoo.com
 Muhammad Iqbal Hossain=h.iqbal.edu@gmail.com
 Sharif Mosharraf Hossain=smhossain@gmail.com
 Tanjim Hossain=tanjim.hossain@utoronto.ca
 Roozbeh Hosseini=roozbeh.hosseini@asu.edu
 Seyed-Ali Hosseini-Yekani=hosseiniyekani@gmail.com
 Mehdi Hosseinkouchack=hosseinkouchack@wiwi.uni-frankfurt.de
 Oliver Hossfeld=oliver.hossfeld@bundesbank.de
 Doug Hostland=dhostland@imf.org
 Tai-kuang Ho=tkho@mx.nthu.edu.tw
 Avdullah Hoti=avdullah.hoti@gmail.com
 Ngoc Luan Ho Trieu=ht333@optusnet.com.au
 Louis Hotte=louis.hotte@uottawa.ca
 Hanna Hottenrott=hottenrott@dice.hhu.de
 Hakan Hotunluoğlu=hakanhotunlu@gmail.com
 V. Joseph Hotz=hotz@econ.duke.edu
 Harold Houba=harold.houba@vu.nl
 Michal Houda=houda@ef.jcu.cz
 Jean-Francois Houde=houde@wharton.upenn.edu
 Jens Leth Hougaard=jlh@foi.dk
 Keqiang Hou=houk2@mcmaster.ca
 Stefan Houpt=shoupt@clio.uc3m.es
 Christopher House=chouse@umich.edu
 Daniel Houser=dhouser@gmu.edu
 Trevor Houser=thouser@piie.com
 David Housman=dhousman@goshen.edu
 Romain Houssa=romain.houssa@fundp.ac.be
 Tony Chieh-Tse Hou=houc@mail.ndhu.edu.tw
 Vincent Hovelaque=vincent.hovelaque@univ-rennes1.fr
 Wai-Ming Ho=waiming@yorku.ca
 Wai-Yip Alex Ho=awyho@hkma.gov.hk
 James Patrick Howard, II=jh@jameshoward.us
 Richard B. Howarth=richard.howarth@dartmouth.edu
 David Howden=dhowden@slu.edu
 Daniel Howdon=daniel.howdon@york.ac.uk
 Howard Howe=howard.howe@ny.frb.org
 Lance Howe=elhowe@uaa.alaska.edu
 David R. Howell=howell@newschool.edu
 Peter Howells=peter.howells@uwe.ac.uk
 Stephen Howes=stephen.howes@anu.edu.au
 Peter Howitt=peter_howitt@brown.edu
 E. Philip Howrey=eph@umich.edu
 Durim Hoxha=durim.hoxha@uab.es
 Michael Hoy=mhoy@uoguelph.ca
 David Hoyos=david.hoyos@ehu.es
 Alejandro Hoyos=ahoyos@uchicago.edu
 Yuen Ping Ho=nechoyp@nus.edu.sg
 Andrei Hrebenciuc, Sr.=andrei_h21@yahoo.com
 Anca Maria Hristea=amhristea@yahoo.com
 Atanas Hristov=hristov.a@ifo.de
 Veneta Hristova=veneta@uni-svishtov.bg
 Kalin Dimitrov Hristov=hristov.k@bnbank.org
 Jana Hromcová=jana.hromcova@uab.es
 Warren Hrung=warren.hrung@ny.frb.org
 Dmytro Hryshko=dhryshko@ualberta.ca
 Chih-Ying Hsiao=chih.hsiao@cba.com.au
 Cody Yu-Ling Hsiao=cody.hsiao@unsw.edu.au
 Pei-Fang Hsieh=pfhsieh@mx.nthu.edu.tw
 Shu-Hui Hsieh=d924702@hotmail.com
 Yu-Wei Hsieh=yuwei.hsieh@usc.edu
 sethu H.S.=sethu.hs@manipal.edu
 Minchung Hsu=minchunghsu@grips.ac.jp
 Ming Hsu=mhsu@haas.berkeley.edu
 Sara Dora Hsu=sara_hsu@yahoo.com
 Shih-Hsun Hsu=shhsu@nccu.edu.tw
 Tsechien Hsu=tsechien@gmail.com
 Yu-Chin Hsu=ychsu@econ.sinica.edu.tw
 Yu-Pei Judy Hsu=yphsu@fcu.edu.tw
 Franklin Huaita=fhuaita@gmail.com
 Albert Guangzhou Hu=ecshua@nus.edu.sg
 Chien-Yu Huang=chuang4@ncsu.edu
 Chiung-Ju Huang=cjhuang@fcu.edu.tw
 Fali Huang=flhuang@smu.edu.sg
 Stella Xiuhua Huangfu=stella.huangfu@sydney.edu.au
 Haibo Huang=haibo.huang@gmail.com
 Hai-Jun Huang=haijunhuang@buaa.edu.cn
 Haizhou Huang=haizhou.huang@gmail.com
 Ho-Chuan Huang=river@mail.tku.edu.tw
 Jikun Huang=jkhuang.ccap@igsnrr.ac.cn
 Jizheng Huang=hjzheng@163.com
 Kevin X.D. Huang=kevin.huang@vanderbilt.edu
 Lin Huang=lhuang@swufe.edu.cn
 Lixin Huang=lxhuang@gsu.edu
 Moxi Huang=huangmoxi1@126.com
 Peng Huang=huangp@ripon.edu
 Pidong Huang=hpd200130070011@gmail.com
 Qiuqiong Huang=qqhuang@uark.edu
 Rachel Juiching Huang=rachel@mail.ntust.edu.tw
 Ruihong Huang=ruihong.huang@wiwi.hu-berlin.de
 Sophia Wu Huang=sshuang@ers.usda.gov
 Wei Huang=weihuang@fas.harvard.edu
 Weihong Huang=awhhuang@ntu.edu.sg
 Weiting Huang=weiting.huang@yahoo.com.cn
 Xianguo Huang=phd09008@grips.ac.jp
 Yongfu Huang=yongfu.huang@wider.unu.edu
 Zhangkai Huang=huangzhk@sem.tsinghua.edu.cn
 Zhuo Huang=zhuohuang@nsd.pku.edu.cn
 Florence Huart=florence.huart@univ-lille1.fr
 Julio Huato=juliohuato@gmail.com
 Isabelle Huault=isabelle@huault.net
 Baiding Hu=baiding.hu@lincoln.ac.nz
 Robert Glenn Hubbard=rgh1@columbia.edu
 Bryan Hubbell=hubbell.bryan@epa.gov
 Hélène Huber=helene.huber@univ-paris1.fr
 Martin Huber=martin.huber@unisg.ch
 Peter Huber=huber@wifo.ac.at
 Samuel Huber=samuel_h@gmx.ch
 Stephan Huber=huber@iaaeg.de
 Paul Hubert=paul.hubert@sciencespo.fr
 Bin Hu=hubin1981@hotmail.com
 Olaf Hübler=huebler@ewifo.uni-hannover.de
 Bo Hu=huboshufe@gmail.com
 Kirstin Hubrich=kirstin.hubrich@ecb.int
 Stefan Hubrich=stefan.hubrich@uni-rostock.de
 Marilyne Huchet-Bourdon=marilyne.huchet-bourdon@agrocampus-ouest.fr
 Nicolas Huchet=huchet@univ-tln.fr
 Miroslav Hucka=miroslav.hucka@vsb.cz
 Nicolas Huck=nicolas.huck@essca.fr
 Steffen Huck=steffen.huck@wzb.eu
 Steven Huddart=huddart@psu.edu
 Marek Hudon=mhudon@ulb.ac.be
 Darren Hudson=darren.hudson@ttu.edu
 Robert Simon Hudson=robert.hudson@hull.ac.uk
 Olivier Hueber=olivier.hueber@unice.fr
 Glenn Hueckel=grh04747@pomona.edu
 Felix Huefner=fhuefner@yahoo.de
 Elena Huergo=ehuergo@ccee.ucm.es
 Luis Huesca=lhuesca@ciad.mx
 Freddy Huet=huetfreddy@yahoo.fr
 Brent Hueth=hueth@wisc.edu
 Roefie Hueting=rhig@hetnet.nl
 Frank Huettner=info@frankhuettner.de
 Gary Clyde Hufbauer=ghufbauer@piie.com
 Feng Hu=feng3hu@gmail.com
 David Huffman=david.huffman1@me.com
 Sonya Kostova Huffman=skostova@iastate.edu
 Mark Huggett=mh5@georgetown.edu
 Andrew Hughes Hallett=ahughesh@gmu.edu
 Jonathan Edward Hughes=jonathan.e.hughes@colorado.edu
 Joseph P. Hughes=jphughes@rci.rutgers.edu
 David Hugh-Jones=davidhughjones@gmail.com
 Sebastian Huhn=huhn@giga-hamburg.de
 Anni Huhtala=anni.huhtala@vatt.fi
 Maria Carmen Huian=maria.huian@uaic.ro
 Raju Huidrom=rh2cw@virginia.edu
 George W L Hui=georgewl_hui@alum.swarthmore.edu
 Kai-Lung Hui=klhui@ust.hk
 Elise Huillery=ehuillery@povertyactionlab.org
 Dennis Huisman=huisman@ese.eur.nl
 Kuno Huisman=k.j.m.huisman@uvt.nl
 Ronald Huisman=rhuisman@few.eur.nl
 Jian Hu=jian.hu@moodys.com
 Jin-Li Hu=jinlihu@mail.nctu.edu.tw
 Ling Hu=d90723007@ntu.edu.tw
 Isaiah Hull=hull.isaiah@gmail.com
 Peter D. Hull=hull@mit.edu
 Alberto Humala=alberto.humala@bcrp.gob.pe
 Marcin Andrzej Humanicki=marcin.humanicki@nbp.pl
 Stefan Humer=shumer@wu.ac.at
 David L. Hummels=hummelsd@purdue.edu
 Michael Hummer=michael.hummer@jku.at
 John Eric Humphries=johnerichumphries@gmail.com
 Federico Huneeus=fhuneeus@fen.uchile.cl
 Chi-Hsiou Daniel Hung=chi-hsiou.hung@glasgow.ac.uk
 Mathias Hungerbühler=mathias.hungerbuhler@unamur.be
 Tsu-Yi Hung=tyhung@ntut.edu.tw
 Ahmed Imran Hunjra=ahmedhunjra@gmail.com
 Arngrim Hunnes=arngrim.hunnes@uia.no
 Boyd Hamilton Hunter=boyd.hunter@anu.edu.au
 John Hunter=ecstjjh@brunel.ac.uk
 Jennifer Hunt=jennifer.hunt@alum.mit.edu
 Lester Charles Hunt=l.hunt@surrey.ac.uk
 Priscillia Hunt=priscillia_hunt@rand.org
 Robert Hunt=bob.hunt@phil.frb.org
 Gabor Hunya=hunya@wiiw.ac.at
 Eva H.G. Hüpkes=ehh4@georgetown.edu
 Daniela Hupková=daniela.hupkova@uniag.sk
 Mobinul Huq=m.huq@usask.ca
 Luminita Hurbean=luminita.hurbean@feaa.uvt.ro
 Michael D. Hurd=mhurd@rand.org
 Jung Hur=ecsjhur@sogang.ac.kr
 Margaret Hurley=margaret.hurley@nuim.ie
 Terrance Hurley=tmh@umn.edu
 Christophe Hurlin=christophe.hurlin@univ-orleans.fr
 Stan Hurn=s.hurn@qut.edu.au
 Sewon Hur=sewonhur@pitt.edu
 Erik Hurst=erik.hurst@gsb.uchicago.edu
 Luke Hurst=luke.w.hurst@gmail.com
 Matt Hurst=matt.hurst@phac-aspc.gc.ca
 Jimena Hurtado Prieto=jihurtad@uniandes.edu.co
 Alvaro Hurtado Rendón=ahurtad1@eafit.edu.co
 Samuel Hurtado=samuel.hurtado@bde.es
 Dragos Huru, Sr.=dragos.huru@economie.ase.ro
 Fazal Husain=fazal@pide.org.pk
 Zakir Husain=dzhusain@gmail.com
 Cristian Huse=cristian.huse@sse.edu
 Don Husereau=don.husereau@gmail.com
 Arzu Huseynova=eim09@rambler.ru
 Shengsui Hu=shengsui@gmail.com
 Shih Wen Hu=swhu@fcu.edu.tw
 Christine Husmann=husmann@uni-bonn.de
 Muhammad Iftikhar Ul Husnain=iftikharhusnain@yahoo.com
 A M Tanvir Hussain=abulmaala@gmail.com
 Anwar Hussain=anwar@pide.org.pk
 Anwar HUSSAIN=anwar@conservationecon.org
 Iftikhar K. Hussain=iftikhar.hussain@sussex.ac.uk
 Jafar Hussain=jafar@pide.org.pk
 Majeed Ali Hussain=majeed1950@yahoo.com
 Mohammad Azhar Hussain=azharh@ruc.dk
 Mumtaz Hussain=mhussain@imf.org
 Sayed Ajaz Hussain=sayed.hussain@utoronto.ca
 Syed Arshad Hussain=sa_h153@hotmail.com
 Karamatullah Hussaini Syed=karamat68@yahoo.com
 Kassim Hussein=kassimhussein2002@yahoo.com
 Katrin Hussinger=katrin.hussinger@uni.lu
 Thomas A Husted=husted@american.edu
 Tiffany Hutcheson=tiffany.hutcheson@uts.edu.au
 Michael Mercier Hutchison=hutch@ucsc.edu
 Elaine Hutson=elaine.hutson@monash.edu
 Silke Hüttel=silke.huettel@agrar.hu-berlin.de
 Alan Hutton=a.hutton@gcal.ac.uk
 Kristiina Huttunen=kristiina.huttunen@aalto.fi
 Xingwei Hu=xhu@imf.org
 Huynh Truong Huy=huyseba@gmail.com
 胡义 (yi hu)=winnerhu2008@vip.sina.com
 Kim P. Huynh=kim@huynh.tv
 Kim Van Huynh=kim.huynh@u-paris2.fr
 Youxin Hu=huyx@swufe.edu.cn
 Yujia Hu=yujia.hu@gmail.com
 Yuqing Hu=yhu3@worldbank.org
 Yu-Wei Hu=yu-wei.hu@hotmail.com
 Zhaoguang Hu=zghu16@gmail.com
 In Chang Hwang=i.c.hwang@vu.nl
 Jae-Kwang Hwang=jhwang@vsu.edu
 Jinyoung Hwang=jyh17@hnu.kr
 Soosung Hwang=soosung.hwang@gmail.com
 Sunoong Hwang=sunoong.hwang@kiet.re.kr
 Henry Richard Hyatt=henry.r.hyatt@gmail.com
 Zulfiqar Hyder=zulfiqar.hyder@anu.edu.au
 Qazi Muhammad Adnan Hye=adnan.economist@yahoo.com
 Marie Hyland=marie.hyland@esri.ie
 Svend Hylleberg=shylleberg@econ.au.dk
 Rob J Hyndman=rob.hyndman@monash.edu
 Brian Hynes=bhynes@lvmglobalmarkets.com
 William M. Hynes=hynesw@tcd.ie
 Kazuya Hyogo=hyogo@econ.ryukoku.ac.jp
 Dean Hyslop=dean.hyslop@vuw.ac.nz
