 Josef Taalbi=josef.taalbi@ekh.lu.se
 Abderrahim Taamouti=ataamouti@gmail.com
 Benjamin Miranda Tabak=benjaminm.tabak@gmail.com
 Chrysostomos Tabakis=ctabakis@kdischool.ac.kr
 Alexander Tabarrok=tabarrok@gmu.edu
 Domenico Tabasso=domenico.tabasso@unige.ch
 Riad Tabbarah=rtabbarah@gmail.com
 Guido Tabellini=guido.tabellini@unibocconi.it
 Marco Taboga=taboga001@gmail.com
 Rodrigo Taborda=r.taborda@uniandes.edu.co
 Takatoshi Tabuchi=ttabuchi@e.u-tokyo.ac.jp
 Florin TACHE=florin.tache@yahoo.com
 Ileana Tache=ileanatache@unitbv.ro
 Jesse B. Tack=tack@agecon.msstate.edu
 Ezequiel Tacsir=tacsir@merit.unu.edu
 Prabhakara Reddy Tada=tprabha9@gmail.com
 Bedassa Tadesse=btadesse@d.umn.edu
 Solomon A. Tadesse=stadesse@chicagobooth.edu
 Yamina Tadjeddine=yamina.tadjeddine@u-paris10.fr
 Darjusch Tafreschi=tafreschi@ese.eur.nl
 Boris Taganov=taganov@iet.ru
 Davoud Taghawi-Nejad=davoud@taghawi-nejad.de
 Farhad TAGHIZADEH HESARY=farhadth@gmail.com
 Athanasios Tagkalakis=atagkalakis@bankofgreece.gr
 Daria Taglioni=daria.taglioni@graduateinstitute.ch
 Fawzi A. Taha=ftaha@ers.usda.gov
 Marian Ţaicu=taicumarian@yahoo.com
 Liaila Tajibaeva=taji0004@umn.edu
 Lucia Tajoli=lucia.tajoli@polimi.it
 Harutaka Takahashi=haru@eco.meijigakuin.ac.jp
 Satoru Takahashi=ecsst@nus.edu.sg
 Wataru Takahashi=wtaka@osaka-ue.ac.jp
 Norikazu Takami=dg067tn@mail2.econ.osaka-u.ac.jp
 Yoshito Takasaki=takasaki@sk.tsukuba.ac.jp
 Ryo Takashima=rtakashima@sophia.ac.jp
 Noriyuki Takayama=takayama@ier.hit-u.ac.jp
 Shino Takayama=s.takayama@economics.uq.edu.au
 Yuki Takayama=takayama@cee.ehime-u.ac.jp
 Koichi Takeda=ktakeda@mt.tama.hosei.ac.jp
 Shiro Takeda=shiro.takeda@gmail.com
 Yosuke Takeda=y-takeda@sophia.ac.jp
 Hiroyuki Takeshima=h.takeshima@cgiar.org
 Kan Takeuchi=takeuchi.kan@gmail.com
 Kenji Takeuchi=takeuchi@econ.kobe-u.ac.jp
 Elvira Takli=taklielvira@gmail.com
 Giuseppina Talamo=giuseppinamc.talamo@unikore.it
 Ismail Anil Talasli=anil.talasli@tcmb.gov.tr
 Damien Talbot=talbot@u-bordeaux4.fr
 Thomas Tallarini=thomas.tallarini@mpls.frb.org
 Ellis W. Tallman=ellis.tallman@oberlin.edu
 Gabriel Talmain=g.talmain@lbss.gla.ac.uk
 Dolf Talman=talman@uvt.nl
 Paloma Taltavull de La Paz=paloma@ua.es
 Bidyut Talukdar=bidyut.talukdar@smu.ca
 Federico Tamagni=f.tamagni@sssup.it
 Armando Lenin Támara Ayus, Sr.=atamaraa@eafit.edu.co
 Cesar E. Tamayo=ctamayo@econ.rutgers.edu
 Esteban Tamayo=etamayoz@gmail.com
 Jorge Andres Tamayo=jtamayo8@gmail.com
 Mery Patricia Tamayo=mptamayo@eafit.edu.co
 Artur Tamazian=artur.tamazian@gmail.com
 Demosthenes N. Tambakis=dnt22@cam.ac.uk
 Andrea Tambalotti=andrea.tambalotti@ny.frb.org
 Massimo Tamberi=m.tamberi@univpm.it
 Roberto Tamborini=roberto.tamborini@unitn.it
 Unay Tamgac=utamgac@etu.edu.tr
 Lota Dabio Tamini=lota.tamini@eac.ulaval.ca
 Natalia Tamirisa=ntamirisa@imf.org
 Lewis Tam=lewistam@umac.mo
 Marcus Tamm=tamm@rwi-essen.de
 Alessandro Tampieri=tamp79@gmail.com
 Jitu Tamuli=jitutamuli@gmail.com
 Hideaki Tamura=h.tamura@jupiter.ocn.ne.jp
 Robert F Tamura=rtamura@clemson.edu
 Xuan S. Tam=xuanstam@cityu.edu.hk
 Kiyoyasu Tanaka=kiyoyasu_tanaka@ide.go.jp
 Makoto Tanaka=mtanaka@grips.ac.jp
 Tomomi Tanaka=tomomi.tanaka@asu.edu
 Yasuhito Tanaka=yasuhito@mail.doshisha.ac.jp
 Ovidiu Mihai Tanase=tanase_mihai_ovidiu@yahoo.com
 Cristina Roxana Tanasescu=cristina.tanasescu@ulbsibiu.ro
 Paul Tanasescu=floritanasescu@yahoo.com
 Anca Tanasie=ancatanasie@gmx.de
 Georgiana Lavinia Tanasoiu=georgianatanasoiu@yahoo.com
 Tanja Tanayama=tanja.tanayama@kotikone.fi
 Bee Wah Tan=bewahtan@gmail.com
 Chih Ming Tan=chihmingtan@gmail.com
 Massimiliano Tancioni=massimiliano.tancioni@uniroma1.it
 Vedat Sinan Tandogan=sinantandogan@gmail.com
 Pankaj Tandon=ptandon@bu.edu
 Verena Tandrayen-Ragoobur=v.tandrayen@uom.ac.mu
 Elaine Tan=elaine.tan@rhul.ac.uk
 Fangfang Tan=fangfang.tan@tax.mpg.de
 Chor Foon TANG=tcfoon@gmail.com
 Edward Chi Ho TANG=edward.c.h.tang@gmail.com
 Thomas Tangerås=thomas.tangeras@ifn.se
 Shaun M. Tanger=tangesm@auburn.edu
 Carsten Tanggaard=ctanggaard@creates.au.dk
 Kam Ki Tang=kk.tang@uq.edu.au
 Ke Tang=ketang@ruc.edu.cn
 Kewei Tang=tang_ke_wei@hotmail.com
 Linyao Tang=tanglinyao@gmail.com
 Meng-Chi Tang=ecdmct@ccu.edu.tw
 Tuck Cheong Tang=tangtuckcheong@gmail.com
 Jeremy Tanguy=jeremy.tanguy@univ-lemans.fr
 Solenne Tanguy=solenne.tanguy@univ-lemans.fr
 Xueli Tang=xtang@deakin.edu.au
 Yao Tang=ytang@bowdoin.edu
 Kiyoshi Taniguchi=ktaniguchi@adb.org
 Angelo Ballesteros Taningco=angelo.taningco@gmail.com
 Jeff Tan=jeff.tan@aku.edu
 Jonathan Tan=jonathan.tan@nottingham.ac.uk
 Kang Yong Tan=kangyong.tan@gmail.com
 Mahamadou Roufahi TANKARI=mahamadoutankari@yahoo.fr
 Muhammad Tanko=ztanko2003@yahoo.com
 Clifford Tan Kuan Lu=cliffordtankuanlu@live.com.my
 Ling Hui Tan=ltan@imf.org
 Mingpeng Tan=tmp2611@163.com
 Robert Tannenwald=rtannen@brandeis.edu
 Mariah D. Tanner Ehmke=mehmke@uwyo.edu
 Evan Tanner=etanner@imf.org
 Tan Peck-Leong=pecktan1@gmail.com
 Aysıt Tansel=atansel@metu.edu.tr
 Roengchai Tansuchat=roengchaitan@gmail.com
 Tao Tan=taotan2008@126.com
 Wei Tan=wtan@ruc.edu.cn
 Ying Tan=ying.tan@okstate.edu
 Yong Tan=a.y.tan@hud.ac.uk
 Zhigang Tao=ztao@hku.hk
 Matias Tapia=matias@uchicago.edu
 Francis Tapon=francistapon@gmail.com
 Mariano E. Tappata=mariano.tappata@sauder.ubc.ca
 Stephen Tapp=stapp@irpp.org
 René Tapsoba=rtapsoba@imf.org
 Oana Cătălina Ţăpurică=oana.tapurica@yahoo.com
 Anders Taraldset=anders.taraldset@legeforeningen.no
 Miguel Angel Tarancon=miguelangel.tarancon@uclm.es
 Nikola Tarashev=nikola.tarashev@bis.org
 Linas Tarasonis=linas.tarasonis@univ-amu.fr
 Alexander Tarasov=alexander.tarasov@lrz.uni-muenchen.de
 Artur Tarassow=artur.tarassow@wiso.uni-hamburg.de
 Essaid Tarbalouti=e.tarbalouti@uca.ma
 Adina Ioana Tarcolea=tarcolea@wiwi.uni-frankfurt.de
 Malgorzata Tarczynska-Luniewska=maluni@poczta.fm
 Giulio Tarditi=giuliotarditi@yahoo.it
 Syed Ali Tarek=syedalitarek@gmail.com
 Muhammad Salman Tariq=salmantariq@gmail.com
 Daniel Tarka=dtarka@hotmail.co.uk
 Ornella Tarola=ornella.tarola@uniroma1.it
 Alessandro Tarozzi=alessandro.tarozzi@upf.edu
 Finn Tarp=finn.tarp@econ.ku.dk
 Benoit Tarroux=benoit.tarroux@univ-rennes1.fr
 Raffaele Tartaglia-Polcini=raffaele.tartagliapolcini@bancaditalia.it
 Valentina Tartari=vt.ino@cbs.dk
 Nori Tarui=nori@hawaii.edu
 Daliana Tascovici=dalianatascovici@yahoo.com
 Murat Tasdemir=tasdemir.phd@gmail.com
 Emcet O. Tas=etas@worldbank.org
 Tanase Tasente=tashy@tashy.ro
 Sherzod Nabiyevich Tashpulatov=stashpul@cerge-ei.cz
 Temel Taskin=temel.taskin@tcmb.gov.tr
 Fatma Taşkın=taskin@bilkent.edu.tr
 Alexandru Tasnadi=relationistul@yahoo.com
 Attila Tasnádi=attila.tasnadi@uni-corvinus.hu
 Troy Tassier=tassier@fordham.edu
 Giorgio Tassinari=giorgio.tassinari@unibo.it
 Yusuke Tateno=tateno0728@gmail.com
 John Tatom=jtatom@earthlink.net
 Didier Francis Tatoutchoup=dtatoutchoup@glendon.yorku.ca
 Konstantinos Tatsiramos=tatsiramos@iza.org
 Giuseppe Tattara=tattara@unive.it
 Robert Tatum=rtatum@unca.edu
 George Tauchen=george.tauchen@duke.edu
 Harald Tauchmann=harald.tauchmann@wiso.uni-erlangen.de
 Cleiton Guollo Taufemback=taufemback.cg@gmail.com
 Emmanuelle TAUGOURDEAU=taugour@univ-paris1.fr
 Arno Tausch=arno.tausch@uibk.ac.at
 Franziska Tausch=tausch@coll.mpg.de
 Hossein Tavakolian=tavakoliyanh@ut.ac.ir
 Jose Ignacio Tavara=jose.tavara@pucp.pe
 Jose Tavares=jtavares@fe.unl.pt
 Lara Patrício Tavares=ltavares@iscsp.ulisboa.pt
 Priscilla Albuquerque Tavares=priscilla.albuquerque.tavares@gmail.com
 Sam M. Tavassoli=sam.tavassoli@bth.se
 Christophe Tavéra=christophe.tavera@univ-rennes1.fr
 George S. Tavlas=gtavlas@bankofgreece.gr
 Alessandro Tavoni=a.tavoni@lse.ac.uk
 Massimo Tavoni=massimo.tavoni@feem.it
 Tchai Tavor=tchait@yvc.ac.il
 Anthony S Tay=anthonytay@smu.edu.sg
 William John Tayler=w.tayler@lancaster.ac.uk
 Alan M. Taylor=amtaylor@ucdavis.edu
 Beck A. Taylor=btaylor@whitworth.edu
 Jennis Jean Taylor Biser=jennisbiser@yahoo.com
 Greg Taylor=greg.taylor@oii.ox.ac.uk
 John B. Taylor=john.taylor@stanford.edu
 Karl Taylor=k.b.taylor@shef.ac.uk
 Laura O. Taylor=laura_taylor@ncsu.edu
 Leon Taylor=taylorleon@aol.com
 Mark P. Taylor=mark.taylor@wbs.ac.uk
 Mark Philip Taylor=mp.t@hotmail.co.uk
 Mark Zachary Taylor=mzak@gatech.edu
 Michael Hugh Taylor=mtaylor@cabnr.unr.edu
 M. Scott Taylor=mstaylor@ucalgary.ca
 Mykel R. Taylor=mtaylor@ksu.edu
 Simon Taylor=s.taylor@jbs.cam.ac.uk
 Tim Taylor=timothy.j.taylor@exeter.ac.uk
 Erol Taymaz=etaymaz@metu.edu.tr
 Richard Tay=rtay888@gmail.com
 Fulbert Tchana Tchana=ftchanatchana@worldbank.org
 Rusty Tchernis=rtchernis@gsu.edu
 Plamen D. Tchipev=tchipev@iki.bas.bg
 Edinaldo Tebaldi=etebaldi@bryant.edu
 Pietro Tebaldi=ptebaldi@stanford.edu
 Adam James Tebble=adam.tebble@kcl.ac.uk
 Lindsay M. Tedds=ltedds@uvic.ca
 Gabriele Tedeschi=g.tedeschi@univpm.it
 Paolo Tedeschi=paolo.tedeschi@unimib.it
 Piero Tedeschi=piero.tedeschi@unicatt.it
 Nathan Tefft=tefft@uw.edu
 Simon Teitel=steitel@starpower.net
 Sorin Ciprian Teiusan=cteiusan@yahoo.com
 Antonio Carlos Fernandes Teixeira=antonio-carlos.teixeira@ec.europa.eu
 Arilton Teixeira=arilton@fucape.br
 Aurora Amélia Castro Teixeira=ateixeira@fep.up.pt
 Rui Pedro Teixeira Dias=rui.dias@escp-eap.net
 Joanílio Rodolpho Teixeira=joanilioteixeira@hotmail.com
 Joao C. A. Teixeira=jteixeira@uac.pt
 Paulino Teixeira=pteixeira@fe.uc.pt
 Rudolph Fabiano Alves Pedroza Teixeira=rudolphgp@hotmail.com
 Cesar Augusto Oviedo Tejada=cesaroviedotejada@gmail.com
 Mauricio Tejada=matejada@uahurtado.cl
 Joan Miguel Tejedor Estupiñán, Sr.=joantejedor@yahoo.com.mx
 Necati Tekatli=necati.tekatli@tcmb.gov.tr
 Mahmut Tekçe=mtekce@marmara.edu.tr
 Hasan Tekgüç=htekguc@gmail.com
 Erdal Tekin=tekin@gsu.edu
 Ayca Tekin-Koru=ayca.tekinkoru@tedu.edu.tr
 Erdinc Telatar=erdinc.telatar@okan.edu.tr
 Funda Telatar=ftelatar@hacettepe.edu.tr
 Pedro Teles=pteles@ucp.pt
 Vladimir Kuhl Teles=vladimir.teles@fgv.br
 Shqiponja Telhaj=s.telhaj@lse.ac.uk
 Santiago Téllez=stelleal@banrep.gov.co
 Mario Delfin Tello=mtello@pucp.edu.pe
 Daniela Tellone=daniela.tellone@gmail.com
 Chris Telmer=chris.telmer@cmu.edu
 Irina A. Telyukova=itelyukova@ucsd.edu
 Tugrul Temel=t.temel@ecorec.org
 Della Yeannie Arsyad Temenggung=della_temenggung@yahoo.com
 Judit Temesvary=jtemesva@hamilton.edu
 Peter Temin=ptemin@mit.edu
 Jerry Henry Tempelman=j48t@yahoo.com
 Judy A. Temple=jtemple@umn.edu
 Ted Temzelides=tedt@rice.edu
 Simona Tenaglia=simten72@hotmail.com
 Juan de Dios Tena=jtena@est-econ.uc3m.es
 Antonio Tena Junguito=antonio.tena@uc3m.es
 Arie ten Cate=a.ten.cate@cpb.nl
 Sven Tengstam=sven.tengstam@economics.gu.se
 Michel Tenikue=michel.tenikue@ceps.lu
 Thijs ten Raa=tenraa@uvt.nl
 Silvana Tenreyro=s.tenreyro@lse.ac.uk
 Désirée Teobaldelli=desiree.teobaldelli@uniurb.it
 Vatuiu Teodora=vatuiu_teodora@yahoo.com
 Nicolae Teodorescu=teodorescu.nicolae@gmail.com
 Armindo dos Santos de Sousa Teodósio=teodosio@pobox.com
 Ernie Gin Swee Teo=ernieteo@smu.edu.sg
 Özgür Teoman=ozgurt70@hotmail.com
 Wing Leong Teo=wingleong.teo@nottingham.edu.my
 Roee Teper=rteper@pitt.edu
 Grigorii Vasilievich Teplykh=teplykhgv@gmail.com
 Miron Tequame=miron.tequame@fundp.ac.be
 Yaz Terajima=yterajima@bankofcanada.ca
 Shinji Teraji=steraji@yamaguchi-u.ac.jp
 Yuki Teranishi=yukitera@fbc.keio.ac.jp
 Timo Teräsvirta=tterasvirta@econ.au.dk
 Eugen Tereanu=etereanu@imf.org
 Jenke ter Horst=j.r.terhorst@uvt.nl
 Siri Terjesen=terjesen@indiana.edu
 Daniele Terlizzese=daniele.terlizzese@bancaditalia.it
 Valeria Termini=vtermini@uniroma3.it
 Pietro Terna=pietro.terna@unito.it
 Stephen I. Ternyik=stephenjehucal@web.de
 Antoine Terracol=terracol@univ-paris1.fr
 Maria Cristina T. Terra=cristina.terra@u-cergy.fr
 Fábio Henrique Bittes Terra, Sr.=fhbterra@yahoo.com.br
 Rafael Terra=rterra@unb.br
 Marco E. Terrones=mterrones@imf.org
 Chris Terry=chris.terry@uts.edu.au
 Michele Tertilt=tertilt@uni-mannheim.de
 Mercedes Teruel Carrizosa=mercedes.teruel@urv.cat
 Graciela Teruel=graciela.teruel@s2.uia.mx
 Juha Tervala=juha.tervala@helsinki.fi
 Hannu Tervo=hannu.t.tervo@jyu.fi
 Joseph Vincent Terza=jvterza@iupui.edu
 Andrea Terzi=aterzi@fc.edu
 Bilge Terzioglu=biterzio@isikun.edu.tr
 Ilinka Terziyska=lynnterziyska@gmail.com
 Linda L. Tesar=ltesar@umich.edu
 Delia Teselios=delia_teselios@yahoo.com
 Garrett TeSelle=gteselle@gmail.com
 Leigh Tesfatsion=tesfatsi@iastate.edu
 Kensuke Teshima=kensuke.teshima@itam.mx
 luc Tessier=luc.tessier@univ-mlv.fr
 Silvia Testarmata=testarmata@economia.uniroma2.it
 Abdelaziz Testas=testas@pub1.qz.fj.cn
 Aleksey Tetenov=aleksey.tetenov@carloalberto.org
 Bruce S. Tether=bruce.tether@mbs.ac.uk
 Robert Tetlow=robert.j.tetlow@frb.gov
 Morris Teubal=msmorris76@gmail.com
 Marek Antoni Teuerle=marek.teuerle@pwr.wroc.pl
 C. N. Teulings=c.n.teulings@uva.nl
 Frédéric Teulon=f.teulon@ipag.fr
 Dirk Willem te Velde=dw.tevelde@odi.org.uk
 Kerem Tezic=kerem.tezic@afaforsakring.se
 Yunyong Thaicharoen=yunyongt@bot.or.th
 Nalitra Thaiprasert=nalitra@gmail.com
 Anjan V. Thakor=thakor@wustl.edu
 Eleftherios Ioannis Thalassinos=thalassi@unipi.gr
 Philippe Thalmann=philippe.thalmann@epfl.ch
 Andreas Thams=andreas.thams@wiwiss.fu-berlin.de
 Constantine Thanassoulas=thanac@aol.com
 John Ernest Thanassoulis=john.thanassoulis@wbs.ac.uk
 Paul Howard Thangata=pthangata@bt-associates.org
 Aditi Thapar=aditi.thapar@nyu.edu
 Rajesh Tharyan=r.tharyan@ex.ac.uk
 Kian Wie THEE=theekw@cbn.net.id
 Bernd Theilen=bernd.theilen@urv.es
 Erik Theissen=theissen@uni-mannheim.de
 Véronique Thelen=veronique.thelen@univ-rennes1.fr
 Thomas Theobald=thomas-theobald@boeckler.de
 Nicholas J. Theocarakis=ntheocar@econ.uoa.gr
 George Theocharides=georget@ciim.ac.cy
 Konstantinos Theodoridis=konstantinos.theodoridis@bankofengland.co.uk
 Panayiotis Theodossiou=p.theodossiou@cut.ac.cy
 Jacques Thépot=thepot@cournot.u-strasbg.fr
 Véronique Thériault=theria13@msu.edu
 Pierre-Emmanuel Thérond=pierre@therond.fr
 Pierre Therrien=pierre.therrien@ic.gc.ca
 Martin Theuringer=martin.theuringer@wvstahl.de
 Olivier Thévenon=olivier.thevenon@ined.fr
 Christoph Thewes=thewes@uni-potsdam.de
 Baba THIAM=baba.thiam@univ-lille3.fr
 Emmanuel Thibault=emmanuel.thibault@univ-tlse1.fr
 Thomas G. Thibodeau=tom.thibodeau@colorado.edu
 Rainer Thiele=rainer.thiele@ifw-kiel.de
 Veikko Thiele=vthiele@business.queensu.ca
 Petra Thiemann=petra.thiemann@unisg.ch
 Lutz Thieme=thieme@rheinahrcampus.de
 Mara Thiene=mara.thiene@unipd.it
 Alain Thierstein=thierstein@tum.de
 Clifford F. Thies=cthies@su.edu
 Jackson Thies=jacksonthies@gmail.com
 Dawn D. Thilmany=thilmany@lamar.colostate.edu
 Christian Thimann=christian.thimann@axa.com
 Lardia Marcel THIOMBIANO=lardia.marcel@gmail.com
 Anthony Thirlwall=a.p.thirlwall@kent.ac.uk
 Harsha Thirumurthy=harsha@unc.edu
 Geraldine Thiry=contact@geraldinethiry.be
 Jacques Thisse=jacques.thisse@uclouvain.be
 Eric Thivant=eric.thivant@univ-lyon3.fr
 Jean-Claude Thoenig=jeanclaude.thoenig@free.fr
 Mathias Thoenig=mathias.thoenig@unil.ch
 Christoph Thoenissen=c.thoenissen@sheffield.ac.uk
 Apostolos Thomadakis=a.thomadakis@lse.ac.uk
 Grid L. D. Thoma=grid05@gmail.com
 Alban Thomas=thomas@toulouse.inra.fr
 Alex M. Thomas=alexmthomas@gmail.com
 Bejoy K. Thomas=bejoykt@yahoo.com
 Carlos Thomas=carlos.thomas@bde.es
 Caroline D. Thomas=caroline.thomas@austin.utexas.edu
 Charles J. Thomas=charlesjthomasphd@gmail.com
 Desmond Thomas=desthom@gmail.com
 Diana W. Thomas=diana.thomas@usu.edu
 Duncan Thomas=dt@d-thomas.org
 Jonathan Thomas=jonathan.thomas@ed.ac.uk
 Kenneth Thomas=khthomas@wharton.upenn.edu
 Niels Peter Thomas=niels.thomas@springer.com
 Ranjeeta Thomas=ranjeeta.thomas@imperial.ac.uk
 Ryland Thomas=ryland.thomas@bankofengland.co.uk
 Anna Thomasson=anna.thomasson@fek.lu.se
 Melissa Thomasson=thomasma@muohio.edu
 Susan Thomas=susant@igidr.ac.in
 Timothy Scott Thomas=t.s.thomas@cgiar.org
 Tim Paul Thomes=tim.thomes@whu.edu
 Brennan Scott Thompson=brennan@ryerson.ca
 Frank Thompson=fthom@umich.edu
 Fred Thompson=fthompso@willamette.edu
 Gary D. Thompson=garyt@ag.arizona.edu
 Henry Thompson=thomph1@auburn.edu
 James R. Thompson=james@uwaterloo.ca
 Paul B. Thompson=thomp649@msu.edu
 Peter Thompson=peter.thompson@scheller.gatech.edu
 Robert Thompson=bob.thompson@dial.pipex.com
 Sarahelen Thompson=sally.thompson@bea.gov
 Rodney Thom=rodney.thom@ucd.ie
 Stephan Lothar Thomsen=thomsen@niw.de
 James B. Thomson=thomson1@uakron.edu
 Russell Thomson=russell.thomson@unimelb.edu.au
 Kaj Thomsson=k.thomsson@maastrichtuniversity.nl
 Christian Thöni=christian.thoeni@unil.ch
 Willem Thorbecke=willem-thorbecke@rieti.go.jp
 Emanuel David Thorne=ethorne@aya.yale.edu
 Daniel Thornton=thornton@stls.frb.org
 James Thornton=jthornton@emich.edu
 Jeremy Thornton=jpthornt@samford.edu
 John Thornton=j.thornton@bangor.ac.uk
 Mark Thornton=mthornton@mises.org
 Michael Alan Thornton=michael.thornton@york.ac.uk
 Sylvie Thoron=sylvie.thoron@u-pec.fr
 Susan Thorp=susan.thorp@uts.edu.au
 Bo Jellesmark Thorsen=bjt@life.ku.dk
 Paul Thorsnes=paul.thorsnes@otago.ac.nz
 Francisco Thoumi=fthoumi@gmail.com
 Sophie Thoyer=thoyer@supagro.inra.fr
 Cameron S. Thraen=thraen.1@osu.edu
 Charles David Throsby=david.throsby@mq.edu.au
 Elisabeth THUELIN=elisabeth.thuelin@dauphine.fr
 Per Thulin=pthulin@abe.kth.se
 Marcel P. Thum=marcel.thum@tu-dresden.de
 Kannan Thuraisamy=kannant@deakin.edu.au
 Linc Thurecht=linc.thurecht@natsem.canberra.edu.au
 Roy Thurik=thurik@ese.eur.nl
 Jerry Thursby=jerry.thursby@mgt.gatech.edu
 Jing Tian=jing.tian@utas.edu.au
 Kun Tian=tiank1@cardiff.ac.uk
 Lihui George Tian=ltian@nankai.edu.cn
 Meng Tian=caroltianmeng@gmail.com
 Mo Tian=motian.pb@gmail.com
 Nan Tian=nan.tian@uct.ac.za
 Xi Tian=tian@okstate.edu
 Xuan Tian=tianx@indiana.edu
 Yongge Tian=yongge.tian@gmail.com
 Luca Tiberti=ltiberti@gmail.com
 Luisa Tibiletti=luisa.tibiletti@unito.it
 Michela Tiboni=michela.tiboni@ing.unibs.it
 Josip Tica=jtica@efzg.hr
 Elisa Ticci=ticci4@unisi.it
 Mihai Tichindelean=mihaitichi@yahoo.com
 Ariane Tichit=ariane.tichit@u-clermont1.fr
 Adam Tickell=adam@tickell.org.uk
 Mabel Maria Tidball=tidball@supagro.inra.fr
 Tim Tiefenbach=tiefenbach@dijtokyo.org
 Laura Tiehen=ltiehen@ers.usda.gov
 Thomas K. Tiemann=tiemann@elon.edu
 Heather L.R. Tierney=hlrtierney@yahoo.com
 Richard Tiffin=j.r.tiffin@reading.ac.uk
 Dorina Tila=economics@dtila.com
 Cosmin Tileaga=cosmin.tileaga@ulbsibiu.ro
 Cédric Tille=cedric.tille@graduateinstitute.ch
 Riccardo Tilli=riccardo.tilli@uniroma1.it
 John E. Tilton=jtilton@mines.edu
 Xavier Timbeau=xavier.timbeau@ofce.sciences-po.fr
 Thomas Timberg=ttimberg@nathaninc.com
 Govinda R. Timilsina=gtimilsina@worldbank.org
 Allan Timmermann=atimmerm@ucsd.edu
 Martina Timmermann=m.timmermann@tima-gmbh.de
 Bram Timmermans=bram@business.aau.dk
 Marcel Peter Timmer=m.p.timmer@rug.nl
 Jason Craig Timmins=jason.timmins@dol.govt.nz
 Carmen Timofte=carmen@ase.ro
 Kevin Timoney=kevin.timoney@gmail.com
 Giuseppe Timpanaro=giuseppe.timpanaro@unict.it
 Deniz Timurcin=dtimurcin@gmail.com
 Dustin H. Tingley=dtingley@gov.harvard.edu
 Jan Tin=jantin4@hotmail.com
 Katrin Tinn=k.tinn@imperial.ac.uk
 Miguel Angel Tinoco-Zermeño=mangel.tinoco@gmail.com
 Peter Tinsley=tinsleypa@gmail.com
 Felix Tintelnot=felixt@princeton.edu
 Daniel Tirado=datir@eco.ub.es
 Mario Tirelli=tirelli@uniroma3.it
 Patrizio Tirelli=patrizio.tirelli@unimib.it
 Nyasha Tirivayi=nyasha.tirivayi@maastrichtuniversity.nl
 Adriana Tiron Tudor=adriana.tiron@econ.ubbcluj.ro
 S. Tolga Tiryaki=tolga.tiryaki@tcmb.gov.tr
 Clement Tisdell=c.tisdell@economics.uq.edu.au
 Deniss Titarenko=denisst79@gmail.com
 Daniel Titelman K=daniel.titelman@cepal.org
 Birinder Singh Tiwana=birinder.tiwana@gmail.com
 Aviral Kumar Tiwari=aviral.eco@gmail.com
 Piyush Tiwari=p.tiwari@abdn.ac.uk
 Rajnish Tiwari=tiwari@tuhh.de
 Sailesh Tiwari=stiwari@worldbank.org
 Stéphane TIZIO=stephane.tizio@u-bourgogne.fr
 Ari Tjahjawandita=aritjahja@fe.unpad.ac.id
 Raymond R. Tjandrawinata=raytjan@yahoo.com
 Sigve Tjøtta=sigve.tjotta@econ.uib.no
 Olegs Tkacevs=olegs.tkacevs@gmail.com
 Oleksandr Tkachuk=atkachuk@ideas.org.ua
 Greg Tkacz=gtkacz@stfx.ca
 Marina Tkalec=mtkalec@eizg.hr
 Valentin Toader=valentin.toader@tbs.ubbcluj.ro
 Aurelio Tobias=aurelio.tobias@gmail.com
 Justin Tobias=jltobias@purdue.edu
 Damian Tobin=dt29@soas.ac.uk
 Alexander Tobon=atobon@u-paris10.fr
 Barbara Tocco=bt86@kent.ac.uk
 Kiril Tochkov=k.tochkov@tcu.edu
 Alexis Akira Toda=atoda@ucsd.edu
 Jessica Erin Todd=jtodd@ers.usda.gov
 Michael Todd=mjt7@cornell.edu
 Alexandru Todea=alexandru.todea@econ.ubbcluj.ro
 Ramona Todericiu=ramona.todericiu@ulbsibiu.ro
 Filon TODEROIU=filon@eadr.ro
 Emanuela Todeva=e.todeva@surrey.ac.uk
 Tamara Peneva Todorova=ttodorova@aubg.bg
 Yasuyuki Todo=yastodo@gmail.com
 Franz Tödtling=franz.toedtling@wu.ac.at
 Adina Cezarina TOFAN=catadina1@gmail.com
 Sübidey Togan=togan@bilkent.edu.tr
 Sahar Tohamy=sahartohamy2002@yahoo.com
 Luis Toharia=luis.toharia@uah.es
 Fernando Tohmé=ftohme@criba.edu.ar
 Otto Toivanen=otto.toivanen@econ.kuleuven.be
 Ilan D. Tojerow=itojerow@ulb.ac.be
 Emre Omer Tokel=etokel@gmail.com
 Andrea Paula Tokman=andrea.tokman@mail.udp.cl
 Sessi Tokpavi=sessi.tokpavi@u-paris10.fr
 Yılmaz Toktaş=toktasyilmaz@gmail.com
 Kiichi Tokuoka=kiichi.tokuoka@gmail.com
 Manuel E. Toledo=m.toledo@itam.mx
 Robert Tollison=rtollis@clemson.edu
 Marco Tolotti=tolotti@unive.it
 Richard S.J. Tol=r.tol@sussex.ac.uk
 Camelia Toma=cameliatoma2004@yahoo.fr
 Luiza Toma=luiza.toma@sruc.ac.uk
 Yoshihiro Tomaru=yoshihiro.tomaru@gmail.com
 Chiara Tomasi=c.tomasi@sssup.it
 Mário Rui Tomás=mariotom.nanet@gmail.com
 Federico Tomassi=federico.tomassi@uniroma1.it
 Mark Tomass=tomass@fas.harvard.edu
 Christis Tombazos=christis.tombazos@monash.edu
 Trevor Tombe=ttombe@ucalgary.ca
 Guilherme Alexandre Tombolo=guilhermetombolo@ufpr.br
 Emilia Tomczyk=emilia.tomczyk@sgh.waw.pl
 Jakub Tomczyk=jstomczyk@gmail.com
 Bojan Tomić=btomic@vsfp.eu
 Iva Tomić=itomic@eizg.hr
 Emma Tominey=emma.tominey@york.ac.uk
 富岡淳 (Jun Tomioka)=tomiokaj@bb.nebuta.ac.jp
 Ben Tomlin=btomlin@bankofcanada.ca
 Philip R. Tomlinson=p.r.tomlinson@bath.ac.uk
 Chiara Tommasi=chiara.tommasi@unimi.it
 Mariano Tommasi=tamara@udesa.edu.ar
 Pietro Tommasino=pietro.tommasino@bancaditalia.it
 Anna Tomová=anna.tomova@fpedas.uniza.sk
 Paul Tompkinson=paul.tompkinson@vuw.ac.nz
 William Tompson=william.tompson@oecd.org
 Steven Toms=j.s.toms@leeds.ac.uk
 Hajime Tomura=tomura.hajime@gmail.com
 Davide Tondani=davide.tondani@unipr.it
 Gabriele Tondl=gabriele.tondl@wu.ac.at
 Stefano Federico Tonellato=stone@unive.it
 Marco Tonello=marco.tonello@bancaditalia.it
 Christopher Tonetti=tonetti@stanford.edu
 Howell Tong=howell.tong@gmail.com
 Hui Tong=htong@imf.org
 Unal Tongur=tongur@metu.edu.tr
 PierAngelo Maria Toninelli=pierangelo.toninelli@unimib.it
 Mirco Tonin=m.tonin@soton.ac.uk
 Gianni Toniolo=giannit@econ.duke.edu
 Ian Tonks=i.tonks@bath.ac.uk
 Jaromir Tonner=jtonner@seznam.cz
 Morten Tønnessen=mortentoennessen@gmail.com
 Akiyuki Tonogi=tonogi.akiyuki@gmail.com
 Glynn T. Tonsor=gtonsor@ksu.edu
 Özgür Tonus=otonus@anadolu.edu.tr
 Lena Tonzer=lena.tonzer@eui.eu
 Geoffrey M. B. Tootell=geoff.tootell@bos.frb.org
 Giorgio Topa=giorgio.topa@ny.frb.org
 Mihai Vladimir Topan=mihai.topan@rei.ase.ro
 Metin Toprak=metin.toprak@gmail.com
 Kudret Topyan=kudret.topyan@manhattan.edu
 Pascal Toquebeuf=pascal.toquebeuf@upmf-grenoble.fr
 Maximo Torero=m.torero@cgiar.org
 Edgardo Torija Zane=edgardotz@gmail.com
 Giuseppe Torluccio=giuseppe.torluccio@unibo.it
 Leopoldo Tornarolli=ltornarolli@cedlas.org
 Daniel Toro González=dtoro@unitecnologica.edu.co
 Andrzej Torój=andrzej.toroj@gmail.com
 Andre Torre=torre@agroparistech.fr
 Carmelo Maria Torre=torre@poliba.it
 Dominique Torre=dominique.torre@gredeg.cnrs.fr
 Antonio de la Torre-Gallegos=atorre@us.es
 Sara Torregrosa-Hetland=storregrosa@ub.edu
 Fernando Torrejón-Flores=ftorrejon@ucam.edu
 Federico Rodriguez Torres=economicon_50@hotmail.com
 Fernando Torres=ftorres@tmvalue.com
 Catalina M. Torres Figuerola=cati.torres@uib.cat
 Francisco Torres=francisco.torres@sant.ox.ac.uk
 Alejandro Torres García=atorres7@eafit.edu.co
 Jhon Edwar Torres=jtorrego@banrep.gov.co
 Jose L. Torres=jtorres@uma.es
 José Luis Torres=jtorres@imf.org
 Sebastián Torres Ledezma=setorres@ucu.edu.uy
 Juan Pablo Torres-Martinez=juan.torres@fen.uchile.cl
 Nuno Torres=nnjtorres@gmail.com
 Víctor Hugo Torres Preciado=torrespreciado@ucol.mx
 Juan Manuel Torres Rojo=juanmanuel.torres@cide.edu
 F. Mauricio Torres Velásquez=maiciot@gmail.com
 Costanza Torricelli=torricelli.costanza@unimore.it
 Gianpiero Torrisi=gianpiero.torrisi@port.ac.uk
 Salvatore Torrisi=torrisi@unibo.it
 Eilya Torshizian=e.torshizian@auckland.ac.nz
 Ermanno Celeste Tortia=ermanno.tortia@unitn.it
 Valentina Tortolini=valetort@gmail.com
 Daniel Louis Tortorice=tortoric@brandeis.edu
 Emili Tortosa-Ausina=tortosa@eco.uji.es
 Orhan Torul=orhan.torul@boun.edu.tr
 Ragnar Torvik=ragnar.torvik@svt.ntnu.no
 Mehmet Serkan Tosun=tosun@unr.edu
 Csaba G. Tóth=tothgcs@gmail.com
 István György Tóth=toth@tarki.hu
 Istvan Janos Toth=tothij@econ.core.hu
 Jozsef Toth=jozsef.toth@uni-corvinus.hu
 Máté Barnabás Tóth=tothmat@mnb.hu
 Peter Tóth=peter.toth@mfsr.sk
 Kanellos Stulianos Toudas=a.toudas@cmc.gov.gr
 Alireza Tourani-Rad=atourani@aut.ac.nz
 Natalia Tourdyeva=ntourdyeva@cefir.ru
 Octavio Augusto Fontes Tourinho=octavio.tourinho@terra.com.br
 Didier Toussaint=didier.toussaint@umons.ac.be
 Julia Touza Montero=julia.touza@uvigo.es
 Mourad Touzani=mourad.touzani@laposte.net
 Vincent Touzé=vincent.touze@sciencespo.fr
 Camilo Ernesto Tovar=ctovar@imf.org
 Elisabeth Tovar=etovar@u-paris10.fr
 Edgar Demetrio Tovar Garcia=beno09@yahoo.com
 Jorge Andrés Tovar=jtovar@uniandes.edu.co
 Ramiro Tovar Landa=rtovar@itam.mx
 Patricia Tovar=ptovar@pucp.pe
 Miguel Angel Tovar Reanos=tovar@zew.de
 Charles A. Towe=ctowe@arec.umd.edu
 Edward Tower=tower@econ.duke.edu
 Flavio Toxvaerd=fmot2@cam.ac.uk
 Hideki Toya=toya@econ.nagoya-cu.ac.jp
 Toshihisa Toyoda=ttoyoda@shudo-u.ac.jp
 Yuki Toyoshima=makenaizard@yahoo.co.jp
 Mathias Trabandt=mathias.trabandt@gmail.com
 Emna Trabelsi=emna.trabelsi2007@yahoo.fr
 Mohamed Ali Trabelsi=daly1704@yahoo.fr
 Alessandra Tracogna=tracogna@csilmilano.com
 Constant I. Tra=constant.tra@unlv.edu
 Joseph Tracy=joseph.tracy@ny.frb.org
 Guido Traficante=guido.traficante@unier.it
 Diana Traikova=traikova@iamo.de
 William Bruce Traill=w.b.traill@reading.ac.uk
 Kenneth Train=train@econ.berkeley.edu
 Fabio Tramontana=fabio.tramontana@unipv.it
 Allen Tran=allentran@ucla.edu
 Jean-Pierre Tranchant=jp.tranchant@ids.ac.uk
 Tiago A. Trancoso=trancoso.tiago@gmail.com
 Dung Tri Tran=dungtrantri@yahoo.com
 Tommaso Trani=ttrani@unav.es
 Kien C. Tran=kien.tran@uleth.ca
 Nhi Hoang Tran=nhi.tran@vu.edu.au
 Alain Trannoy=alain.trannoy@eco.u-cergy.fr
 Emmanouil Tranos=e.tranos@vu.nl
 Thang Toan Tran=trantoanthang@mpi.gov.vn
 Tuan Huu Tran=tuantranhuu@yahoo.com
 Tuyen Quang Tran=tuyentq@vnu.edu.vn
 Hans Jørgen Tranvåg=tranvag@gmail.com
 Van Hoa Tran=tvheco@uow.edu.au
 Abel Jean Traoré=traorejeanabel@yahoo.fr
 Fousseini TRAORE=fousseini.traore@cgiar.org
 Stefan Traub=traub@uni-bremen.de
 Nora Traum=nora_traum@ncsu.edu
 Giuseppe Travaglini=giuseppe.travaglini@uniurb.it
 Guido Travaglini=jay_of_may@yahoo.com
 Chiara Maria Travisi=chiara.travisi@gmail.com
 Greg Traxler=lecenter99@yahoo.com
 Rowan Trayler=rowan.trayler@uts.edu.au
 Francesco Trebbi=ftrebbi@mail.ubc.ca
 Christoph Trebesch=christoph.trebesch@lmu.de
 Giorgio Trebeschi=giorgio.trebeschi@bancaditalia.it
 Carmine Trecroci=trecroci@eco.unibs.it
 Thomas Tregouet=thomas.tregouet@u-cergy.fr
 David Treguer=dtreguer@worldbank.org
 Bharat Trehan=bharat.trehan@sf.frb.org
 Tania Treibich=tania.treibich@gmail.com
 Nicolas TREICH=ntreich@toulouse.inra.fr
 Alejandra Berenice Trejo Nieto=abtrejo@colmex.mx
 Stephen J. Trejo=trejo@eco.utexas.edu
 Jean-François Tremblay=jean-francois.tremblay@uottawa.ca
 Rodrigue TREMBLAY=rodrigue.tremblay@umontreal.ca
 Ioan Trenca=itrenca2011@yahoo.com
 Carsten Trenkler=trenkler@uni-mannheim.de
 Stefano Trento=strento@compasslexecon.com
 Alfredo Trespalacios=alfredo.trespalacios@gmail.com
 Thierry Tressel=ttressel@imf.org
 John Tressler=tressler@waikato.ac.nz
 Lutz Trettin=lutz.trettin@rwi-essen.de
 Jonathan Treussard=jtreussa@bu.edu
 Elisabetta Trevisan=elisabetta.trevisan@unipd.it
 Alex William Trew=alex.trew@st-andrews.ac.uk
 Attilio Trezzini=trezzini@uniroma3.it
 Umberto Triacca=umberto.triacca@ec.univaq.it
 Giovanni Tria=tria@ceis.uniroma2.it
 Kostas Triantafyllopoulos=kostas@sheffield.ac.uk
 Evangelos Triantaphyllou=trianta@lsu.edu
 Michael Tribe=michael.tribe@strath.ac.uk
 Pierre Triboulet=pierre.triboulet@toulouse.inra.fr
 Pasquale Tridico=tridico@uniroma3.it
 Thomas Peter Triebs=triebs@ifo.de
 Robert K. Triest=robert.triest@bos.frb.org
 Neda Trifković=neda.trifkovic@econ.ku.dk
 Silvia Trifonova Trifonova=trifonovasilvia@yahoo.com
 Alexandru Trifu=alexandru.trifu@gmail.com
 Antonella Trigari=antonella.trigari@unibocconi.it
 Angela Triguero Cano=angela.triguero@uclm.es
 Timo Trimborn=timo.trimborn@wiwi.uni-goettingen.de
 Vitor Trindade=trindadev@missouri.edu
 Juan Evangelista Trinidad=jetrini@ual.es
 Urs Trinkner=urs.trinkner@swiss-economics.ch
 Matteo Triossi=mtriossi@dii.uchile.cl
 Amarnath Tripathi=amarnathtripathi@rediffmail.com
 Gautam Tripathi=gautam.tripathi@uni.lu
 Sabyasachi Tripathi=sabya.tripathi@gmail.com
 Sanjeev Tripathi=sanjeev@iimahd.ernet.in
 Fabien Tripier=fabien.tripier@univ-lille1.fr
 Michaela Trippl=michaela.trippl@circle.lu.se
 Oreste Tristani=oreste.tristani@ecb.int
 Ahmed Tritah=ahmed.tritah@univ-lemans.fr
 Giorgio Triulzi=triulzi@merit.unu.edu
 Pravin Trivedi=trivedi@indiana.edu
 Ugo Trivellato=trivell@stat.unipd.it
 Victor Troaca=victortroaca@yahoo.com
 Dumitru Troanca=dumitru.troanca@ulbsibiu.ro
 Walter Trockel=walter.trockel@uni-bielefeld.de
 Justin G. Trogdon=justintrogdon@unc.edu
 Ugo Troiano=troiano@umich.edu
 Irina A. Troitskaia=itro@econ.msu.ru
 Nataša Trojak=ntrojak@vsfp.eu
 Fabio Trojani=fabio.trojani@usi.ch
 Mirza Trokić=trokic@bilkent.edu.tr
 Michel Trommetter=michel@grenoble.inra.fr
 Nicolino Trompieri Neto=nicolino.trompieri@ipece.ce.gov.br
 Rodrigo Troncoso=rtroncoso@udd.cl
 Cristián Troncoso-Valverde=cristian.troncoso@udp.cl
 Leonello Tronti=l.tronti@sna.gov.it
 Domenica Tropeano=tropeano@unimc.it
 Kenneth R. Troske=ktroske@uky.edu
 Ronald G. Trostle=rtrostle@ers.usda.gov
 Robert Patrick Trost=trostr@cna.org
 Giovanni Trovato=giovanni.trovato@uniroma2.it
 Marta Troya Martinez=marta.troyamartinez@economics.ox.ac.uk
 Peter Gerard Troyan, Jr.=petetroyan@gmail.com
 Parvati Trübswetter=parvati.truebswetter@iab.de
 Christian Trudeau=trudeauc@uwindsor.ca
 Stefan Trueck=strueck@efs.mq.edu.au
 Lourdes Trujillo=ltrujillo@daea.ulpgc.es
 Antonio Trujillo-Ponce=atrujillo@upo.es
 Truong Phuoc Truong=truong.truong@sydney.edu.au
 Danilo Rogelio Trupkin=dtrupkin@um.edu.uy
 Konstantinos P. Tsagarakis=kandila@her.forthnet.gr
 Henghsiu Tsai=htsai@stat.sinica.edu.tw
 Jeffrey Tzuhao Tsai=d91723013@ntu.edu.tw
 Ming-Fang Tsai=mftsai@mail.tku.edu.tw
 Tsung-Sheng Tsai=tstsai@ntu.edu.tw
 Yuping Tsai=ytsai@cdc.gov
 Elias Tsakas=e.tsakas@maastrichtuniversity.nl
 Nikolas Tsakas=ntsakas@eco.uc3m.es
 Nikos Tsakiris=ntsak@cc.uoi.gr
 Persefoni V. Tsaliki=ptsaliki@econ.auth.gr
 Maria Tsampra=mtsampra@upatras.gr
 Charalambos G. Tsangarides=ctsangarides@imf.org
 Kwok Ping Tsang=byront@vt.edu
 Stella Tsani=s.cani@reading.ac.uk
 Jean-Paul Kimbambu Tsasa Vangu=jeanpaultsasa@lareq.com
 Maria Tsavdaridou=tsavdaridou@uth.gr
 Wen-Jen Tsay=wtsay@econ.sinica.edu.tw
 Rolf Tschernig=rolf.tschernig@wiwi.uni-regensburg.de
 David Tschirley=tschirle@msu.edu
 Adrian Tschoegl=tschoegl@alum.mit.edu
 Chung-Yi Tse=tsechung@econ.hku.hk
 Kyriaki Tsegenidi=ktseg@upatras.gr
 Kostas Tsekouras=tsekour@econ.upatras.gr
 Fu-Min Tseng=ftseng14@gmail.com
 Y. K. Tse=yktse@smu.edu.sg
 Maria Tsiapa=mtsiapa@uth.gr
 Sarantis Tsiaplias=stsiaplias@live.com
 Leonidas Tsiaras=l.tsiaras@aston.ac.uk
 Daniel Tsiddon=tsiddon@post.tau.ac.il
 Panagiotis Tsigaris=ptsigaris@tru.ca
 Kyriaki Dimitrios Tsilika=ktsilika@uth.gr
 Clarence Nkengne Tsimpo=ctsimponkengne@worldbank.org
 Efthymios Mike Tsionas=tsionas@aueb.gr
 Andreas Tsopanakis=a.tsopanakis@salford.ac.uk
 John Tsoukalas=john.tsoukalas@glasgow.ac.uk
 Dr. Christopher Tsoukis=c.tsoukis@londonmet.ac.uk
 Dimitris Tsouknidis=dtsouknidis@gmail.com
 Lefteris Tsoulfidis=lnt@uom.edu.gr
 Ekaterini Tsouma=etsouma@kepe.gr
 Chris Tsoumas=ctsoum@unipi.gr
 Nicholas K. Tsounis=tsounis@kastoria.teikoz.gr
 Aki Tsuchiya=a.tsuchiya@sheffield.ac.uk
 Yoichi Tsuchiya=ytsuchiya@rs.tus.ac.jp
 Albert K. C. Tsui=ecsatsui@nus.edu.sg
 Kevin K. Tsui=ktsui@clemson.edu
 Raquel Tsukada=tsukada@merit.unu.edu
 Tsuneo Tsukatani=tsuka@kinet-tv.ne.jp
 Takayuki Tsuruga=tsuruga@econ.kyoto-u.ac.jp
 Tetsuya Tsurumi=tsurumi@nanzan-u.ac.jp
 Viktor Tsyrennikov=vt68@cornell.edu
 Sandy Tubeuf=s.tubeuf@leeds.ac.uk
 Marilena Tucci=marilenalessandro@libero.it
 Michele Tuccio=m.tuccio@soton.ac.uk
 Catherine Tucker=cetucker@mit.edu
 Steven James Tucker=steven.tucker.nz@gmail.com
 Claudia Elena Tuclea=claudia.tuclea@com.ase.ro
 Andreas Tudyka=andreas.tudyka@whu.edu
 David Tuesta=david.tuesta@grupobbva.com
 Vicente Tuesta=vicentetuesta@gmail.com
 Fabio Tufano=fabio.tufano@nottingham.ac.uk
 David Tufte=tufte@suu.edu
 Jan Tuinstra=j.tuinstra@uva.nl
 Jiong Tu=jtu@lakeheadu.ca
 Jun Tu=tujun@smu.edu.sg
 Narcis Tulbure=narcis.tulbure@yahoo.com
 Luminita Tuleaşcă=luminita.tuleasca@tuleasca.com
 Henry Tulkens=henry.tulkens@uclouvain.be
 Norovsambuu Tumennasan=ntumennasan@econ.au.dk
 Semih Tumen=semihtumen@gmail.com
 Elif Tunali=elif.tunali@ege.edu.tr
 Cengiz Tunc=cengiz.tunc@tcmb.gov.tr
 Ruhi Tuncer=tuncer.ruhi@gmail.com
 Bertil Tungodden=bertil.tungodden@nhh.no
 Dr. Sanjay N. Tupe=sanjaytupein@yahoo.co.in
 Belgi Turan=bkturan@uh.edu
 Gilberto TURATI=gilberto.turati@unito.it
 Jana Turčínková=jana.turcinkova@mendelu.cz
 Aziz Turhan=azizturhan@yahoo.com
 Kemal TURKCAN=kturkcan@akdeniz.edu.tr
 Édouard Turkisch=edouard.turkisch@oecd.org
 Kulno Turk=kulno.turk@ut.ee
 Mehmet Turk=mehmet.turk@isbank.com.tr
 Nermin Ceren Türkmen=cerozer@yahoo.com.tr
 Gerard M. Turley=gerard.turley@nuigalway.ie
 Sean Turnell=sturnell@efs.mq.edu.au
 Brian Turner=b.turner@ucc.ie
 Chad S. Turner=chad.turner@tamucc.edu
 Graham Mark Turner=gturner@unimelb.edu.au
 John David Turner=j.turner@qub.ac.uk
 John Lovick Turner, V=jlturner@uga.edu
 Karen Turner=k.turner@hw.ac.uk
 Matthew Turner=mturner@chass.utoronto.ca
 Paul Turner=p.m.turner@lboro.ac.uk
 Robert W. Turner=rturner@colgate.edu
 Sarah Elizabeth Turner=sturner@virginia.edu
 Frantisek Turnovec=turnovec@mbox.fsv.cuni.cz
 Stephen J Turnovsky=sturn@u.washington.edu
 Theodore Turocy=t.turocy@uea.ac.uk
 Ivan Nicholas Turok=iturok@hsrc.ac.za
 Stéphane Turolla=stephane.turolla@rennes.inra.fr
 Hélène Turon=helene.turon-lacarrieu@bristol.ac.uk
 Cassio M. Turra=turra@cedeplar.ufmg.br
 Alessandro Turrini=alessandro.turrini@ec.europa.eu
 Jaime Turrión=jaime.turrion@uam.es
 Ciprian Ionel TURTUREAN=ciupan@yahoo.com
 Jarkko Turunen=jarkkoturunen@hotmail.com
 Ralph Turvey=mailturvey@gmail.com
 Antonella Tutino=tutino.antonella@gmail.com
 Laura Tuttle=tuttlel@sec.gov
 Anca Tutulea=anca.vacar@ulbsibiu.ro
 Onur Tutulmaz=otutulmaz@gmail.com
 Sukriye TUYSUZ=sukriye.tuysuz@yeditepe.edu.tr
 Didem Tuzemen=didem.tuzemen@kc.frb.org
 Manuela Tvaronaviciene=manuela.tvaronaviciene@vgtu.lt
 Ragnar Tveterås=ragnar.tveteras@uis.no
 Sigbjorn Tveteras=stveteras@pucp.pe
 Michal Tvrdoň=tvrdon@opf.slu.cz
 George Tweneboah=opokutweneboah@yahoo.com
 Tereza Tykvova=tereza.tykvova@uni-hohenheim.de
 John H. Tyler=john_tyler@brown.edu
 Jean-Robert Tyran=jean-robert.tyran@univie.ac.at
 Joanna Tyrowicz=j.tyrowicz@uw.edu.pl
 Marcelo Tyszler=marcelo@tyszler.com.br
 Panagiota Tzamourani=tetti_t@hotmail.com
 Dimitris Tzelepis=tzelepis@upatras.gr
 Nickolaos Tzeremes=bus9nt@econ.uth.gr
 Panagiotis Tziogkidis=tziogkidisp@cardiff.ac.uk
 Konstantinos Tzioumis=kostas.tzioumis@occ.treas.gov
