 Ebrima Faal=e.faal@afdb.org
 Daniele Fabbri=d.fabbri@unibo.it
 Giorgio Fabbri=giorgio.fabbri@uniparthenope.it
 Raul V. Fabella=raul.fabella@up.edu.ph
 Oliver Fabel=oliver.fabel@univie.ac.at
 Jason Faberman=jfaberman@frbchi.org
 Silvia Fabiani=silvia.fabiani@bancaditalia.it
 Richard Fabling=richard.fabling@motu.org.nz
 Frank J. Fabozzi=frank.fabozzi@edhec.edu
 Natalia Fabra=nfabra@eco.uc3m.es
 Elodie Fabre=e.fabre@qub.ac.uk
 Annalisa Fabretti=annalisa.fabretti@uniroma2.it
 Simona Fabrizi=s.fabrizi@massey.ac.nz
 Nathalie Fabry=nathalie.fabry@univ-mlv.fr
 Gilbert Faccarello=gilbert.faccarello@u-paris2.fr
 Francois Facchini=francois.facchini@u-psud.fr
 Giovanni Facchini=giovanni.facchini@nottingham.ac.uk
 Renato Faccini=r.faccini@qmul.ac.uk
 Mara Faccio=mfaccio@purdue.edu
 Uwe Fachinger=uwe.fachinger@uni-vechta.de
 Stefano Fachin=stefano.fachin@uniroma1.it
 Mehdi Fadaee=m.fadaee@imps.ac.ir
 Harald Fadinger=harald.fadinger@univie.ac.at
 Ειρήνη Φαφαλιού (Irene Fafaliou)=fafaliou@unipi.gr
 Marcel Fafchamps=fafchamp@stanford.edu
 Gabriel Fagan=gabriel.fagan@ecb.int
 Stephen Fagan=stephenpfagan@gmail.com
 Jan Ernst Fagerberg=jan.fagerberg@tik.uio.no
 Andreas Fagereng=afagereng@gmail.com
 Sonja Fagernäs=s.a.e.fagernas@sussex.ac.uk
 Alessandra Faggian=faggian.1@osu.edu
 Silvia Faggian=faggian@unive.it
 Giulia Faggio=g.faggio1@lse.ac.uk
 Nezameddin Faghih=faghihnezam@yahoo.com
 Giorgio Fagiolo=giorgio.fagiolo@sssup.it
 Mohamad Fahmi=mfahmi@fe.unpad.ac.id
 Stefan Sebastian Fahrländer=sf@fpre.ch
 René Fahr=rene.fahr@uni-paderborn.de
 Stephan Alexander Fahr=stephan.fahr@ecb.europa.eu
 Ester Faia=faia@wiwi.uni-frankfurt.de
 Ulrich Faigle=faigle@zpr.uni-koeln.de
 Miquel Faig=mfaig@chass.utoronto.ca
 Jürgen Faik=juergen@faik.net
 Marco Faillo=marco.faillo@unitn.it
 Itay P. Fainmesser=itay_fainmesser@brown.edu
 Xavier Fairise=xavier.fairise@univ-lemans.fr
 Kim Fairley=k.fairley@fm.ru.nl
 Robert W. Fairlie=rfairlie@ucsc.edu
 Ray Fair=ray.fair@yale.edu
 Azeema Faizunnisa=azeema@gmail.com
 Jose Santiago Fajardo Barbachan=pepefb@gmail.com
 Luis Eduardo Fajardo=lfajardo@urosario.edu.co
 Pablo D. Fajgelbaum=pfajgelbaum@econ.ucla.edu
 Fathi FAKHFAKH=fathi.fakhfakh@u-paris2.fr
 Ali Fakih=afakih@lau.edu.lb
 Evangelos M. Falaris=falaris@udel.edu
 Antonio Falato=antonio.falato@frb.gov
 Torberg Falch=torberg.falch@svt.ntnu.no
 Oliver Falck=falck@ifo.de
 José Benjamin Falck Zepeda=j.falck-zepeda@cgiar.org
 Paolo Falco=paolo.falco@gmail.com
 Marcin Faldzinski=marf@umk.pl
 Alaeddine Faleh=alaeddinefaleh@yahoo.fr
 Armin Falk=armin.falk@uni-bonn.de
 Martin Falk=martin.falk@wifo.ac.at
 El Hadji Fall=el.hadji.fall@undp.org
 Vittorio Falletti=falletti@libero.it
 Bruce Fallick=bruce.fallick@frb.gov
 Francesco Fallucchi=francesco.fallucchi@nottingham.ac.uk
 Thibault FALLY=fally@berkeley.edu
 Rodney Edward Falvey=rfalvey@bond.edu.au
 Anna Maria Falzoni=anna.falzoni@unibocconi.it
 Eugene F. Fama, Sr.=eugene.fama@gsb.uchicago.edu
 Phillip Fanchon=pfanchon@calpoly.edu
 C. Simon Fan=fansimon@ln.edu.hk
 Domenico Fanelli=domenico.fanelli@gmail.com
 Luca Fanelli=luca.fanelli@unibo.it
 Elliott Fan=elliottfan@ntu.edu.tw
 Hanming Fang=hanming.fang@econ.upenn.edu
 Lei Fang=lei.fang@atl.frb.org
 Tony Fang=tony.fang@monash.edu
 WenShwo Fang=wsfang@fcu.edu.tw
 Ying Fang=yifst1@gmail.com
 Yiwei Fang=yfang15@stuart.iit.edu
 Yue Fang=yfang@darkwing.uoregon.edu
 Zheng Fang=fang0031@ntu.edu.sg
 Jing Fan=samfanjing@yahoo.com.cn
 Liang-cong Fan=flc1984@163.com
 Maoyong Fan=mfan@bsu.edu
 Shenggen Fan=s.fan@cgiar.org
 Dean Fantazzini=deanfa@eco.unipv.it
 Luciano Fanti=lfanti@ec.unipi.it
 Davide Fantino=davide.fantino@bancaditalia.it
 Xibo Fan=xibofan@jhu.edu
 Ying Fan=yingfan@umich.edu
 Elisa Faraglia=ef307@cam.ac.uk
 Helmut Farbmacher=farbmacher@mea.mpisoc.mpg.de
 Davood Farbod=d.farbod@gmail.com
 Mario Nuno Farelo=m.farelo@fct.unl.pt
 Sahbi FARHANI=sahbi.farhani@ipag.fr
 Abdeljelil FARHAT=abdeljelil.farhat@umontreal.ca
 Emmanuel Farhi=efarhi@harvard.edu
 Ana Paula Faria=apfaria@eeg.uminho.pt
 Andre Faria=alfaria@alumni.uchicago.edu
 Miguel Faria e Castro=mfariacastro@fe.unl.pt
 Joao Ricardo Faria=rfaria2@utep.edu
 Pablo Farías=pablofariasnazel@yahoo.com
 Muhammad Zahir Faridi=zahirfaridi@bzu.edu.pk
 Jose C. Fariñas=farinas@ccee.ucm.es
 Vincenzo Farina=vincenzo.farina@uniroma2.it
 Mira Farka=efarka@fullerton.edu
 Beatrice Farkas=bfarkas@diw.de
 Peter Farkas=farkas_peter@ceu-budapest.edu
 Kristine Farla=farla@merit.unu.edu
 J. Doyne Farmer=jdf@santafe.edu
 Roger E. A. Farmer=rfarmer@econ.ucla.edu
 Martin Farnham=mfarnham@uvic.ca
 Erika Färnstrand Damsgaard=erika.farnstrand.damsgaard@konj.se
 José Heleno Faro=jhfaro@gmail.com
 Stefano Farolfi=farolfi@cirad.fr
 Abdul Farooq=farooqcomsats@gmail.com
 Lidia Farré=lidia.farre@iae.csic.es
 Greg Farrell=greg.farrell@resbank.co.za
 Joseph Farrell=farrell@econ.berkeley.edu
 Katharine N. Farrell=katharine.farrell@qub.ac.uk
 Lisa Farrell=lisa.farrell@rmit.edu.au
 Niall Farrell=niall.farrell@esri.ie
 Verónica Inés Farreras=veronicafarreras@gmail.com
 Robert Scott Farrow=farrow@umbc.edu
 Mehdi Farsi=mehdi.farsi@unine.ch
 Hamid Faruqee=hfaruqee@imf.org
 Etienne Farvaque=etienne.farvaque@univ-lille1.fr
 Mohammad Reza Farzanegan=farzanegan@uni-marburg.de
 Alessandra Fasano=fasano@istat.it
 Giovanni Fasano=fasano@unive.it
 Martin M.G. Fase=mmg.fase@planet.nl
 Anja Faße=fasse@iuw.uni-hannover.de
 Claudio Fassio=cla.fassio@gmail.com
 Antonio Fatas=antonio.fatas@insead.edu
 Francisco Fatas-Villafranca=ffatas@unizar.es
 Kaneez Fatima=f.kaneez.1@research.gla.ac.uk
 Ibrahim Fatnassi=ibrahim.fatnassi@isg.rnu.tn
 Marco Fattore=marco.fattore@unimib.it
 Christophe Faugere=christophe.faugere@kedgebs.com
 Sebastian Faundez M=faundez.madariaga@gmail.com
 Dietrich Karl Fausten=dietrich.fausten@monash.edu
 Horácio Crespo Faustino=faustino@iseg.utl.pt
 Scott William Fausti=scott.fausti@sdstate.edu
 Jon Faust=faustj@jhu.edu
 Yvon Fauvel=fauvel.yvon@uqam.ca
 Fitriya Fauzi=fitriya@umpalembang.ac.id
 Ana Claudia Polato e Fava=ana.fava@ufabc.edu.br
 Giovanni Favara=favarag@gmail.com
 Pascal Favard=pascal.favard@univ-tours.fr
 Daniela Favaretto=favaret@unive.it
 Donata Favaro=donata.favaro@unipd.it
 Giampiero Favato=g.favato@kingston.ac.uk
 Carlo Favero=carlo.favero@unibocconi.it
 Giovanni Favero=gfavero@unive.it
 Yarine Fawaz=yarine.fawaz@yahoo.fr
 Chris Fawson=chris.fawson@usu.edu
 Marianne Fay=mfay@worldbank.org
 Burcu Afyonoğlu Fazlıoğlu=bfazlioglu@etu.edu.tr
 Steven Mark Fazzari=fazz@wustl.edu
 Philip Martin Fearnside=pmfearn@inpa.gov.br
 Allen Featherstone=afeather@ksu.edu
 Christine H. Feaver=feaver@mcmaster.ca
 Irawan Febianto=i_febianto@yahoo.com
 Falko Fecht=falko.fecht@t-online.de
 Johannes Wolfgang Fedderke=jwf15@psu.edu
 Arne Feddersen=af@sam.sdu.dk
 Alessandro Fedele=alessandro.fedele@unibz.it
 Gershon Feder=gfeder@hotmail.com
 Daniela Federici=d.federici@unicas.it
 Giovanni Federico=giovanni.federico@eui.eu
 Elena Fedorova=elena.fedorova@lut.fi
 Yuri V. Fedotov=fedotov@gsom.pu.ru
 Michele Fedrizzi=michele.fedrizzi@unitn.it
 Alberto Feduzi=feduzi@uniroma3.it
 Daniel Feenberg=feenberg@nber.org
 Robert Feeney=robfeeney@hotmail.com
 Robert C. Feenstra=rcfeenstra@ucdavis.edu
 David Feeny=dafeeny@comcast.net
 Eberhard Feess=e.feess@fs.de
 Ernst Fehr=ernst.fehr@econ.uzh.ch
 Hans Fehr=hans.fehr@uni-wuerzburg.de
 Sebastian Fehrler=sebastian.fehrler@pw.uzh.ch
 Edgar L .Feige=elfeige@wisc.edu
 James Allen Feigenbaum=j.feigen@aggiemail.usu.edu
 Adam Fein=afein@pembrokeconsulting.com
 Robert M. Feinberg=feinber@american.edu
 Susan Feinberg=feinberg@temple.edu
 Jonathan Feinstein=jonathan.feinstein@yale.edu
 Donna L Feir=dfeir@uvic.ca
 Daniel A. Feitosa Lopes=dafl1822@gmail.com
 Gabriel J Felbermayr=felbermayr@ifo.de
 Martin Feldkircher=martin.feldkircher@gzpace.net
 Lars P. Feld=feld@eucken.de
 Barry Feldman=barry@prismanalytics.com
 David H Feldman=dhfeld@wm.edu
 Naomi E. Feldman=naomi.e.feldman@frb.gov
 Horst Feldmann=h.feldmann@bath.ac.uk
 Alberto Felettigh=alberto.felettigh@bancaditalia.it
 Christina Felfe=christina.felfe@unisg.ch
 Mike Felgenhauer=mike.felgenhauer@plymouth.ac.uk
 Florentino Felgueroso=ffelgue@gmail.com
 Emanuele Felice=emanuele.felice@gmail.com
 Giulia Felice=giulfelice@gmail.com
 Teppo Felin=teppo.felin@byu.edu
 Ricardo Mourinho Félix=rfelix@bportugal.pt
 Harrison Fell=hfell@mines.edu
 Leonardo Felli=lfelli@econ.lse.ac.uk
 Gerlinde Fellner=gerlinde.fellner@uni-ulm.de
 Daniel Felsenstein=msdfels@mscc.huji.ac.il
 Claude Felteau=felteau.claude@uqam.ca
 Andrew Feltenstein=afeltenstein@gsu.edu
 Vincent Feltkamp=vincent.feltkamp@bigfoot.com
 Nick Feltovich=nicholas.feltovich@monash.edu
 Dr Christophe Feltus=christophe.feltus@tudor.lu
 Fabienne Femenia=fabienne.femenia@rennes.inra.fr
 Gianluca Femminis=gianluca.femminis@unicatt.it
 Salih Fendoglu=salih.fendoglu@tcmb.gov.tr
 Guohua Feng=ghfeng26@gmail.com
 Matthias R. Fengler=matthias.fengler@unisg.ch
 Li Feng=lf20@txstate.edu
 Qu Feng=qfeng@ntu.edu.sg
 Yuanhua Feng=yuanhua.feng@wiwi.upb.de
 Zhigang Feng=z.feng2@gmail.com
 Aju J. Fenn=aju.fenn@coloradocollege.edu
 Stefano Fenoaltea=stefano.fenoaltea@uniroma2.it
 Ricardo Fenochietto=rfenochietto@imf.org
 James Fenske=james.fenske@economics.ox.ac.uk
 Thomas Fent=thomas.fent@oeaw.ac.at
 Arnaud Féral=arnaud.feral@u-cergy.fr
 Perrine Cécile Ferauge=perrine.ferauge@umons.ac.be
 Ergete Ferede=feredee@macewan.ca
 John-Paul Ferguson=jpferg@stanford.edu
 Shon Ferguson=shon.ferguson@ifn.se
 Leopoldo Fergusson=lfergusson@uniandes.edu.co
 Mete Feridun=mete.feridun@gmail.com
 Fabio Feriozzi=fabio.feriozzi@ie.edu
 Marcelo Ferman=marceloferman@gmail.com
 John Fernald=fernaldjg@gmail.com
 Liliana Fernandes=lfernandes@porto.ucp.pt
 Maria Eduarda Fernandes=eduarda.fernandes@ipleiria.pt
 Nuno Fernandes=nuno.fernandes@imd.ch
 Paula Odete Fernandes=pof@ipb.pt
 Karmele Fernandez-Aguirre=karmele.fernandez@ehu.es
 Octavio Fernández-Amador=octavio.fernandez-amador@jku.at
 Gema Fernández-Avilés=gema.faviles@uclm.es
 Jorge Fernández-Baca=fernandezbaca_ja@up.edu.pe
 Aurelio Fernandez Bariviera=aurelio.fernandez@urv.net
 Víctor Fernández-Blanco=vfernan@uniovi.es
 Cristina Fernández=cfvidaurreta@bde.es
 Gonzalo Fernandez-de-Cordoba=gfdc@uma.es
 Santiago Fernandez de Cordoba=santiago.fernandezdecordoba@unctad.org
 Juan Fernández de Guevara=juan.fernandez@ivie.es
 Esther Fernández=mesferna@ccee.ucm.es
 Eva Fernández=eva.fernandez@uc3m.es
 Manuel Fernández Grela=mf.grela@usc.es
 Jesús Fernández-Huertas Moraga=jfernandezhuertas@fedea.es
 Jose Manuel Fernandez=jose.fernandez@louisville.edu
 Ana Fernández-Laviada=ana.fernandez@unican.es
 Xoaquín Fernandez-Leiceaga=xoaquin.fernandez@usc.es
 Roberto Fernández-Llera=rfllera@hotmail.com
 Manuel Fernandez=manuel.fernandezsierra@worc.ox.ac.uk
 Andrés Fernández Martin=andresf@iadb.org
 Melchor Fernandez=melchor.fernandez@usc.es
 Antonio Fernández Morales=afdez@uma.es
 Diana Lucia Fernandez Moreno=dianafernandezmoreno@gmail.com
 Pablo Fernandez=fernandezpa@iese.edu
 Pascual Fernandez, Sr.=pascual.fernandez@urjc.es
 Raquel Fernandez=raquel.fernandez@nyu.edu
 Pedro Fernández Sánchez=fersan.fcee@ceu.es
 Pilar Fernandez-Sanchez=pilarfs@ugr.es
 Jose L. Fernandez-Serrano=jfserrano@us.es
 Ivan Fernandez-Val=ivanf@bu.edu
 Jesus Fernandez-Villaverde=jesusfv@econ.upenn.edu
 Vladimir Fernández=vfernandez@bcb.gob.bo
 Lopez Hernandez Fernando A=fernando.lopez@upct.es
 Giner de la Fuente Fernando, Sr.=f.giner@uah.es
 Ricardo T. Fernholz=rfernholz@cmc.edu
 Luz María Ferrada=lferrada@ulagos.cl
 Anna Maria Ferragina=aferragina@unisa.it
 Christopher Ferrall=ferrallc@queensu.ca
 Mery Ferrando=mery.ferrando@uclouvain.be
 Francesco M. Ferrante=frafer61@gmail.com
 Vittorioemanuele Ferrante=manolo@unifi.it
 Gaëlle Ferrant=gaelle.ferrant@kuleuven-kulak.be
 Laurent Ferrara=laurent.ferrara@u-paris10.fr
 Cataldo Ferrarese=dinoferrarese@gmail.com
 Cesar Attilio Ferrari=ferrari@javeriana.edu.co
 Emanuele Ferrari=emanuele.ferrari@ec.europa.eu
 Fernando Ferrari Filho=ferrari@ufrgs.br
 Filippo Ferrari=filippo.ferrari@unive.it
 Pier Alda Ferrari=pieralda.ferrari@unimi.it
 Claudio Ferraz=cferraz@econ.puc-rio.br
 Céline Ferré=celinef@gmail.com
 Afonso Ferreira=afonso@cepe.ecn.br
 Alex Luiz Ferreira=alexferreira@usp.br
 Candida Ferreira=candidaf@iseg.utl.pt
 Marta Ferreira Dias=mfdias@ua.pt
 Eva Ferreira=eva.ferreira@ehu.es
 Fernando V. Ferreira=fferreir@wharton.upenn.edu
 Sara Ferreira Filipe=sara.ferreira@uni.lu
 Francisco H. G. Ferreira=fferreira@worldbank.org
 José Luis Ferreira=jlferr@eco.uc3m.es
 Jose Tome Ferreira=tomeferreira@yahoo.co.uk
 Manuel Portugal Ferreira=manuel.portugal.ferreira@gmail.com
 Paulo Jorge Ferreira=pjsf@uevora.pt
 Pedro Ferreira=pferreira@ipam.pt
 Pedro C. Ferreira=ferreira@fgv.br
 Pedro Lopes Ferreira=pedrof@fe.uc.pt
 Priscila Ferreira=priscila@eeg.uminho.pt
 Roberto Tatiwa Ferreira=rtf2@uol.com.br
 Jesus Ferreiro=jesus.ferreiro@ehu.es
 Ana Ferrer=aferrer@uwaterloo.ca
 Julian Ferrer=jferrer@itc.mx
 Andrea Ferrero=andrea.ferrero@economics.ox.ac.uk
 Giuseppe Ferrero=giuseppe.ferrero@bancaditalia.it
 Lucas Ferrero=lucasferrero@gmail.com
 Mario Ferrero=ferrerom@sp.unipmn.it
 Ben Ferrett=b.e.ferrett@lboro.ac.uk
 Paola Ferretti=ferretti@unive.it
 Riccardo Ferretti=riccardo.ferretti@unimore.it
 Peyton Michael Ferrier=pferrier@ers.usda.gov
 Javier Ferri=francisco.ferri@uv.es
 Silvia Ferrini=s.ferrini@uea.ac.uk
 John Nelson Ferris=jakemax33@comcast.net
 J. Stephen Ferris=stephen_ferris@carleton.ca
 Andrea R. Ferro=andferro@ufscar.br
 Gustavo Ferro=gferro@uade.edu.ar
 Filippo Ferroni=filippo.ferroni@banque-france.fr
 Marie Ferru=mferru@univ-poitiers.fr
 Marin Ferry=ferry@dial.prd.fr
 Chaim Fershtman=fersht@post.tau.ac.il
 Wayne Ferson=ferson@marshall.usc.edu
 Robert Ferstl=robert.ferstl@ur.de
 Imre Fertő=ferto@econ.core.hu
 Eric C. Fesselmeyer=ecsef@nus.edu.sg
 Pirmin Fessler=pirmin.fessler@oenb.at
 Agnès Festré=agnes.festre@gredeg.cnrs.fr
 Besnik Taip Fetai=b.fetai@seeu.edu.mk
 Switgard Feuerstein=switgard.feuerstein@awi.uni-heidelberg.de
 Philippe Février=fevrier@ensae.fr
 Vera Feygina=fejvera@gmail.com
 Adam Jerome Fforde=adam@aduki.com.au
 Nathan Vincent Fiala=nfiala@uci.edu
 Kamila Fialova=kfialova@email.cz
 Maurizio Fiaschetti=maurizio.fiaschetti@uniroma2.it
 Davide Fiaschi=dfiaschi@ec.unipi.it
 Eleonora Fichera=eleonora.fichera@manchester.ac.uk
 Ferdinand Fichtner=ferdinand.fichtner@googlemail.com
 Bashir Ahmad Fida=bashirfida@hotmail.com
 Joao Gabriel Fidalgo=fidalgo.joaogabriel@gmail.com
 Michael Fidora=michael.fidora@ecb.int
 Jarko Fidrmuc=jarko.fidrmuc@zu.de
 Paweł Fiedor=s801dok@wizard.uek.krakow.pl
 Alexander J. Field=afield@scu.edu
 David Fielding=dfielding@business.otago.ac.nz
 Gary Fields=gsf2@cornell.edu
 Simon Field=simon.field@oecd.org
 Simon Fietze=simonf@sam.sdu.dk
 Francesco Figari=ffigar@essex.ac.uk
 Frank T. Figge=figge@sustainablevalue.com
 Paolo Figini=paolo.figini@unibo.it
 David Figlio=figlio@northwestern.edu
 Erik Figueiredo=eafigueiredo@gmail.com
 Lízia de Figueirêdo=lizia@cedeplar.ufmg.br
 Paulo N. Figueiredo=pnf@fgv.br
 Adolfo Figueroa=afiguer@pucp.edu.pe
 Nicolas Figueroa=nicolasf@dii.uchile.cl
 Jean-Marc Figuet=jean-marc.figuet@u-bordeaux4.fr
 Charles Figuieres=charles.figuieres@supagro.inra.fr
 Lucrezio Figurelli=figurelu@bc.edu
 Radhouane Filali=radhouane.filali@fdseps.rnu.tn
 Tatiana Filatova=finmantv@yahoo.com
 Dmytro Filchenko=dm.filchenko@mss.sumdu.edu.ua
 Larry H. Filer, II=lfiler@odu.edu
 Randall Filer=rfiler@hunter.cuny.edu
 Dariusz Filip=dariuszfilip@tlen.pl
 Fragkiskos Filippaios=f.filippaios@kent.ac.uk
 Thomai Filippeli=t.filippeli@qmul.ac.uk
 Andrea Filippetti=andrea.filippetti@cnr.it
 Antonio Filippin=antonio.filippin@unimi.it
 Luigi Filippini=luigi.filippini@unicatt.it
 Massimo Filippini=massimo.filippini@lu.unisi.ch
 Mateusz Jan Filipski=m.filipski@cgiar.org
 George Filis=gfilis@bournemouth.ac.uk
 Lapo Filistrucchi=l.filistrucchi@uvt.nl
 Alpay Filiztekin=alpayf@sabanciuniv.edu
 Jose L Fillat=jose.fillat@bos.frb.org
 Valerio Filoso=filoso@unina.it
 Darren Filson=darren.filson@cmc.edu
 Frederico Finan=ffinan@econ.berkeley.edu
 Jeanette Findlay=jeanette.findlay@glasgow.ac.uk
 Ronald Findlay=ref2@columbia.edu
 T. Scott Findley=tscott.findley@usu.edu
 Alain Finet=alain.finet@umons.ac.be
 Joseph Michael Finger=michael.finger@comcast.net
 Bernard Fingleton=bf100@cam.ac.uk
 Matteo Fini=matteo.fini@hotmail.it
 Israel Finkelshtain=finkelsh@huji.ac.il
 Alan Finkelstein Shapiro=alanfshapiro@gmail.com
 Yoel Finkel=yoel@cbs.gov.il
 Aaron Finkle=afinkle@csusm.edu
 Martina Fink=martina.fink@jku.at
 Jocelyn E. Finlay=jfinlay@hsph.harvard.edu
 Ross Finnie=rfinnie@uottawa.ca
 Daria Finocchiaro=daria.finocchiaro@riksbank.se
 Vladi Finotto=vfinotto@unive.it
 Michael Finus=m.finus@bath.ac.uk
 Franco Fiordelisi=franco.fiordelisi@uniroma3.it
 Annamaria Fiore=a.fiore@arti.puglia.it
 Mariantonietta Fiore=m.fiore@unifg.it
 Gabriele Fiorentini=fiorentini@disia.unifi.it
 Elisabetta Fiorentino=fiorentinoelisabetta@libero.it
 Giulia Fiorese=giulia.fiorese@jrc.ec.europa.eu
 Damiano Fiorillo=damiano.fiorillo@uniparthenope.it
 Fabio Fiorillo=f.fiorillo@univpm.it
 Mario Fiorini=mario.fiorini@uts.edu.au
 Carlo V. Fiorio=carlo.fiorio@unimi.it
 Linda Fioriti=linda.fioriti@unipg.it
 Riccardo Fiorito=rfiorito@iol.it
 Tamara Fioroni=tamara.fioroni@univr.it
 Zakaria Firano=firanou@yahoo.fr
 Vinícius de Azevedo Couto Firme=firmez@ig.com.br
 Peyman Firouzi Naeim=firouzinaeimp12@students.ecu.edu
 Bogdan Firtescu=firtescu@uaic.ro
 Gianluca Fiscato=gianluca.fiscato@gmail.com
 William A. Fischel=bill.fischel@dartmouth.edu
 Andreas Fischer=andreas.fischer@snb.ch
 Doris Fischer=doris.fischer@uni-wuerzburg.de
 Edwin O. Fischer=edwin.fischer@uni-graz.at
 Justina A. V. Fischer=javfischer@gmx.de
 Thomas Fischer=fischer@vwl.tu-darmstadt.de
 Price Vanmeter Fishback=pfishback@eller.arizona.edu
 Eric Fisher=efisher@calpoly.edu
 Hayley Fisher=hayley.fisher@sydney.edu.au
 Jonas Fisher=jfisher@frbchi.org
 Monica Fisher=monica.fisher@oregonstate.edu
 Paul Fisher=pfishe@essex.ac.uk
 Albert Fishlow=af594@columbia.edu
 Arthur Fishman=afishman@mail.biu.ac.il
 Nigel L. Fish=nigel.fish@gmail.com
 Gary Fissel=gfissel@fdic.gov
 Daniel Frantz Fistung=dfistung@yahoo.com
 Piotr Fiszeder=piotr.fiszeder@umk.pl
 Rune Dahl Fitjar=rune.d.fitjar@uis.no
 Jean-Paul Fitoussi=jeanpaul.fitoussi@sciences-po.fr
 John D. Fitzgerald=john.fitzgerald@esri.ie
 John M. Fitzgerald=jfitzger@bowdoin.edu
 Terry J Fitzgerald=tjf@minneapolisfed.org
 Grant Fitzner=grantfitzner@gmail.com
 Katie Fitzpatrick=fitzpatk@seattleu.edu
 Maria Donovan Fitzpatrick=maria.d.fitzpatrick@cornell.edu
 Thomas James Fitzpatrick, IV=thomas.j.fitzpatrick@clev.frb.org
 Vincent G. Fitzsimons=v.g.fitzsimons@bradford.ac.uk
 Jon Hernes Fiva=j.h.fiva@econ.uio.no
 Dennis J. Fixler=dennis.fixler@bea.gov
 Derya Fındık=dfindik@metu.edu.tr
 Carlos Maria F-Jardon=cjardon@uvigo.es
 Odd-Helge Fjeldstad=odd.fjeldstad@cmi.no
 Emmanuel Flachaire=emmanuel.flachaire@univ-amu.fr
 Véronique Flambard=veronique.flambard@icl-lille.fr
 Alessandro Flamini=alessandro.flamini@unipv.it
 Sjur Didrik Flåm=sjur.flaam@econ.uib.no
 Greg Flanagan=greg.flanagan@uleth.ca
 Kieron Flanagan=kieron.flanagan@manchester.ac.uk
 Peter Flaschel=pflaschel@wiwi.uni-bielefeld.de
 David Flath=david.flath@gmail.com
 Frank Flatters=ff@frankflatters.com
 Thomas Flavin=thomas.flavin@nuim.ie
 Sarah Flèche=sarah.fleche@ens.fr
 Anne-Marie Fleischer=fleischer_anne@yahoo.com
 Charles Fleischman=charles.fleischman@frb.gov
 Belton M. Fleisher=fleisher.1@osu.edu
 Sebastian Fleitas=sefle@iecon.ccee.edu.uy
 Vladislav Flek=flek@mup.cz
 David A. Fleming=david.fleming@csiro.au
 Michael J. Fleming=michael.fleming@ny.frb.org
 Jason Fletcher=jmfletcher@wisc.edu
 Stein-Erik Fleten=stein-erik.fleten@iot.ntnu.no
 Hein Fleuren=fleuren@uvt.nl
 Jean-Baptiste Fleury=jean-baptiste.fleury@u-cergy.fr
 Nicolas FLEURY=nicolas.fleury@univ-lille1.fr
 Christopher Flinn=christopher.flinn@nyu.edu
 Laurent Flochel=lflochel@crai.com
 Thomas Flochel=tflochel@worldbank.org
 Martin Floden=martin.floden@riksbank.se
 Lennart Flood=lennart.flood@handels.gu.se
 Robert P. Flood=robert.p.flood.24@nd.edu
 Chris Florackis=c.florackis@liv.ac.uk
 Raymond J.G.M. Florax=rflorax@purdue.edu
 Monique Florenzano=monique.florenzano@univ-paris1.fr
 Daniel Flores=danflore_mx@yahoo.com.mx
 Ricardo Flores-Fillol=ricardo.flores@urv.cat
 Daniel Flores-Guri=dflores@alum.bu.edu
 Alfonso Flores-Lagunes=aflores@binghamton.edu
 Manuel Flores=manuel.flores@usc.es
 Manuel Flores=manuel@decon.edu.uy
 Óscar Flores=osflores@uat.edu.mx
 Carmen Elisa Flórez=cflorez@uniandes.edu.co
 Massimo Florio=massimo.florio@unimi.it
 Joël Floris=joel.floris@econ.uzh.ch
 Michael André Flor=michael.flor@wiwi.uni-augsburg.de
 John Earl Floyd=floyd@chass.utoronto.ca
 Claude Fluet=fluet.claude-denys@uqam.ca
 David T. Flynn=david@barterisevil.com
 Hisham Salem Foad=hfoad@mail.sdsu.edu
 Mouez Fodha=fodha@univ-paris1.fr
 Reto Foellmi=reto.foellmi@unisg.ch
 Andrew T. Foerster=andrew.foerster@kc.frb.org
 Mette Foged=mette.foged@econ.ku.dk
 Sara Fogelberg=sara.fogelberg@ne.su.se
 Alessandra Fogli=afogli00@gmail.com
 Fred Foldvary=ffoldvary@gmail.com
 Duncan K. Foley=foleyd@newschool.edu
 Nathan Foley-Fisher=nathan.c.foley-fisher@frb.gov
 Kelly Foley=kelly.foley@usask.ca
 Raffaella Folgieri=raffaella.folgieri@unimi.it
 Henk Folmer=h.folmer@rug.nl
 Benjamin Ayodele Folorunso=bfolorun@oauife.edu.ng
 Monika Foltyn-Zarychta=monika0fz@gmail.com
 Nicole Fondeville=nicolef2009@hotmail.fr
 Felipe J. Fonseca=fjfonseca82@gmail.com
 Miguel Alexandre Fonseca=m.a.fonseca@gmail.com
 Raquel Fonseca=fonseca.raquel@uqam.ca
 Lionel Fontagné=lionel.fontagne@univ-paris1.fr
 Francois Fontaine=francois.fontaine@univ-lorraine.fr
 Xavier Fontaine=fontaine@pse.ens.fr
 Elsa Fontainha=elmano@iseg.utl.pt
 Alessandro Fontana=alessandro.fontana@unige.ch
 André H.L. Fontana, Sr.=andre.fontana@mail.be
 Giuseppe Fontana=gf@lubs.leeds.ac.uk
 Roberto Fontana=roberto.fontana@unibocconi.it
 Emilio Fontela=emilio.fontela@uam.es
 Matías Fontenla=fontenla@unm.edu
 Vincy Fon=vfon@gwu.edu
 David K. Foot=foot@chass.utoronto.ca
 Christopher Lee Foote=chris.foote@bos.frb.org
 Jean Guillaume Forand=jgforand@uwaterloo.ca
 Kristin Forbes=kjforbes@mit.edu
 Francisco Javier Forcadell=franciscojavier.forcadell@urjc.es
 James Forder=james.forder@balliol.ox.ac.uk
 George S Ford=george.ford@phoenix-center.org
 Jon M. Ford=ford_jon@yahoo.com
 Kirsten Ford=kirsten.ford@economics.utah.edu
 Linda Foreman=lfarmer@ers.usda.gov
 Dirk Foremny=foremny@ub.edu
 Nohora Forero Ramírez=nohora.forero@gmail.com
 Pasquale Foresti=foresti@unicz.it
 Csaba Forgacs=csaba.forgacs@uni-corvinus.hu
 Guglielmo Forges Davanzati=guglielmo.forges@unisalento.it
 Ferenc Forgo=ferenc.forgo@uni-corvinus.hu
 Gonzalo F. Forgues-Puccio=gff2@st-andrews.ac.uk
 Emanuele Forlani=emanuele.forlani@eco.unipv.it
 Chiara Forlati=chiara.forlati@epfl.ch
 Matteo Formenti=matteo.formenti@uniroma2.it
 Dirk Fornahl=dfornahl@uni-bremen.de
 Fabio Fornari=fabio.fornari@ecb.int
 Lorenzo Forni=lforni@imf.org
 Mario Forni=mario.forni@unimore.it
 Yeganeh Forouheshfar=yeganeh.forouheshfar@dauphine.fr
 Rikard Forslid=rf@ne.su.se
 Anders Forslund=anders.forslund@ifau.uu.se
 Anthony Forster=forsteranthony@yahoo.co.uk
 Marcel Förster=marcel.foerster@wirtschaft.uni-giessen.de
 Michael F. Förster=michael.forster@oecd.org
 Antonio Forte=antonioforte80@virgilio.it
 Rosa Portela Forte=rforte@fep.up.pt
 Santiago Forte=santiago.forte@esade.edu
 Alvaro Javier Forteza=alvarof@decon.edu.uy
 Roberto Fortich=rfortich@unitecnologica.edu.co
 Bernard Fortin=bernard.fortin@ecn.ulaval.ca
 Mario Fortin=mario.fortin@usherbrooke.ca
 Pierre Fortin=fortin.pierre@uqam.ca
 Margherita Fort=margherita.fort@unibo.it
 Teresa C. Fort=teresa.fort@tuck.dartmouth.edu
 Piergiuseppe Fortunato=piergiuseppe.fortunato@unctad.org
 Morten Fosaas=morten.fosaas@tik.uio.no
 Alga Danila Foschi=algadf@ec.unipi.it
 Constanza Fosco=constanzafosco@gmail.com
 Mogens Fosgerau=mf@transport.dtu.dk
 Sebastian Fossati=sfossati@ualberta.ca
 Nicolai Foss=njf.smg@cbs.dk
 Samuel Fosso Wamba=fossowam@gmail.com
 Ana Fostel=afostel@gwu.edu
 Jack Fosten=j.fosten@surrey.ac.uk
 Andrew Foster=afoster@brown.edu
 Dean P. Foster=dean@foster.net
 James E. Foster=fosterje@email.gwu.edu
 John Foster=j.foster@economics.uq.edu.au
 Lucia Smith Foster=lucia.s.foster@census.gov
 Neil Foster-McGregor=neil.foster@univie.ac.at
 William Ellis Foster=wfoster@uc.cl
 Augustin Fosu=afosu@isser.edu.gh
 Panagiotis Fotis=pfotis@epant.gr
 Stergios B. Fotopoulos=fotopo@wsu.edu
 Didier Fouarge=d.fouarge@maastrichtuniversity.nl
 Hassan Fouayzi=f.hassan@lycos.com
 Martial Foucault=martial.foucault@sciencespo.fr
 Denis Fougere=fougere@ensae.fr
 Arnaud Fougeyrollas=arnaud.fougeyrollas@erasme-team.eu
 Cyril Fouillet=cyril.fouillet@essca.fr
 Jessica Fouilloux=jessica.fouilloux@univ-rennes1.fr
 Stilianos Fountas=sfountas@uom.gr
 Julien Fouquau=jfq@rouenbs.fr
 Roger Fouquet=r.fouquet@imperial.ac.uk
 Michel Fouquin=michel.fouquin@cepii.fr
 Andre Fourcans=fourcans@essec.fr
 Johan Fourie=johanf@sun.ac.za
 Vasiliki Fourmouzi=vasiliki_f@yahoo.com
 Gary M. Fournier=gfournier@fsu.edu
 Guy Fournier=guy.fournier@hs-pforzheim.de
 Panos Fousekis=panosfousekis@gmail.com
 Stuart J Fowler=stuart.fowler@mtsu.edu
 Alan Keith Fox=alan.fox@usitc.gov
 Craig R. Fox=craig.fox@anderson.ucla.edu
 John Andrew Fox=seanfox@k-state.edu
 Melanie Fox-Kean=mfox@austincollege.edu
 Kevin J. Fox=k.fox@unsw.edu.au
 Timothy J. Foxon=t.j.foxon@leeds.ac.uk
 Andrea Fracasso=andrea.fracasso@unitn.it
 Matteo Fragetta=mfragetta@unisa.it
 Vito Fragnelli=vito.fragnelli@mfn.unipmn.it
 John C. Frain=frainj@tcd.ie
 Jan Frait=jan.frait@cnb.cz
 W Scott Frame=wframe@uncc.edu
 Francesca Francavilla=francesca.francavilla@oecd.org
 Marco Francesconi=mfranc@essex.ac.uk
 Massimo Franchi=mas.franchi@gmail.com
 Barbara Francioni=barbara.francioni@uniurb.it
 Gómez Francisco=fgomez@us.es
 Herminia Francisco=h.francisco@cgiar.org
 Manuela Francisco=mfrancisco@worldbank.org
 Johanna L. Francis=ajofrancis@fordham.edu
 Michael Francis=mfrancis@bankofcanada.ca
 Francis Tandoh=bigtandoh@yahoo.co.uk
 Egon Franck=egon.franck@business.uzh.ch
 Raphael Franck=raphael.franck@biu.ac.il
 Laurent Franckx=franckx.laurent@gmail.com
 Maria del Rosario Franco Chuaire=mrfranco@iadb.org
 Daniele Franco=daniele.franco@bancaditalia.it
 Patrick Francois=francois@interchange.ubc.ca
 Sofia F. Franco=sufmff@gmail.com
 Liliana Yaned Franco Vásquez=lyfranco@unal.edu.co
 Christian Francq=christian.francq@univ-lille3.fr
 Anna Francsovics=francsovics.anna@kgk.uni-obuda.hu
 Ann-Christine Frandsen=frandsen@essex.ac.uk
 Björn Frank=frank@uni-kassel.de
 Günter Franke=guenter.franke@uni-konstanz.de
 Jeffrey Alexander Frankel=jeffrey_frankel@harvard.edu
 Jeff Frank=j.frank@rhul.ac.uk
 Myron J. Frankman=myron.frankman@mcgill.ca
 Mark W. Frank=markfrank@shsu.edu
 Murray Frank=murra280@umn.edu
 Robert H. Frank=rhf3@cornell.edu
 Sonja Fransen=sonja.fransen@maastrichtuniversity.nl
 Martin Fransman=m.fransman@ed.ac.uk
 Peter Franz=peterfranz@outlook.com
 Bruno Ferreira Frascaroli=bruno@ccsa.ufpb.br
 Angela Fraschini=angela.fraschini@sp.unipmn.it
 Clive D. Fraser=cdf2@le.ac.uk
 Iain Fraser=i.m.fraser@kent.ac.uk
 Cristian Camilo Frasser=cristian.frasser@correounivalle.edu.co
 Michele Fratianni=m.fratianni@univpm.it
 Saverio M. Fratini=fratini@uniroma3.it
 Federico Frattini=federico.frattini@unife.it
 Marcel Fratzscher=mfratzscher@diw.de
 Elizabeth Frazao=efrazao@ers.usda.gov
 Andrea Frazzini=andrea.frazzini@aqr.com
 Guillaume R. Frechette=frechette@nyu.edu
 Anders Frederiksen=afr@asb.dk
 Karima Fredj=fredj@unbc.ca
 Per G. Fredriksson=per.fredriksson@louisville.edu
 Fredy H. Wompner G.=wompner@gmail.com
 Charles Freedman=charles_freedman@carleton.ca
 Alan Freeman=afreeman@iwgvt.org
 David J. Freeman=david_freeman@sfu.ca
 Donald Freeman=eco_dgf@shsu.edu
 Guy Freeman=gfreeman@hku.hk
 Richard B. Freeman=freeman@nber.org
 Owen Freestone=owen.freestone@treasury.gov.au
 Klas Fregert=klas.fregert@nek.lu.se
 Ricardo da Silva Freguglia=ricardo.freguglia@ufjf.edu.br
 Joerg Freiling=freiling@uni-bremen.de
 Clovis Freire=freire@un.org
 Tiago Freire=tiago@tiagofreire.com
 Stephan Freitag=freitag@wifa.uni-leipzig.de
 Lucio Flávio da Silva Freitas=lucioffreitas@yahoo.com.br
 Xavier Freixas=xavier.freixas@upf.edu
 Nicolas Frémeaux=nicolas.fremeaux@u-cergy.fr
 Florent Fremigacci=florent.fremigacci@gmail.com
 Eric Baird French=eric.french.econ@gmail.com
 Kenneth French=kfrench@dartmouth.edu
 Michael T. French=mfrench@miami.edu
 Rob French=r.french@bristol.ac.uk
 Giuseppe Freni=freni@uniparthenope.it
 Koen Frenken=k.frenken@uu.nl
 Richard Frensch=frensch@ios-regensburg.de
 Alexander FRENZEL=afrenzel@de.imshealth.com
 Marzia Freo=marzia.freo@unibo.it
 Quentin Frère=quentin.frere@dijon.inra.fr
 sandy Fréret=sandy.freret@gmail.com
 Anne Fretel=anne.fretel@ires.fr
 Michael Freudenberg=michael.freudenberg@gmail.com
 Caroline Freund=cfreund@worldbank.org
 Bruno S. Frey=bruno.frey@econ.uzh.ch
 Miriam Frey=frey@ios-regensburg.de
 Andreas Freytag=a.freytag@wiwi.uni-jena.de
 Bernd Frick=bernd.frick@notes.uni-paderborn.de
 Daniel Fricke=daniel.fricke@ifw-kiel.de
 Sven-Olof Fridolfsson=sven-olof.fridolfsson@ifn.se
 Guido Friebel=gfriebel@wiwi.uni-frankfurt.de
 Rachel M. Friedberg=rachel_friedberg@brown.edu
 Jeffry A. Frieden=jfrieden@harvard.edu
 Hans Wolfgang Friederiszick=friederiszick@e-ca.com
 Daniel Friedman=dan@ucsc.edu
 David Friedman=ddfr@daviddfriedman.com
 Ezra Friedman=ezra-friedman@law.northwestern.edu
 Jed Friedman=jfriedman@worldbank.org
 John N. Friedman=jfriedman@post.harvard.edu
 Christian Friedrich=christian.friedrich@graduateinstitute.ch
 Peter Friedrich=peter@mtk.ut.ee
 Jana Friedrichsen=jana.friedrichsen@wzb.eu
 Silke A. Friedrich=friedrich@ifo.de
 Karola Friedrici=friedrici@fmt.uni-hannover.de
 Julius Frieling=julius.frieling@gmail.com
 Christian Fries=email@christian-fries.de
 Klaus Sylvester Friesenbichler=klaus.friesenbichler@wifo.ac.at
 Lana Friesen=l.friesen@economics.uq.edu.au
 Jan Fries=fries@zew.de
 Vincent Frigant=vincent.frigant@u-bordeaux.fr
 Roberta Frigeni=roberta.frigeni@unibocconi.it
 Bart Frijns=bfrijns@aut.ac.nz
 Paul Frijters=p.frijters@uq.edu.au
 Wolfgang Frimmel=wolfgang.frimmel@jku.at
 Joseph Magnus Frimpong=jf_magnus@yahoo.com
 Veronica Cecilia Frisancho=vfrisancho@iadb.org
 Walter Frisch=walter.frisch@univie.ac.at
 Peter Fristrup=peter@fristrup.dk
 David Frisvold=david-frisvold@uiowa.edu
 Ulrich Fritsche=ulrich.fritsche@wiso.uni-hamburg.de
 Michael Fritsch=m.fritsch@uni-jena.de
 Heiko Fritz=heiko.fritz@lnu.se
 Markus Frölich=froelich@uni-mannheim.de
 Alexander Frolov=afrolov@forecast.ru
 Daniil Petrovich Frolov=ecodev@mail.ru
 Vincent Fromentin=vfromentin@gmail.com
 Michael Frömmel=michael.froemmel@ugent.be
 Simona Frone=frone.simona@gmail.com
 Kenneth A. Froot=kfroot@hbs.edu
 Katharina Frosch=katharina.frosch@uni-wuerzburg.de
 Jon Frost=j.j.frost@dnb.nl
 Emmanuel Frot=emmanuel.frot@microeconomix.com
 Robert James Froud=r.froud@warwick.ac.uk
 Roland Fryer=rfryer@fas.harvard.edu
 John Fry=frymaths@googlemail.com
 Renee A. Fry-McKibbin=renee.mckibbin@anu.edu.au
 Zied Ftiti=zied.ftiti@isg.rnu.tn
 Andreas Fuchs=mail@andreas-fuchs.net
 Victor R. Fuchs=vfuchs@stanford.edu
 Dahai Fu=fudahai@cufe.edu.cn
 Paul Fudulu=paulfudulu@yahoo.com
 Amadeo Fuenmayor=amadeo.fuenmayor@uv.es
 Cristina Fuentes-Albero=cristina.fuentes-albero@frb.gov
 Miguel Fuentes=mafuentes@bcentral.cl
 Olga M. Fuentes=ofuentes@spensiones.cl
 Rodrigo Fuentes=rodrigo.fuentes@uc.cl
 Timothy S. Fuerst=tfuerst@nd.edu
 Ana-Maria Fuertes=a.fuertes@city.ac.uk
 Clemens Fuest=fuest@zew.de
 Guadalupe Fugarolas=guadafugarolas@gmail.com
 Carolina Fugazza=carolina.fugazza@carloalberto.org
 Marco Fugazza=marco.fugazza@unctad.org
 Keith Owen Fuglie=kfuglie@ers.usda.gov
 Jeffrey C. Fuhrer=jeff.fuhrer@bos.frb.org
 Johannes Fuhr=jf@wip.tu-berlin.de
 Hui Fu=fuhuicn@gmail.com
 José Alberto Fuinhas=fuinhas@ubi.pt
 Eiji Fujii=efujii@kwansei.ac.jp
 Hidemichi Fujii=hidemichifujii@gmail.com
 Takamune Fujii=tkfujii@tcue.ac.jp
 Tomoki Fujii=tfujii@smu.edu.sg
 Takemi Fujikawa=takemifujikawa@gmail.com
 Akimasa Fujiwara=afujiw@hiroshima-u.ac.jp
 Takako Fujiwara-Greve=takakofg@econ.keio.ac.jp
 Kenji Fujiwara=kenjifujiwara@kwansei.ac.jp
 Kyoji Fukao=k.fukao@r.hit-u.ac.jp
 Mitsuhiro Fukao=fukao@fbc.keio.ac.jp
 Kiichiro Fukasaku=kiichiro.fukasaku@oecd.org
 Nadežda Fuksová=nfuksova@gmail.com
 Kosei Fukuda=kfukuda@tamacc.chuo-u.ac.jp
 Sakiko Fukuda-Parr=fukudaps@newschool.edu
 Shin-ichi Fukuda=sfukuda@e.u-tokyo.ac.jp
 Tani Fukui=tani.fukui@usitc.gov
 Yukio Fukumoto=fukumoto@osaka-ue.ac.jp
 Mototsugu Fukushige=mfuku1961@gmail.com
 Marcelo Fukushima=marcelofukushima@yahoo.co.jp
 Takashi Fukushima=tfukushima@grips.ac.jp
 Scott Lansing Fulford=scott.fulford@bc.edu
 Lilyan Fulginiti=lfulginiti@unl.edu
 Edward Fullbrook=edward.fullbrook@btinternet.com
 Sascha Füllbrunn=fullbrunn@gmail.com
 Connel Fullenkamp=cfullenk@econ.duke.edu
 Don Fullerton=dfullert@illinois.edu
 Thomas Fullerton=tomf@utep.edu
 Chiara Fumagalli=chiara.fumagalli@unibocconi.it
 Elena Fumagalli=elena.fumagalli@unil.ch
 Laura Fumagalli=lfumag@essex.ac.uk
 Yukihiko Funaki=funaki@waseda.jp
 Stefania Funari=funari@unive.it
 Hideki Funatsu=hfunatsu@res.otaru-uc.ac.jp
 Bruno Funchal=bfunchal@gmail.com
 Joachim Fünfgelt=fuenfgelt@uni.leuphana.de
 Zuzana Fungáčová=zuzana.fungacova@bof.fi
 Loretta Fung=phfung@mx.nthu.edu.tw
 Patricia Funk=patricia.funk@upf.edu
 Peter Funk=funk@wiso.uni-koeln.de
 Qiang Fu=bizfq@nus.edu.sg
 Mats Furby=hjalp@hotmail.com
 Davide Furceri=dfurceri@imf.org
 Francesco Furlanetto=francesco.furlanetto@norges-bank.no
 Marilena Furno=furnoma@tin.it
 Eric Furstenberg=efurstenberg@gmail.com
 Bernardo Alves Furtado=bernardo.furtado@ipea.gov.br
 Delia Furtado=delia.furtado@uconn.edu
 Marcelo Furtado Martins de Paula=mfurtadom@gmail.com
 Salim B. Furth=salim.furth@heritage.org
 Yuichi Furukawa=you.furukawa@gmail.com
 Fumitaka Furuoka=fumitaka@um.edu.my
 Taiji Furusawa=furusawa@econ.hit-u.ac.jp
 Angelo FUSARI=anfusari@hotmail.it
 Alessio Fusco=alessio.fusco@ceps.lu
 Elisa Fusco=fusco_elisa@libero.it
 Peter Fusek=peter.fusek@partnering.sk
 Shihe Fu=fush@bc.edu
 Catherine Fuss=catherine.fuss@nbb.be
 Roland Füss=roland.fuess@unisg.ch
 Andreas Fuster=andreas.fuster@ny.frb.org
 Luisa Fuster=luisafuster12@gmail.com
 Antonio Fuster Olivares=toni.fuster@ua.es
 Koichi Futagami=futagami@econ.osaka-u.ac.jp
 Vincent Kang Fu=vkfu@yahoo.com
 Nobuhiko Fuwa=nfuwa@waseda.jp
