 Jamel Saadaoui=jamelsaadaoui@gmail.com
 Zied SAADAOUI=saadaouizied@gmail.com
 Agustín Saade Ospina=agustinsaade2014@u.northwestern.edu
 Radwan Saade=radwan.saade@sba.gov
 Mohamed Saadi=msaadi_umlv@yahoo.fr
 Tahsin Saadi Sedik=tsaadisedik@imf.org
 Lauri Sääksvuori=lauri.saaksvuori@wiso.uni-hamburg.de
 David S. Saal=d.s.saal@aston.ac.uk
 Eduardo Saavedra=saavedra@uahurtado.cl
 Jaime Saavedra=jasaavedra@minedu.gob.pe
 Irum Saba=irumsaba82@gmail.com
 Laura Sabani=lsabani@unifi.it
 Richard P. Saba=sabaric@auburn.edu
 Shwetlena Sabarwal=shwetlena@gmail.com
 Tarun Sabarwal=sabarwal@cal.berkeley.edu
 Marcela Sabate=msabate@unizar.es
 Mareva Sabatier=mareva.sabatier@univ-savoie.fr
 Fabio Sabatini=fabio.sabatini@uniroma1.it
 Diana Claudia Sabau-Popa=dianasabaupopa@yahoo.ro
 Roberto Sabbatini=roberto.sabbatini@bancaditalia.it
 Jeroen Sabbe=jeroen.sabbe@bain.com
 Guillermo Sabbioni=gsabbioni@uca.edu.ar
 Leonard Sabetti=lsabetti@gmu.edu
 Klara Sabirianova Peter=kpeter@unc.edu
 Muhammad Sabir=muhammadsabir@spdc.org.pk
 Muhammad Sabir=afridisabir@yahoo.com
 Iosif Sacal=secs43@yahoo.com
 Carla Sa=cangelica@eeg.uminho.pt
 Agnese Sacchi=a.sacchi@unimercatorum.it
 Donatella Saccone=donatella.saccone@unito.it
 Lorenzo Sacconi=lorenzo.sacconi@economia.unitn.it
 Bruce Sacerdote=bruce.sacerdote@dartmouth.edu
 J K Sachdeva=sachdevajk@hotmail.com
 Andreas Sachs=sachs@zew.de
 Adolfo Sachsida=sachsida@hotmail.com
 Lionel Sack=lionel.sack@circle.lu.se
 Stephen Sacks=stephen.sacks@uconn.edu
 SADEFO KAMDEM Jules=sadefo@yahoo.fr
 Mahdi Sadeghi=sadeghi@isu.ac.ir
 Javad Sadeghzadeh=jay373@econ.yorku.ca
 Mohammad Amin Sadeghzadeh=m.sadeghzadeh@imps.ac.ir
 Amit Sadhukhan=amit2006jnu@gmail.com
 Jacques Beno Sadik=tsadik00@bezeqint.net
 Efraim Sadka=sadka@post.tau.ac.il
 Mustapha Sadni Jallab=msadnijallab@gmail.com
 Elisabeth Sadoulet=esadoulet@berkeley.edu
 Bert M. Sadowski=b.m.sadowski@tue.nl
 Philipp Sadowski=p.sadowski@duke.edu
 Shuan SadreGhazi=ghazi@merit.unu.edu
 Abdolkarim Sadrieh=sadrieh@ovgu.de
 Raffaella Sadun=rsadun@hbs.edu
 Rana Riaz Saeed=rrs1960@yahoo.com
 Rodrigo Saens=rsaens@utalca.cl
 Frode Sættem=frode.sattem@nhh.no
 Emmanuel Saez=saez@econ.berkeley.edu
 Mohammad Samaun Safa=dearsafa@gmail.com
 Meysam Safari=meysam.safari@gmail.com
 Karolina Safarzynska=ksafarzy@wu.ac.at
 Henry Saffer=hsaffer@gc.cuny.edu
 Christoph Safferling=christoph.safferling@univie.ac.at
 Felipe Eduardo Saffie=fesaffie@sas.upenn.edu
 Pedro A C Saffi=p.saffi@jbs.cam.ac.uk
 Filipa Goncalves Sa=filipa.sa@kcl.ac.uk
 Vicente Safon=safon@uv.es
 Amagoia Sagasta=amagoia.sagasta@ehu.es
 Eirik Lund Sagen=eirik.sagen@skagerakenergi.no
 Michael Sager=msager@cppib.ca
 Kamal Saggi=k.saggi@vanderbilt.edu
 Aman Saggu=asaggu26@gmail.com
 Çağrı Sağlam=csaglam@bilkent.edu.tr
 Yigit Saglam=yigit.saglam@vuw.ac.nz
 Andres Sagner=asagner@bu.edu
 Amrita Saha=amrita.sa3188@gmail.com
 Ahmet Sahbaz=sahbazahmet@yahoo.com
 Afsin SAHIN=afsinsahin@gazi.edu.tr
 Aysegul Sahin=aysegul.sahin@ny.frb.org
 Saygin Sahinoz=saygin.sahinoz@tcmb.gov.tr
 Sebnem Sahin=ssahin@worldbank.org
 Sercin Sahin=sercinsahin@hotmail.com
 Sule Sahin=sule@hacettepe.edu.tr
 Claudia R. Sahm=claudia.r.sahm@frb.gov
 David Ezra Sahn=david.sahn@cornell.edu
 Ganeswar Sahoo=gs.oneworld@gmail.com
 Soham Sahoo=soham9r@isid.ac.in
 Raaj Kumar Sah=sah@uchicago.edu
 Mostafa Sahraei-Ardakani=mostafa@asu.edu
 Jean-Guillaume Sahuc=jean-guillaume.sahuc@banque-france.fr
 Nicolas Sahuguet=nicolas.sahuguet@hec.ca
 Pritish Kumar Sahu=pritishkumar9@gmail.com
 Femi SAIBU=omosaibu@yahoo.com
 Dhafer SAIDANE=dhafer.saidane@univ-lille3.fr
 Mohamed SAIDANE=saidane@math.univ-montp2.fr
 Farzad Saidi=saidi@nyu.edu
 Youssef SAIDI=saidiyoussef@hotmail.com
 Maher Said=maher.said@nyu.edu
 Mariana Saidón=msaidon@yahoo.com
 Hemanta Saikia=hemantassam@yahoo.com
 Katharina Sailer=ksailer@crai.com
 Mohd Safri Saiman=mohdsafri@gmail.com
 Gilles Saint-Paul=gstpaulmail@gmail.com
 Jorge Sainz=jorge.sainz@urjc.es
 Hisamitsu Saito=saitoh@econ.hokudai.ac.jp
 Kuniyoshi Saito=kuniyosh@eco.meijigakuin.ac.jp
 Makoto Saito=makoto@econ.hit-u.ac.jp
 Yukiko Umeno Saito=saito-yukiko@rieti.go.jp
 Albert Saiz=saiz@mit.edu
 Patricio Sáiz=patricio.saiz@uam.es
 Zurab Sajaia=zsajaia@worldbank.org
 Antonia Sajardo-Moreno=antonia.sajardo@uv.es
 Muhammad Sajid Sajid=sajid_911@hotmail.com
 Shinichi Sakata=shinichi.sakata@gmail.com
 Hideaki Sakawa=sakawa@econ.nagoya-cu.ac.jp
 Christos Sakellariou=acsake@ntu.edu.sg
 Kostis Sakellaris=ksakellar06@aueb.gr
 Plutarchos Sakellaris=plutarch@aueb.gr
 Humam Sakhnini=humam@yahoo.com
 József Sákovics=jozsef.sakovics@ed.ac.uk
 Pawel Sakowski=sakowski@wne.uw.edu.pl
 Sergio Naruhiko Sakurai=sakurai@usp.br
 Daniel Sakyi=dsakyi.cass@knust.edu.gh
 Davide Sala=dsala@sam.sdu.dk
 Raufhon Salahodjaev=rsalaho1@binghamton.edu
 Dilyara Salakhova=dilyara.salakhova@banque-france.fr
 Luca Sala=luca.sala@unibocconi.it
 Paraskevi K. Salamaliki=paraskevi.salamaliki@uni-konstanz.de
 Andrés Salamanca Lugo=asalamancal@bt.unal.edu.co
 Aidin Salamzadeh=salamzadehaidin@gmail.com
 Bernard Salanié=bs2237@columbia.edu
 François Salanié=salanie@toulouse.inra.fr
 Julien Salanié=julien.salanie@univ-st-etienne.fr
 Raymond J. Salani, III=raymondsalani3@gmail.com
 David Joseph Salant=dsalant@gmail.com
 Andrea Salanti=andrea.salanti@unibg.it
 Stephen Walter Salant=ssalant@umich.edu
 Paola Salardi=paola.salardi@utoronto.ca
 Gonzalo Salas=gsalas@iecon.ccee.edu.uy
 Jorge Salas=salas@econ.umd.edu
 Rafael Salas=r.salas@ucm.es
 Manuel Salas Velasco=msalas@ugr.es
 Sheu Adekunle Salau=sheu_awwal@yahoo.com
 Eduardo Salazar Silva=esalazars@unprg.edu.pe
 Fernando Salazar=fsalazar75@hotmail.com
 Irene Salazar=iresalazar@gmail.com
 Bruno Salcedo=bruno@psu.edu
 Hans Juergen Salchow=hjsalchow@aol.com
 Adrián Saldarriaga Isaza=casaldarriagai@unal.edu.co
 Juan Pablo Saldarriaga=jpsaldarriagam@ut.edu.co
 Martin Saldias=martin.saldias@bportugal.pt
 Kashif Saleem=kashif.saleem@lut.fi
 Shahid Saleem=marshal.shahid@yahoo.com
 Jumana Saleheen=jumana.saleheen@bankofengland.co.uk
 Djavad Salehi-Isfahani=salehi@vt.edu
 Mohamed Saleh=mohamed.saleh@tse-fr.eu
 Nashwa Saleh=salehn@ebrd.com
 Sherif Gamal Salem=gamalsalem.sherif@gmail.com
 Gillian Salerno=gillian.salerno@gmail.com
 Nicola Carmine SALERNO=nicola.salerno@tin.it
 Hugo Salgado Cabrera=husalgad@udec.cl
 Edgar Salgado Chavez=e.salgado-chavez@sussex.ac.uk
 Sergio Cristian Salgado Ibáñez, Sr.=ssalgado@bcentral.cl
 Maria Salgado=msalgado@cornerstone.com
 Alfredo Salgado-Torres=astorres1982@gmail.com
 Isaías Hazarmabeth Salgado-Ugarte=isalgado@unam.mx
 Yahia Salhi=yahia.salhi@gmail.com
 Evens Salies=evens.salies@sciencespo.fr
 Adam Salifu=aacadamus2000@yahoo.com
 Nimesh Salike=salikenimesh@hotmail.com
 Tim Salimans=salimans@ese.eur.nl
 José Daniel Salinas Rincón, Sr.=dsalinas18@yahoo.com
 Michael Alvin Salinger=salinger@bu.edu
 Silvia Salini=silvia.salini@unimi.it
 Afees Adebare Salisu=aa.salisu@mail.ui.edu.ng
 Audrey Sallenave=audrey.sallenave@univ-tln.fr
 Jean-Michel Salles=jean-michel.salles@supagro.inra.fr
 Federico Sallusti=fsallusti@istat.it
 Aneel Salman=aneelsalman@yahoo.com
 Ferhan Salman=fsalman@gmail.com
 Claire Salmon=claire.salmon@univ-savoie.fr
 Mark Salmon=mhs39@cam.ac.uk
 Pierre Salmon=pierre.salmon@u-bourgogne.fr
 Tim C. Salmon=tsalmon@smu.edu
 Matthew Jude Salois=msalois@ufl.edu
 Sara Salomone=sara.salomone@uclouvain.be
 Enrico Saltari=enrico.saltari@uniroma1.it
 Brian Salter=brian.g.salter@kcl.ac.uk
 Alexis Saludjian=saludjian@ie.ufrj.br
 Marco Emilio Salusso, Sr.=marco.salusso@comunidad.ub.edu.ar
 Luca Salvadori=luca.salvadori@ub.edu
 Neri Salvadori=nerisal@ec.unipi.it
 Pablo F. Salvador=pfsalvador@hotmail.com
 Susana Salvado=ssalvado@fe.unl.pt
 Kjell G Salvanes=kjell.salvanes@nhh.no
 Stanley C. W. Salvary=stawinsal@yahoo.ca
 Christophe Salvat=cs495@cam.ac.uk
 Luca Salvatici=luca.salvatici@uniroma3.it
 Stella Salvatierra=ssalvat@unav.es
 Marcio Antonio Salvato, Sr.=marcio.salvato@gmail.com
 Andrea Salvini=salvini@ilo.org
 Cristina Salvioni=salvioni@unich.it
 Daniela M. Salvioni=daniela.salvioni@unibs.it
 Alberto Salvo=albertosalvo@nus.edu.sg
 Kevin Salyer=kdsalyer@ucdavis.edu
 Massimo Salzano=salzano@unisa.it
 Danilo Samà=ds@danilosama.com
 Roberto Samaniego=roberto@gwu.edu
 Daniel Samano=dsamano@banxico.org.mx
 Ioannis Samantas=isamantas@econ.uoa.gr
 Evangelos Sambracos=sambra@unipi.gr
 Dov Samet=dovsamet@gmail.com
 Morteza Sameti=sameti@acnt.ui.ac.ir
 Hossein Samiei=ssamiei@imf.org
 Hind Sami=hind.sami@univ-lyon2.fr
 Janesh Sami=janesh.sami@gmail.com
 Emma Samman=emmasamman@rocketmail.com
 Robert Wayne Samohyl=samohyl@yahoo.com
 Val Samonis=val@samonis.com
 Nicholas Lawrence Samouilhan=nsamouilhan@gmail.com
 Antonio Rodriguez Sampayo=ar.sampayo@usc.es
 Christopher James Sampson=chris.sampson@nottingham.ac.uk
 Anne-Laure Samson=anne-laure.samson@dauphine.fr
 Yiagadeesen Samy=yiagadeesen_samy@carleton.ca
 Elioth Sanabria=em.sanabria86@uniandes.edu.co
 Alan Sanchez=asanchez@grade.org.pe
 Blanca Sanchez-Alonso=blanca@ceu.es
 Diego Sánchez-Ancochea=diego.sanchez-ancochea@qeh.ox.ac.uk
 Mabel Sánchez Barrioluengo=msbarrioluengo@ingenio.upv.es
 Edgar J Sánchez Carrera=carrera.edgar@gmail.com
 María Ángeles Sánchez Domínguez=sancheza@ugr.es
 Patricio Sánchez-Fernández=patricio@uvigo.es
 Antonio Jesús Sánchez Fuentes=antoniojesus.sanchez@ccee.ucm.es
 José R. Sánchez-Fung=j.sanchez-fung@kingston.ac.uk
 Gabriel Sanchez=gabrielsan@iadb.org
 Andrés Sánchez Jabba=asanchja@banrep.gov.co
 José Miguel Sánchez=jmsanchez@uc.cl
 Jose Ignacio Sanchez-Macias=macias@usal.es
 José Sánchez Maldonado=jsanchezm@uma.es
 Rocío Sánchez-Mangas=rocio.sanchez@uam.es
 Manuel Ordóñez Sánchez=mordonez@us.es
 Virginia Sanchez-Marcos=sanchezv@unican.es
 Alfonso Ramon Sanchez Martin=arsanmar@upo.es
 Santiago Sánchez-Pagés=ssanchez@staffmail.ed.ac.uk
 Joss Erick Sanchez, Dr.=joss.sanchez@uaslp.mx
 Rosario Sánchez Pérez=rosario.sanchez@uv.es
 Maria Laura Sanchez Puerta=msanchezpuerta@worldbank.org
 Raul Sanchez=rosanchez2003@gmail.com
 Javier Sanchez-Reaza=jsanchezreaza@worldbank.org
 Blanca Sanchez-Robles=blanca.sanchezrobles@gmail.com
 Miguel Sanchez-Romero=miguel.sanchez@oeaw.ac.at
 James Sanchirico=jsanchirico@ucdavis.edu
 Rosa Sanchis-Guarner=m.r.sanchis-guarner-herrero@lse.ac.uk
 Amparo Sanchis-Llopis=sanchisa@uv.es
 Juan A. Sanchis Llopis=juan.a.sanchis@uv.es
 Maria Teresa Sanchis Llopis=m.teresa.sanchis@uv.es
 Benjamin MacLean Sand=bmsand@yorku.ca
 Åke Sandberg=ake.sandberg@sociology.su.se
 Justin Sandefur=jsandefur@cgdev.org
 Rickard Sandell=sandellrick@gmail.com
 Anthony B. Sanders=asander7@gmu.edu
 Nicholas J. Sanders=njsanders@wm.edu
 Rohnn Sanderson=rohnn.sanderson@brescia.edu
 Jeremy Sandford=jeremy.sandford@uky.edu
 Manjit Singh Sandhu=manjit.singh@monash.edu
 Roger James Sandilands=r.j.sandilands@strath.ac.uk
 Ryan Sandler=rsandler@ucdavis.edu
 Todd Sandler=tsandler@utdallas.edu
 Malte Sandner=sandner@fiwi.uni-hannover.de
 Damiano Sandri=damiano.sandri@gmail.com
 Marco Sandri=sndmrc@tiscali.it
 Ronald Douglas Sands=rsands@ers.usda.gov
 Francesco Domenico Sandulli=sandulli@ccee.ucm.es
 Bjørn Sandvik=bjorn.sandvik@econ.uib.no
 Robert Sandy=icjz100@iupui.edu
 Renuka Sane=renukas@gmail.com
 Viviane Sanfelice=sanfelicev@gmail.com
 Marco Sanfilippo=marco.sanfilippo@eui.eu
 Andrew Sanford=andrew.sanford@monash.edu
 Bahram Sanginabadi=b.sanginabadi@yahoo.com
 Piyapong Sangkaew=piyasangkaew@gmail.com
 Marc Sangnier=marc.sangnier@univ-amu.fr
 Prem Sangraula=psangraula@worldbank.org
 Claudia Sanhueza=claudia.sanhueza@udp.cl
 Saifullahi Sani Ibrahim=ssmatazukt@yahoo.com
 Muhammad Ryan Sanjaya=m.ryan.sanjaya@gmail.com
 Leire San-Jose=leire.sanjose@ehu.es
 Jesús Carlos Sanjuán=jsanjuan@uma.es
 Carlos San Juan Mesonada=csm@eco.uc3m.es
 Ramesh Sankaranarayanan=rsankaran@business.uconn.edu
 Marta San Martín=marta.sanmartin@ehu.es
 Domingo Sanna=dsanna@austral.edu.ar
 Francesca Sanna-Randaccio=fsr@dis.uniroma1.it
 Helge Sanner=hs@sannerseminare.de
 Hachimi Sanni Yaya=sanni.yaya@uottawa.ca
 Esteban Sanroma=esanroma@ub.edu
 Chiara Sanseverino=chiara.sanseverino@gmail.com
 Andreu Sanso=andreu.sanso@uib.es
 Alessandro Sansone=a.sansone@fastwebnet.it
 João R. Sanson=jrsanson@pq.cnpq.br
 Daniel Santabárbara García=daniel.santabarbara@gmail.com
 Juan Santalo=juan.santalo@ie.edu
 Julieth Santamaria=jsantamariabonil@worldbank.org
 Maria Santana Gallego=maria.santana@uib.es
 Synthia Kariny Silva de Santana=synthiak@gmail.com
 Grazia D. Santangelo=grsanta@unict.it
 Pedro H. C. Sant'Anna=pde@eco.uc3m.es
 Juan Eduardo Santarcángelo=jsantar@gmail.com
 Enrico Santarelli=enrico.santarelli@unibo.it
 Gino Santarossa=gino.santarossa@videotron.ca
 Torsten Santavirta=torsten.santavirta@sofi.su.se
 Paolo Santella=paolo.santella@gmail.com
 Fabio Gaetano Santeramo=fabiogaetano.santeramo@gmail.com
 Rexford Santerre=rsanterre@business.uconn.edu
 Carlos Santiago-Caballero=carlos.santiago@uc3m.es
 Fernando Santiago=fsantiago@idrc.ca
 Juan Santiago=jmsantiagop@bt.unal.edu.co
 Rodriguez Feijoo Santiago, Sr.=srfeijoo@dmc.ulpgc.es
 Emanuele Santi=e.santi@afdb.org
 Roberto Santillan=roberto.santillan@itesm.mx
 Daniel Santín=dsantin@ccee.ucm.es
 Isabella Santini=isabella.santini@uniroma1.it
 Sawitree Santipiriyapon=sawitree.stp@gmail.com
 Javier Santiso=javier.santiso@esade.edu
 Raffaella Santolini=r.santolini@univpm.it
 Gianluca Santoni=g.santoni@sssup.it
 Michele Santoni=michele.santoni@unimi.it
 Eric Santor=esantor@bank-banque-canada.ca
 Emiliano Santoro=emiliano.santoro@unicatt.it
 Andre Alves Portela Santos=andreportela@gmail.com
 Antonio Alberto Santos=aasantos@fe.uc.pt
 António Bob Santos=abmsantos@netcabo.pt
 Carlos Santos=csantos@porto.ucp.pt
 Carlos Daniel Santos=c.d.santos@uvt.nl
 Cezar Santos=santos@uni-mannheim.de
 Cristina Santos=c.santos@open.ac.uk
 Edward Ponce Santos=edward.p.santos@up.edu.ph
 Georgina SANTOS=santosg@cardiff.ac.uk
 Joseph M. Santos=joseph.santos@sdstate.edu
 Juan Carlos Santos=carlos.santos@ehu.es
 Juan Luis Santos=santos.juanluis@gmail.com
 Manuel Santos=m.santos2@miami.edu
 Miguel Baião Santos=miguel@baiaosantos.com
 Paulo Santos Monteiro=paulo.santosmonteiro@york.ac.uk
 Luis Santos-Pinto=luispedro.santospinto@unil.ch
 Rafael Santos=rafael.santosvillagran@yale.edu
 Rafael Chaves Santos=rafael.santos@bcb.gov.br
 Ricardo Manuel Santos=ric10manuel@yahoo.com
 Helena Santos-Rodrigues=hsantos@estg.ipvc.pt
 Sérgio Pereira Santos=ssantos@ualg.pt
 João M.C. Santos Silva=jmcss@essex.ac.uk
 Susana Santos=ssantos@iseg.utl.pt
 Paolo Santucci de Magistris=psantucci@creates.au.dk
 Lawrence Santucci=lawrenc3@gmail.com
 Marc Santugini=marc.santugini@hec.ca
 M. Remzi Sanver=sanver@bilgi.edu.tr
 Anand Sanwal=asanwal@brilliont.com
 Ayanendu Sanyal=ayanendu1@gmail.com
 Basilio Sanz-Carnero=bsanz@cee.uned.es
 Ismael Sanz=ismael.sanz@urjc.es
 Nicolas SANZ=nicolas.sanz@martinique.univ-ag.fr
 Isabel Sanz-Villarroya=isanzvil@posta.unizar.es
 Claudio Sapelli=csapelli@uc.cl
 Juan Sapena=juan.sapena@ucv.es
 Paola Sapienza=paola-sapienza@northwestern.edu
 Geza Sapi=geza.sapi@ec.europa.eu
 Sandro Sapio=alessandro.sapio@uniparthenope.it
 Andre Sapir=asapir@ulb.ac.be
 Jeet Bahadur Sapkota=jbsnepal@gmail.com
 Prakash Raj Sapkota=prakash.raj.sapkota@gmail.com
 Alejandro Saporiti=alejandro.saporiti@manchester.ac.uk
 Itay Saporta Eksten=isaporta@stanford.edu
 Margarita Sapozhnikov=shepenen@bc.edu
 Koson Sapprasert=koson.s@bu.ac.th
 Sunil Sapra=ssapra@calstatela.edu
 Eleftherios Sapsalis=esapsali@ulb.ac.be
 Najam us Saqib=najam@pide.org.pk
 Omar Farooq Saqib=omar.farooq@sbp.org.pk
 José María Sarabia=sarabiaj@unican.es
 Marianela Sarabia=marianela.sarabia@gmail.com
 Francesco Saraceno=francesco.saraceno@sciences-po.fr
 Ana Isabel Saracho=jepsadea@bs.ehu.es
 Dürdane Şirin Saracoğlu=ssirin@metu.edu.tr
 Vasilis Sarafidis=vasilis.sarafidis@monash.edu
 Nikias Sarafoglou=nikias_sa@yahoo.se
 M. Margarida S. M. Martins M. Saraiva=msaraiva@uevora.pt
 Krista Jabs Saral=jabs@webster.ch
 Sudipta Sarangi=sarangi@lsu.edu
 Sandeep Saran=ssaran_icar@yahoo.co.in
 Vassilis Sarantides=v.sarantides@sheffield.ac.uk
 Ravi Saraogi=ravi.srg@gmail.com
 Catalin-Silviu Sararu=catalinsararu@yahoo.com
 Deepak Saraswat=saraswat.d@gmail.com
 Beena=vsbeenakrishna@gmail.com
 Palanisamy Saravanan=prof.saravanan@gmail.com
 George Saravelos=george_saravelos@hks10.harvard.edu
 Antonio I. Saravia=saravia_av@mercer.edu
 Diego Saravia=dsaravia@bcentral.cl
 Jimmy A. Saravia=jsaravia@eafit.edu.co
 Bernardo Elías Saray Ricardo=bernardoeliassaray@hotmail.com
 Jordi Sardà=jordi.sarda@urv.cat
 Eleni Sardianou=esardianou@hua.gr
 Mariano Jorge Sardi=mariano.sardi@bcra.gov.ar
 Boguslawa Barszczak Sardinha=boguslawa.sardinha@esce.ips.pt
 Maria Sard=maria.sard@uib.es
 Claudio Sardoni=claudio.sardoni@uniroma1.it
 Samita Sareen=samitasareen@yahoo.ca
 Fausto Saretta=fsaretta@fclar.unesp.br
 Gilberto Sarfati=gilberto@sarfati.com.br
 Samad Sarferaz=sarferaz@kof.ethz.ch
 Thomas Sargent=thomas.sargent@nyu.edu
 Caroline sargis roussel=c.roussel@ieseg.fr
 Alina Camelia SARGU=alina.sargu@feaa.uaic.ro
 Hakan Saribas=hakan203@yahoo.com
 George Saridakis=g.saridakis@kingston.ac.uk
 Ercan SARIDOĞAN=ercan.saridogan@istanbul.edu.tr
 Grigor Dimitrov Sariiski=grigor@sariiski.com
 Cagri Sarikaya=cagri.sarikaya@tcmb.gov.tr
 Kazim Sari=kazims@beykent.edu.tr
 Atulya Sarin=asarin@scu.edu
 Nazmi Sari=nazmi.sari@usask.ca
 Madhuri Saripalle=msaripalle@yahoo.com
 Hakan Sarıtaş=hsaritas@pau.edu.tr
 Ramazan Sarı=rsari@metu.edu.tr
 Apu Sarkar=apusarkar@gmail.com
 Asani Sarkar=asani.sarkar@gmail.com
 Dipanwita Sarkar=dipanwita.sarkar@qut.edu.au
 Jayanta Sarkar=jsarkar71@gmail.com
 Jayanta Sarkar=jayanta.sarkar@qut.edu.au
 Prabirjit Sarkar=prabirjitsarkar@gmail.com
 Siddhartha Sarkar=drsarkar.s@gmail.com
 Soumodip Sarkar=ssarkar@uevora.pt
 Subrata Sarkar=ssarkar@igidr.ac.in
 Debnarayan Sarker=sarkar_d_n@rediffmail.com
 Sergei Sarkissian=sergei.sarkissian@mcgill.ca
 Peter Sarlin=psarlin@abo.fi
 Sisira Sarma=ssarma2@uwo.ca
 Vengadeshvaran Jagatheeswara Sarma=vengadeshvaran.sarma@nottingham.edu.my
 Paula Sarmento=sarmento@fep.up.pt
 Tamat Bin Sarmidi=tamat@ukm.my
 Viviana Sarmiento Guzmán=vivianasarmientog@gmail.com
 Miguel Sarmiento=nsarmipa@banrep.gov.co
 Lucio Sarno=lucio.sarno@city.ac.uk
 Sinan Sarpça=ssarpca@ku.edu.tr
 Mauricio Sarrias, Sr.=msarrias86@gmail.com
 Mare Sarr=mare.sarr@uct.ac.za
 Marcello Sartarelli=marcellosartarelli@gmail.com
 Pierre Daniel Sarte=pierre.sarte@rich.frb.org
 Tiktik Dewi Sartika=tixtax@yahoo.com
 Domenico Sartore=sartore@unive.it
 Nicola Sartori=sartori@unive.it
 Nicola Sartor=nicola.sartor@univr.it
 Eftichios Sartzetakis=esartz@uom.gr
 Todd Sarver=todd.sarver@duke.edu
 Matti Sarvimäki=matti.sarvimaki@aalto.fi
 Chaudhary Imran Sarwar=effectiveleadership.imran@gmail.com
 Ghulam Sarwar=sarwar41ss@hotmail.com
 Miguel Alonso Sarzosa=sarzosa@econ.umd.edu
 Masaru Sasaki=sasaki@econ.osaka-u.ac.jp
 Shoichi Sasaki=ichi2sun@fancy.ocn.ne.jp
 Tsuyoshi Sasaki=tsuyosh1jp@yahoo.co.jp
 Subash Sasidharan=subash@iitm.ac.in
 Anoop Sasikumar=taichichuaan@gmail.com
 Maria Sassi=msassi@eco.unipv.it
 Seifallah SASSI=seifallah.sassi@yahoo.fr
 Steven A. Sass=steven.sass@bc.edu
 Tim Sass=tsass@gsu.edu
 Myrna Sastré Gutiérrez=myrna.sastre@gmail.com
 D.V.S. Sastry=dvssastry@hotmail.com
 Peter Sasvari=iitsasi@uni-miskolc.hu
 Willem Sas=willem.sas@kuleuven.be
 Jyothis Sathyapalan=jyothis.cess@gmail.com
 Geni Satiko Sato=sato@iea.sp.gov.br
 Atsuhiro Satoh=atsato@mail.doshisha.ac.jp
 Hiroshi Sato=sato.zuoteng@r.hit-u.ac.jp
 Hitoshi Sato=hitoshi_sato@ide.go.jp
 Masayuki Sato=msat@port.kobe-u.ac.jp
 Misato Sato=m.sato1@lse.ac.uk
 Ben Satriatna=satriatna.ben@gmail.com
 Elan Satriawan=elansatriawan@gmail.com
 Michael Sattinger=m.sattinger@albany.edu
 K.J.S. Satyasai=satyasaik@live.com
 Beate Sauer=beate.sauer@unibw.de
 Jan Sauermann=jan.sauermann@sofi.su.se
 Raymond Sauer=sauerr@clemson.edu
 Robert M. Sauer=robertmsauer@gmail.com
 Thomas Sauer=thomas.sauer@bw.fh-jena.de
 Drew Saunders=drew.d.saunders@gmail.com
 Alexandre Sauquet=alexandre.sauquet@gmail.com
 Rritu Saurabha=rsaurabha@gmail.com
 Philip Ulrich Sauré=philip.saure@snb.ch
 Carme Saurina Canals=carme.saurina@udg.es
 Stephane Saussier=saussier@univ-paris1.fr
 Nicolas Sauter=nicolas.sauter@lrz.uni-muenchen.de
 Oliver Sauter=oliver.sauter@uni-hohenheim.de
 Anja Sautmann=anja_sautmann@brown.edu
 Jehan Sauvage=jehan.sauvage@oecd.org
 Elizabeth Savage=elizabeth.savage@uts.edu.au
 James Savage=javage@gmail.com
 Michael Savage=michael.savage@esri.ie
 Scott James Savage=savages@colorado.edu
 Ernesto Savaglio=ernesto@unich.it
 Luc Savard=luc.savard@usherbrooke.ca
 Sara Savastano=sara.savastano@uniroma2.it
 Marco Savegnago=savegnago.marco@gmail.com
 Peter A. Savelyev=peter.savelyev@vanderbilt.edu
 Marco Savioli=m.savioli@unibo.it
 Pier Paolo Saviotti=pier-paolo.saviotti@wanadoo.fr
 Marcel René Savioz=marcel.savioz@snb.ch
 Fredrik Sävje=fredrik.savje@nek.uu.se
 Gheorghe Săvoiu=gheorghe.savoiu@upit.ro
 Maria Savona=m.savona@sussex.ac.uk
 Roberto Savona=savona@eco.unibs.it
 Luca Savorelli=luca.savorelli@unibo.it
 Christos Savvas Savva=christos.savva@cut.ac.cy
 Alexey Vladimirovich Savvateev=savvateev@gmail.com
 Andreas Savvides=andreas.savvides@cut.ac.cy
 Yasuyuki Sawada=sawada@e.u-tokyo.ac.jp
 Tadeusz Sawik=sawik@zarz.agh.edu.pl
 Khaing Sape Saw=sabaikhaingsaw@gmail.com
 John Sawkins=j.w.sawkins@hw.ac.uk
 Malcolm Sawyer=m.c.sawyer@lubs.leeds.ac.uk
 W. Charles Sawyer=w.c.sawyer@tcu.edu
 Branislav Saxa=branislav.saxa@cerge-ei.cz
 Richa Saxena=riches@iimahd.ernet.in
 Serdar Sayan=serdar.sayan@etu.edu.tr
 Selin Sayek=sayek@bilkent.edu.tr
 Stuart Sayer=s.sayer@ed.ac.uk
 Mesut Saygili=mesutsaygili@yahoo.com
 Perihan Özge Saygın=saygin@uni-mannheim.de
 Edward A. Sayre=edward.sayre@usm.edu
 Sbaouelgi Jihene=jihenesba@yahoo.fr
 Rashid Sbia=rsbia@mof.gov.bh
 Abdelkader Sbihi=sbihi@univ-paris1.fr
 Argia Sbordone=argia.sbordone@ny.frb.org
 Faouzi SBOUI=sbouif@yahoo.fr
 Massimo Sbracia=massimo.sbracia@bancaditalia.it
 Lucia Sbragia=lucia.sbragia@durham.ac.uk
 Giacomo Sbrana=gsb@rouenbs.fr
 Patrizia Sbriglia=patrizia.sbriglia@unina2.it
 Luisa Scaccia=scaccia@unimc.it
 Francesco Scafarto=francesco.scafarto@uniroma2.it
 Benjamin Scafidi=ben.scafidi@gcsu.edu
 Olivier Scaillet=olivier.scaillet@unige.ch
 Enrico Scalas=enrico.scalas@mfn.unipmn.it
 Domenico Scalera=scalera@unisannio.it
 Antonio Scalia=antonio.scalia@bancaditalia.it
 Pasquale Lucio Scandizzo=scandizzo@uniroma2.it
 Sergio Scandizzo=s.scandizzo@bei.org
 Giacomo Scandolo=giacomo.scandolo@univr.it
 Daiane Scaraboto=dscaraboto@uc.cl
 Jose Antonio Scaramucci=jascar@uol.com.br
 Giovanni Scarano=scarano@uniroma3.it
 Dr Helen Scarborough=scars@deakin.edu.au
 Herbert E. Scarf=herbert.scarf@yale.edu
 Margherita Scarlato=margherita.scarlato@uniroma3.it
 Carlo Scarpa=cscarpa@eco.unibs.it
 Riccardo Scarpa=rscarpa@waikato.ac.nz
 Stefano Scarpetta=stefano.scarpetta@oecd.org
 Gian Carlo Scarsi=giancarlo.scarsi@orr.gsi.gov.uk
 Carlos G. Scartascini=carlossc@iadb.org
 Milan Scasny=milan.scasny@czp.cuni.cz
 Roberto Scazzieri=roberto.scazzieri@unibo.it
 Francesco Scervini=francesco.scervini@unito.it
 Andreas Schabert=andreas.schabert@udo.edu
 Barry Schachter=barrynschachter@gmail.com
 Jens Schade=schade@verkehrspsychologie-dresden.de
 Hannu J. Schadewitz=hannu.schadewitz@utu.fi
 Klaus Schaeck=klaus.schaeck@bangor.ac.uk
 Kurt C. Schaefer=schk@calvin.edu
 Andrea Schäfer=a.schaefer@zes.uni-bremen.de
 Dorothea Schäfer=dschaefer@diw.de
 Mark Schaffer=m.e.schaffer@hw.ac.uk
 Markus Schaffner=m.schaffner@qut.edu.au
 Glenn D. Schaible=schaible@ers.usda.gov
 Ton van Schaik=schaik@uvt.nl
 Arjan Hille Schakel=a.schakel@maastrichtuniversity.nl
 Christophe Schalck=cschalck@pole-esg.fr
 Eric Schaling=eric.schaling@wits.ac.za
 Christoph A. Schaltegger=christoph.schaltegger@unilu.ch
 Heinz Schandl=heinz.schandl@csiro.au
 Simone G. Schaner=simone.schaner@dartmouth.edu
 Thorsten Schank=schank@uni-mainz.de
 Norbert Schanne=norbert.schanne@iab.de
 Ernesto Schargrodsky=eschargr@utdt.edu
 Marcel Scharth=m.scharth@vu.nl
 Alain Schatt=alain.schatt@unil.ch
 Markus Schatten=markus.schatten@foi.hr
 Brandon Schaufele=brandon.schaufele@uottawa.ca
 Catherine Schaumans=catherine.schaumans@gmail.com
 Julia Schaumburg=j.schaumburg@vu.nl
 Alfredo Schclarek=alfredo@eco.unc.edu.ar
 Richard Scheelings=rjscheel@gmail.com
 Ricardo Schefer=schefer@cema.edu.ar
 Eric Michael Scheffel=eric.scheffel@nottingham.edu.cn
 Juliane Scheffel=juliane.scheffel@nottingham.edu.cn
 Martin Scheffel=scheffel@zew.de
 Lukas Scheffknecht=lukas.scheffknecht@uni-hohenheim.de
 Jörg Scheibe=joerg.scheibe@gmx.de
 Marcus Scheiblecker=marcus.scheiblecker@wifo.ac.at
 Jose Scheinkman=joses@princeton.edu
 Mark Schelker=mark.schelker@unifr.ch
 Thomas Schelkle=schelkle@wiso.uni-koeln.de
 Lawrence Schembri=lschembri@bank-banque-canada.ca
 Heike Schenkelberg=heike.schenkelberg@lrz.uni-muenchen.de
 Oliver Schenker=schenker@zew.de
 Hans E.J.J. Schenk=e.j.j.schenk@uu.nl
 Klaus Reiner Schenk-Hoppé=k.r.schenk-hoppe@leeds.ac.uk
 Glenn Schepens=glenn.schepens@ugent.be
 Bettina Scherg=scherg@uni.leuphana.de
 Thomas Scherngell=thomas.scherngell@ait.ac.at
 Andrea Schertler=andrea.schertler@leuphana.de
 Francesco Schettino=francesco.schettino@unina2.it
 Macario Schettino=macarioschettino@gmail.com
 Ronald Schettkat=schettkat@wiwi.uni-wuppertal.de
 Florian Scheuer=scheuer@stanford.edu
 Uwe Scheuering=scheuering@zew.de
 Andreas Jörg Scheuerle=andreas.scheuerle@deka.de
 Rolf Scheufele=rolf.scheufele@snb.ch
 Fabio Schiantarelli=schianta@bc.edu
 Francesco Schiavone=franz.schiavone@gmail.com
 Andreas Schibany=andreas.schibany@ihs.ac.at
 Jack Schieffer=jack.schieffer@uky.edu
 Alexander Schiersch=aschiersch@diw.de
 Giorgio Schifani=giorgio.schifani@unipa.it
 Aaron Schiff=aaron.schiff@covec.co.nz
 Maurice Schiff=schiffmaurice@yahoo.com
 Hannah Schildberg-Hoerisch=schildberg-hoerisch@uni-bonn.de
 Christopher Johannes Schild=christopher-johannes.schild@fau.de
 Anita R. Schiller=a.schiller@dundee.ac.uk
 Brad Schiller=bschiller@unr.edu
 Daniel Schiller=schiller@niw.de
 Jörg Schiller=j.schiller@uni-hohenheim.de
 Jang Schiltz=jang.schiltz@uni.lu
 Michael Schiltz=michael.schiltz@arts.kuleuven.be
 Garry J. Schinasi=garry.schinasi@gmail.com
 Ibolya Schindele=schindelei@mnb.hu
 Dirk Schindler=dirk.schindler@nhh.no
 Kati Schindler=kschindler@diw.de
 Martin Schindler=mschindler@imf.org
 Christoph Schinke=schinke@ifo.de
 Ioana Cosmina Schiopu=ioana.schiopu@esade.edu
 Alfred Schipke=alfred_schipke@harvard.edu
 Burkhard Schipper=bcschipper@ucdavis.edu
 Pasquale Schiraldi=p.schiraldi@lse.ac.uk
 John Charles Schirm, V=john.schirm@gmail.com
 Maria Carmela Schisani=schisani@unina.it
 Fabiano Schivardi=schiva@alumni.stanford.edu
 Guttorm Schjelderup=guttorm.schjelderup@nhh.no
 Alain Schlaepfer=alain.schlaepfer@upf.edu
 Joerg Schlaepfer=schlaepfer@kof.ethz.ch
 Christopher Schlägel=christopher.schlaegel@ovgu.de
 Karl H. Schlag=karl.schlag@univie.ac.at
 Edward Schlee=ed.schlee@asu.edu
 Frauke Schleer=schleer@zew.de
 Harris Schlesinger=hschlesi@cba.ua.edu
 Ekkehart Schlicht=schlicht@lmu.de
 Eva Schliephake=eschliep@uni-bonn.de
 Erik Schlogl=erik.schlogl@uts.edu.au
 Dominik F. Schlossstein=dominik.schlossstein@ebs.edu
 Martin Schlotter=martin.schlotter@stmwivt.bayern.de
 Gerald Schluter=geraldschluter@aol.com
 Anke Schmalenbach=anke.schmalenbach@ebnerstolz.de
 Martin C. Schmalz=schmalz@umich.edu
 Karl Schmedders=karl.schmedders@business.uzh.ch
 David Schmeidler=davidschmeidler@gmail.com
 Katherine Schmeiser=kschmeis@mtholyoke.edu
 Steven Schmeiser=steven@schmeiser.org
 Christian Schmeißer=christian.schmeisser@iwh-halle.de
 Hans-Joerg Schmerer=hans-joerg.schmerer@iab.de
 Allan Schmid=schmid@msu.edu
 Andreas Schmid=andreas.schmid@uni-bayreuth.de
 Eric Schmidbauer=eschmidb@indiana.edu
 Christian Schmid=christian.schmid@vwi.unibe.ch
 Eva Schmid=eva.schmid@pik-potsdam.de
 Kurt Schmidheiny=kurt.schmidheiny@unibas.ch
 Carsten Schmidt=cschmidt@sfb504.uni-mannheim.de
 Tim Schmidt-Eisenlohr=t.schmidteisenlohr@gmail.com
 Klaus Schmidt-Hebbel=kschmidt-hebbel@uc.cl
 Klaus M. Schmidt=klaus.schmidt@lrz.uni-muenchen.de
 Lucie Schmidt=lschmidt@williams.edu
 Martin B. Schmidt=mbschm@wm.edu
 Oliver Schmidt=s.o.krates@web.de
 Peter Schmidt=schmidtp@uni-potsdam.de
 Reinhard H. Schmidt=schmidt@finance.uni-frankfurt.de
 Prof. Dr. Sascha Leonard Schmidt=sascha.schmidt@ebs.edu
 Sebastian Schmidt=sebastian.schmidt@ecb.int
 Tobias Schmidt=tobias.schmidt@bundesbank.de
 Torsten Schmidt=torsten.schmidt@unh.edu
 Christian Schmieder=chschmieder@gmx.de
 Mathias Schmit=m.schmit@sagora.eu
 Alexander Schmitt=alexander.schmitt@kuleuven.be
 Stephanie Schmitt-Grohe=stephanie.schmittgrohe@columbia.edu
 Nicolas Schmitt=schmitt@sfu.ca
 Pamela Schmitt=pschmitt@usna.edu
 Hendrik Schmitz=hendrik.schmitz@wiwinf.uni-due.de
 James Schmitz=jas@res.mpls.frb.fed.us
 Martin Schmitz=schmitzm@tcd.ie
 Sergio Schmukler=sschmukler@worldbank.org
 Brian Schmult=bcs@sgeo.com
 Ian Michael Schmutte=schmutte@uga.edu
 Armin Schmutzler=armin.schmutzler@econ.uzh.ch
 Claus Schnabel=claus.schnabel@wiso.uni-erlangen.de
 Isabel Schnabel=isabel.schnabel@uni-mainz.de
 Reinhold Schnabel=reinhold.schnabel@uni-due.de
 Gunther Schnabl=schnabl@wifa.uni-leipzig.de
 Mario Schnalzenberger=mario.schnalzenberger@jku.at
 Bernd Schnatz=bernd.schnatz@ecb.int
 Nicole Schneeweis=nicole.schneeweis@jku.at
 Dorothee Schneider=schneider.dorothee.hu@gmail.com
 Eric Schneider=eric.schneider@nuffield.ox.ac.uk
 Frédéric Schneider=frederic.schneider@econ.uzh.ch
 Friedrich Georg Schneider=friedrich.schneider@jku.at
 Hilmar Schneider=hilmar.schneider@ceps.lu
 Kerstin Schneider=schneider@wiwi.uni-wuppertal.de
 Marc Schneider=mschneider@iza.org
 Martin Schneider=schneidr@stanford.edu
 Martin Schneider=martin.schneider@oenb.at
 Ondrej Schneider=schneider@fsv.cuni.cz
 Paul Schneider=paul.schneider@wbs.ac.uk
 Udo Schneider=dr.udo.schneider@wineg.de
 Uwe A. Schneider=uwe.schneider@zmaw.de
 Yves Schneider=schneidery@gmail.com
 Jan Schnellenbach=schnellenbach@walter-eucken-institut.de
 Fabian Schnell=fabian.schnell@unisg.ch
 Eric Schniter=schniter@chapman.edu
 Monika Schnitzer=schnitzer@lrz.uni-muenchen.de
 Antoinette Schoar=aschoar@mit.edu
 Pia Sophia Schober=pschober@diw.de
 Ronnie Schoeb=ronnie.schoeb@fu-berlin.de
 Todd Schoellman=todd.schoellman@gmail.com
 Nicolaas J. Schoeman=niek.schoeman@up.ac.za
 Ronald J. Schoenberg=rons@u.washington.edu
 Dennis Schoeneborn=dennis.schoeneborn@uzh.ch
 Robert F. Schoeni=bschoeni@umich.edu
 Dirk Schoenmaker=dirk.schoenmaker@dsf.nl
 Volker Schöer=volker.schoer@wits.ac.za
 Norman Schofield=schofield.norman@gmail.com
 Jeroen Schokkaert=jeroen.schokkaert@econ.kuleuven.be
 Klaus Schöler=schoeler@uni-potsdam.de
 Almuth Scholl=almuth.scholl@uni-konstanz.de
 Armin Scholl=armin.scholl@uni-jena.de
 Bert Scholtens=l.j.r.scholtens@rug.nl
 John Karl Scholz=jkscholz@wisc.edu
 Franziska Schönau=schoenau@iamo.de
 Philipp Schönbucher=p@schonbucher.de
 Katharina Schone=katharina.schone@u-bourgogne.fr
 Carlos Schönerwald=cschonerwald@ufrj.br
 Mark Schonewille=msrf.schonewille@gmail.com
 Stefan Schönfelder=stefan.schoenfelder@wifo.ac.at
 Alice Schoonbroodt=alicesch17@gmail.com
 Mark Schopf=mark.schopf@wiwi.upb.de
 Frank Schorfheide=schorf@ssc.upenn.edu
 Andrew Schotter=andrew.schotter@nyu.edu
 Jeffrey Joseph Schott=jschott@piie.com
 Peter K. Schott=peter.schott@yale.edu
 Bruno Schoumaker=bruno.schoumaker@uclouvain.be
 Lotte Schou-Zibell=lschouzibell@adb.org
 Arthur Jan Hendricus Christoffel Schram, Jr.=schram@uva.nl
 Margit Schratzenstaller=margit.schratzenstaller@wifo.ac.at
 Stacey Schreft=sschreft@gmail.com
 Jesse Schreger=schreger@fas.harvard.edu
 Till Schreiber=txschr@wm.edu
 Mark Schreiner=mark@microfinance.com
 Anna Louise Schröder=a.m.schroeder@lse.ac.uk
 Carsten Schröder=cschroeder@diw.de
 Elizabeth Schroeder=liz.schroeder@oregonstate.edu
 Gerhard Schroeder=gaschroeder@gmail.com
 Rolf Schröder=rolfschroeder.h@t-online.de
 Enrique Schroth=enrique.schroth.1@city.ac.uk
 Christian Schubert=schubert@econ.mpg.de
 Hermann Schubert=vewschubert@gmx.de
 Jens Schubert=jschubert@vcu.edu
 Katheline Schubert=schubert@univ-paris1.fr
 Torben Schubert=torben.schubert@isi.fraunhofer.de
 Guenter Schucher=schucher@giga-hamburg.de
 Simeon Schudy=simeon.schudy@econ.lmu.de
 Norman Schuerhoff=norman.schuerhoff@unil.ch
 Florian Schuett=f.schuett@uvt.nl
 Ludger Schuknecht=ludger.schuknecht@ecb.europa.eu
 Moritz Schularick=moritz.schularick@fu-berlin.de
 Jürgen Schuldt=schuldt_jn@up.edu.pe
 Margot Schüller=schueller@giga-hamburg.de
 Simone Schüller=schueller@fbk.eu
 Stephan Schulmeister=stephan.schulmeister@wifo.ac.at
 Elisabeth Schulte=elisabeth.schulte@wiwi.uni-marburg.de
 Patrick Schulte=schulte@zew.de
 Christian Schultz=cs@econ.ku.dk
 Marie Louise Schultz-Nielsen=mls@rff.dk
 Christian Henning Schulz=christian_h_schulz@gmx.de
 Erika Schulz=eschulz@diw.de
 Jonathan F. Schulz=jonathan.schulz@nottingham.ac.uk
 Christian Schumacher=christian.schumacher@bundesbank.de
 Jan Schumacher=jan.schumacher@unbw.de
 Reinhard Schumacher=rschumac@uni-potsdam.de
 Daniel Schunk=mail@daniel-schunk.de
 Jürgen Schupp=jschupp@diw.de
 Paul Schure=schure@uvic.ca
 Stefanie Schurer=stefanie.schurer@gmail.com
 Andres Ricardo Schuschny=schuschny@gmail.com
 Stephan Schuster=stephan@stephan-schuster.net
 Thomas Schuster=schuster@tomschuster.de
 Nicolas Schutz=nicolas.schutz@polytechnique.edu
 Mike Schwan=mike.schwan@uni-potsdam.de
 J. Brad Schwartz=jbrad.schwartz@gmail.com
 Michael Schwartz=michael.schwartz@kfw.de
 Joshua Schwartzstein=josh.schwartzstein@dartmouth.edu
 Alexandra Schwarz=schwarz@wiwi.uni-wuppertal.de
 Wolfgang Schwarzbauer=schwarzba@ihs.ac.at
 Johannes A. Schwarzer=johannes.schwarzer@uni-hohenheim.de
 Gerhard Schwarz=gerhard.schwarz@wifo.ac.at
 Tim Schwarzmüller=tim.schwarzmueller@ifw-kiel.de
 Gerhard Schweimayer=gerhard@schweimayer.de
 Albert George Schweinberger=a.schweinberger@uni-konstanz.de
 Julia M. Schwenkenberg=julia.schwenkenberg@rutgers.edu
 Guido Schwerdt=guido.schwerdt@uni-konstanz.de
 Gregor Schwerhoff=schwerhoff@pik-potsdam.de
 Manijeh Schwindt=mschwindt@munichre.com
 Malte Schwoon=m.schwoon@gmx.de
 Michael Schymura=schymura@zew.de
 Laurence Scialom=laurence.scialom@u-paris10.fr
 Emanuela Sciubba=esciubba@econ.bbk.ac.uk
 Dario Sciulli=d.sciulli@unich.it
 Paolo Sckokai=paolo.sckokai@unicatt.it
 Alessandro Diego Scopelliti=a.d.scopelliti@warwick.ac.uk
 Vincenzo Scoppa=v.scoppa@unical.it
 Antonello Eugenio Scorcu=antonello.scorcu@unibo.it
 Eric Scorsone=scorsone@msu.edu
 Luiz Guilherme Scorzafave=scorza@usp.br
 Allen J. Scott=ajscott@ucla.edu
 Andrew Scott=ascott@london.edu
 Anthony Scott=a.scott@unimelb.edu.au
 Colin David Scott=colin.scott@ucd.ie
 Massimo Scotti=massimo.scotti@uts.edu.au
 Marie José SCOTTO=m.scotto@ipag.fr
 Andrei Scridon=andrei.scridon@econ.ubbcluj.ro
 S. Şerban Scrieciu=s.scrieciu@wu.ac.at
 Marcella Scrimitore=marcella.scrimitore@unisalento.it
 Lyle Scruggs=lyle.scruggs@uconn.edu
 Cornelia Scutaru=corneliascutaru@yahoo.com
 Hanen SDIRI=sdirihanen@gmail.com
 Kiat Ying Seah=sky@nus.edu.sg
 James L. Seale, Jr.=jseale@ufl.edu
 Richard Alan Seals Jr.=alan.seals@auburn.edu
 Bruce Alan Seaman=bseaman@gsu.edu
 Paul Timothy Seaman=p.t.seaman@dundee.ac.uk
 Michael A. Seamans=michael.seamans@dal.frb.org
 John J. Seater=john_seater@ncsu.edu
 Alexander Sebald=alexander.sebald@econ.ku.dk
 Steffen P. Sebastian=steffen.sebastian@wiwi.uni-regensburg.de
 Helder Sebastião=helderse@fe.uc.pt
 Jarmila Šebestová=sebestova@opf.slu.cz
 Szabolcs Sebestyén=szabolcs.sebestyen@iscte.pt
 Maamar Sebri=maamer.sebri@gmail.com
 Angelo Secchi=angelo.secchi@univ-paris1.fr
 Davide Secchi=secchi.davi@gmail.com
 Antonio Seccia=antonio.seccia@unifg.it
 İ.Erdem Seçilmiş=ies@hacettepe.edu.tr
 Oana Secrieru=oana.secrieru@rmc.ca
 Ian J. Seda-Irizarry=isedairi@gmail.com
 Mojtaba Sedigh Fazli=mojtabafazli@yahoo.com
 Golnaz Sedigh=gsedi023@uottawa.ca
 Franck Sedillot=franck.sedillot@banque-france.fr
 Silvia Rita Sedita=silvia.sedita@unipd.it
 Roger A. Sedjo=sedjo@rff.org
 Petr Sedlacek=sedlacek@uni-bonn.de
 Alena Sedláčková Novák=alena.sedlackova@fpedas.uniza.sk
 Teodor Sedlarski=sedlarski@feb.uni-sofia.bg
 Lucie Sedmihradská=sedmih@vse.cz
 Thomas Seegmuller=thomas.seegmuller@univ-amu.fr
 Seraphim Seferiades=ssefer@panteion.gr
 James Sefton=j.sefton@imperial.ac.uk
 Carmit Segal=carmit.segal@econ.uzh.ch
 Uzi Segal=segalu@bc.edu
 Eduardo Segarra=eduardo.segarra@ttu.edu
 Kathleen Segerson=kathleen.segerson@uconn.edu
 Rene Segers=rsegers@few.eur.nl
 Paul Segerstrom=paul.segerstrom@hhs.se
 Alain Segessemann=alain.segessemann@unine.ch
 Elena Seghezza=seghezza@unige.it
 Abdelkrim SEGHIR=kseghir@aucegypt.edu
 Majda SEGHIR=majda.seghir@etu.u-pec.fr
 Stephanie Seguino=stephanie.seguino@uvm.edu
 Anatoli Segura=segura@cemfi.es
 Ruben Segura-Cayuela=seguracayuela@gmail.com
 Juan Carlos Segura-Ortiz=jcsegura@lasalle.edu.co
 Alex Segura-Ubiergo=aseguraubiergo@imf.org
 Zlatko Šehanović=zlatko.sehanovic@veleri.hr
 Ruben R. Seiberlich=ruben.seiberlich@uni-konstanz.de
 Carlos Seiglie=seiglie@andromeda.rutgers.edu
 David Seim=david.seim@utoronto.ca
 Shannon Seitz=sseitz@analysisgroup.com
 Petros G. Sekeris=petros.sekeris@port.ac.uk
 Sekhar CSC=sekharcsc@yahoo.com
 Tatevik Sekhposyan=tsekhposyan@bankofcanada.ca
 Sheetal Sekhri=ssekhri@virginia.edu
 Erika Seki=e-seki@fc.ritsumei.ac.jp
 Ismail Seki=ismailseki@gmail.com
 Atsushi Sekine=atsushi.sekine@hotmail.com
 Toshitaka Sekine=toshitaka.sekine@boj.or.jp
 Sofiane Sekioua=s.sekioua@afdb.org
 Fuat Sekmen=sekmen@sakarya.edu.tr
 Miki Seko=seko@econ.keio.ac.jp
 Siok Kun Sek=sksek@usm.my
 Jorge Selaive=jselaive@gmail.com
 Rebecca J. Sela=rebeccapaul@yahoo.com
 Ekta Selarka=ekta@mse.ac.in
 Jo Seldeslachts=j.w.seldeslachts@uva.nl
 James K. Self=jkself@indiana.edu
 Jason Scott Seligman=seligman.10@osu.edu
 Sheikh Selim=selims@westminster.ac.uk
 Tarek Selim=tselim@aucegypt.edu
 ALEXANDER SELLAMEN, Sr.=alexsellamen@gmail.com
 Andrew Sellgren=andrew_sellgren@mckinsey.com
 Thorsten Sellhorn=sellhorn@bwl.lmu.de
 Deniz Selman=deniz.selman@boun.edu.tr
 Refk Selmi=s.refk@yahoo.fr
 Harris Selod=hselod@worldbank.org
 David Duden Selover=dselover@odu.edu
 Luc Sels, Sr.=luc.sels@econ.kuleuven.be
 Andrew Seltzer=a.seltzer@rhul.ac.uk
 Jesiah Selvam=sjesiah@yahoo.com
 Geethanjali Selvaretnam=gs51@st-andrews.ac.uk
 Alessandro Sembenelli=sembenelli@econ.unito.it
 Ivan Mulianta Sembiring Meliala=ivanm@students.bandungfe.net
 Andreea Ileana Semenescu=asemenescu@yahoo.com
 Maria Semenova=mariasem@inbox.ru
 Vilem Semerak=vilem.semerak@cerge-ei.cz
 Cristhian Seminario=seminario_cjm@up.edu.pe
 Roman B. Semko=rsemko@kse.org.ua
 Willi Semmler, Sr.=semmlerw@newschool.edu
 Anastasios B. Semos=semos@agro.auth.gr
 José J. Sempere-Monerris=jose.j.sempere@uv.es
 Anastasia Semykina=asemykina@fsu.edu
 Matus Senaj=senaj@rrz.sk
 Watagala Gamaralalage Tharaka Sameera Senanayaka=tharakasenanayaka@yahoo.com
 Anindita Sen=anindita.tinni@gmail.com
 Anindya Sen=asen@watarts.uwaterloo.ca
 Arijit Sen=arijitsen@iimcal.ac.in
 Ozge Senay=os12@st-andrews.ac.uk
 Sisay Regassa Senbeta=sisayregassa@gmail.com
 Bisakha Sen=bsen@uab.edu
 Ilkay Sendeniz-Yüncü=i.sendeniz@ieseg.fr
 Gitanjali SenDutta=gitan_dutta@hotmail.com
 Babacar Sene=babis_sene@yahoo.fr
 Ismaël Sene=ismael.sene@esc-rennes.fr
 Omar SENE=papomarsene@gmail.com
 Serigne Moustapha Sene=serigne.sene@dpee.sn
 Bory Seng=bory.seng@gmail.com
 Abhijit Sengupta=sengupta.abhijit@gmail.com
 Aditi Sengupta=azs0074@auburn.edu
 Kunal Sengupta=kunal.sengupta@sydney.edu.au
 Rajeswari Sengupta=rajeswari.sen@gmail.com
 Sonali Sen Gupta=s.sengupta@lancaster.ac.uk
 Hüseyin Şen=hsen@ybu.edu.tr
 Claudia Senik=senik@pse.ens.fr
 Asli Senkal=as7av@virginia.edu
 Kunal Sen=kunal.sen@manchester.ac.uk
 Myriam J. Senn=myriam_senn@gmx.ch
 Benabbou SENOUCI=senouci.ben@gmail.com
 Rahul Sen=rahul.sen@aut.ac.nz
 Ravi Sen=rsen@mays.tamu.edu
 Mine Zeynep Senses=msenses@jhu.edu
 Marianne Sensier=marianne.sensier@manchester.ac.uk
 Ahmet Şensoy=ahmet.sensoy@borsaistanbul.com
 Subir Sen=subir.econ@gmail.com
 Subir Kumar Sen=subirkumarsen@gmail.com
 Enrique Sentana=sentana@cemfi.es
 Jim Sentance=sentance@upei.ca
 Tapas Kumar Sen=tapas.sen@nipfp.org.in
 Esther-Mirjam Sent=e.m.sent@fm.ru.nl
 İsmail Şentürk=ismail.senturk@gop.edu.tr
 Zeynep Senyuz=zeynep.senyuz@frb.gov
 Byoung Hoon Seok=seok.19@osu.edu
 Myung Hwan Seo=m.seo@lse.ac.uk
 Hamid Sepehrdoust=hamidbasu1340@gmail.com
 Peter Sephton=psephton@business.queensu.ca
 Juha Seppala=juha.seppala@gmail.com
 Pascal Seppecher=pascal.seppecher@unice.fr
 Jüri Sepp=juri.sepp@ut.ee
 Cristian Felipe Sepulveda=csepulve@tulane.edu
 Jean P. Sepulveda=jeansepulveda@udd.cl
 Tiago Neves Sequeira=sequeira@ubi.pt
 Michel Serafinelli=michel.serafinelli@utoronto.ca
 Kazi Faisal Bin Seraj=faisal.k@brac.net
 Massimiliano Serati=mserati@liuc.it
 Elena Claudia Serban=claudiaserbanos@yahoo.com
 Cosmin Serbanescu=serbanescucosmin@yahoo.com
 Radu Serbulescu=rserbulescu@yahoo.com
 Razvan Sorin SERBU=razvan.serbu@ulbsibiu.ro
 Goran Serdarević=goran.serdarevic@gmail.com
 Tomas Serebrisky=tserebrisky@iadb.org
 Dimitris Vas Seremetis=dser@aegean.gr
 Luigi Sereno=luigi.sereno@unibo.it
 Stergios Seretis=seretiss@gmail.com
 Konstantinos Serfes=ks346@drexel.edu
 Aicha Serghini Idrissi=aserghin@ulb.ac.be
 Adnan Seric=a.seric@unido.org
 Giovanni Serio=giovanni.serio@gmail.com
 Shigehiro Serizawa=serizawa@iser.osaka-u.ac.jp
 Laura Serlenga=lserlenga@gmail.com
 Apostolos Serletis=serletis@ucalgary.ca
 Catherine Sermet=sermet@irdes.fr
 Pieter M. Serneels=p.serneels@uea.ac.uk
 Ludmila S. Serova=serovals@gsom.pu.ru
 Daniel Serra=daniel.serra@upf.edu
 Danila Serra=dserra@smu.edu
 Fernando Antonio Ribeiro Serra=fernando.serra@hsmeducacao.com.br
 Francisco SERRANITO=francisco.serranito@univ-orleans.fr
 José A Serrano Álvarez=jserranoalv@uoc.edu
 Carlos Serrano-Cinca=serrano@posta.unizar.es
 Felipe Serrano=felipe.serrano@ehu.es
 Mònica Serrano=monica.serrano@ub.edu
 Roberto Serrano=roberto_serrano@brown.edu
 Nicolas Andre Benigno Serrano-Velarde=nicolas.serranovelarde@unibocconi.it
 Pablo Serra=pserra@econ.fen.uchile.cl
 Zelia Serrasqueiro=zelia@ubi.pt
 Maroš Servátka=maros.servatka@canterbury.ac.nz
 Dobromił Serwa=dobromil.serwa@nbp.pl
 Ananth Seshadri=aseshadr@ssc.wisc.edu
 Sridhar Seshadri=sridhar.seshadri@mccombs.utexas.edu
 Sakalya Venkata Seshaiah=venkatas@ibsindia.org
 S Venkata Seshaiah=svs_kiams@rediffmail.com
 Ganesh K. Seshan=gks7@georgetown.edu
 Luca Sessa=luca.sessa@bancaditalia.it
 John G Sessions=j.g.sessions@bath.ac.uk
 Giulia Sestieri=giulia.sestieri@banque-france.fr
 Roberta Sestini=sestini@dis.uniroma1.it
 Yuthana Sethapramote=yuthanas@gmail.com
 Nirmal Sethia=sadhu_0@yahoo.co.in
 Rajiv Sethi=rs328@columbia.edu
 Suman Seth=suman.seth@qeh.ox.ac.uk
 Guru Sethupathy=ps2179@columbia.edu
 Kusdhianto Setiawan=kusdhianto@gmail.com
 Maman Setiawan=maman.setiawan@fe.unpad.ac.id
 Mark Setterfield=mark.setterfield@trincoll.edu
 Ofer Setty=ofer.setty@gmail.com
 Ralph Setzer=ralph.setzer@ecb.int
 Purvi Sevak=psevak@hunter.cuny.edu
 Can Sever=cnsvr89@gmail.com
 Battista Severgnini=bs.eco@cbs.dk
 Francesca Severini=francesca.severini@unimc.it
 Benoît Sévi=benoit.sevi@gmail.com
 Almudena Sevilla=a.sevilla@qmul.ac.uk
 Orhun Sevinc=sevinc.orhun@gmail.com
 Sewando=ponsians@yahoo.com
 Reyno Seymore=reyno.seymore@up.ac.za
 Selami Sezgin=selamisezgin@hotmail.com
 Fabio Sforzi=fabio.sforzi@unipr.it
 Nadia Sghaier=sghaiernadia@yahoo.fr
 Silvia Sgherri=ssgherri@imf.org
 Paolo Sgrignoli=paolo.sgrignoli@imtlucca.it
 Pasquale M Sgro=sgro@deakin.edu.au
 Shahbaz Shabbir=shahbazgill@gmail.com
 Leonard Shabman=shabman@rff.org
 Jason Shachat=jason.shachat@gmail.com
 Yochanan Shachmurove=yochanan@econ.upenn.edu
 Douglas A. Shackelford=doug_shack@unc.edu
 Wasel Bin Shadat=wbshadat@yahoo.com
 Mehdi Shafaeddin=m.shafaeddin@gmail.com
 Sherrill Shaffer=shaffer@uwyo.edu
 M. Najeeb Shafiq=mnshafiq@pitt.edu
 Ajay Shah=ajayshah@mayin.org
 Anwar Shah=shah.anwar@gmail.com
 Attaullah Shah=attashah15@hotmail.com
 Kiumars Shahbazi=k.shahbazi@urmia.ac.ir
 Muhammad Shahbaz=shahbazmohd@live.com
 Chandra Shah=chandra.shah@education.monash.edu.au
 Deepak Shah=deepak.ds.shah@gmail.com
 Rozina Shaheen=r.shaheen@lboro.ac.uk
 Abdullah Ibneyy Shahid=abdullahts@yahoo.com
 Koonal K. Shah=kshah@ohe.org
 Manisha Shah=manishashah@ucla.edu
 Asghar Shahmoradi=ashahmoradi@imf.org
 Manuchehr Shahrokhi=mshahrok@csufresno.edu
 Anwar Shaikh=shaikh@newschool.edu
 Azeem M. Shaikh=amshaikh@uchicago.edu
 Salman Ahmed Shaikh=salmanashaikh@iba.edu.pk
 Saleem Shaik=saleem.shaik@ndsu.edu
 Greg Shailer=greg.shailer@anu.edu.au
 Ruvim Shakhnovich=ruvim_s@mail.ru
 Jonathan Shalev=jonathan.shalev@gmail.com
 Haim Shalit=shalit@bgu.ac.il
 Mahvish Shami=m.shami@lse.ac.uk
 Farkhanda Shamim=farashamy@yahoo.com
 Ahmed Shamiri=ahmed_shamiri@yahoo.com
 Maral Shamloo=mshamloo@imf.org
 Nasir Ali Shamsi=editor.jss@centreofexcellence.net
 Syed Furqan Haider Shamsi=s.f.h.shamsi@ncl.ac.uk
 Khadija Shams=kshams.sbbwup@gmail.com
 Mohammad Shamsuddoha=mdsdoha@gmail.com
 Martin Shanahan=martin.shanahan@unisa.edu.au
 Mathew Donald Shane=mshane@ers.usda.gov
 Han Lin Shang=h.shang@soton.ac.uk
 Hua (Helen) Shang=huashang@swufe.edu.cn
 Rashmi Shankar=rshankar@worldbank.org
 Sriram Shankar=s.shankar@uws.edu.au
 Venkatesh Shankar=vshankar@mays.tamu.edu
 Jay Shanken=jay.shanken@emory.edu
 Chris Shannon=cshannon@econ.berkeley.edu
 Rajaratnam Shanthini=rshanthini@pdn.ac.lk
 Bayuni Shantiko=b.shantiko@gmail.com
 Mingliang Frank Shao=mingliangshao@gmail.com
 Xiaofeng Shao=xshao@uiuc.edu
 Adam Hale Shapiro=adam.shapiro@sf.frb.org
 Alexander Shapiro=ashapiro@isye.gatech.edu
 Carl Shapiro=shapiro@haas.berkeley.edu
 Jesse Shapiro=jmshapir@uchicago.edu
 Shahla Shapouri=shapouri@ers.usda.gov
 Hosein Sharifi-Renani=sharifi55r@yahoo.com
 Mahin Sharif=sharif.mahin@gmail.com
 Abhijit Sharma=a.sharma12@bradford.ac.uk
 Ajay Sharma=ajays@igidr.ac.in
 Akhilesh K. Sharma=aksbhu2608@gmail.com
 Amarendra Sharma=asharma@elmira.edu
 Anurag Sharma=anurag.sharma@monash.edu
 Dr. Chanchal Kumar Sharma=chanchalsharma1@gmail.com
 Ghanshyam Sharma=gsharma@clemson.edu
 Hari Sharma=hari.sharma@trincoll.edu
 Kalyan Raj Sharma=kalyanrajsharma@gmail.com
 Kanhaiya Lal Sharma=klsharmadr@gmail.com
 Manohar P. Sharma=msharma5@worldbank.org
 Parmendra Sharma=p.sharma@griffith.edu.au
 Sandeshika Sharma=sandeshika@hotmail.com
 Shruti Sharma=shrutis@iimahd.ernet.in
 Shyam Sunder Sharma Prasad=ssp_sharma@yahoo.com
 Subhash C. Sharma=sharma@siu.edu
 Sunil Sharma=ssharma@imf.org
 Sunil Sharma=sunilsharma@iimahd.ernet.in
 Tridib Sharma=sharma@itam.mx
 Steven Sharpe=steve.a.sharpe@frb.gov
 Timothy P. Sharpe=timothy.sharpe@newcastle.edu.au
 Paul Richard Sharp=pauls@sam.sdu.dk
 Sergey Shashnov=shashnov@hse.ru
 Howard J. Shatz=howard_shatz@rand.org
 Mughees Shaukat=mughees.ams@gmail.com
 Steven Shavell=shavell@law.harvard.edu
 Tal Shavit=shavittal@gmail.com
 Daigee Shaw=shawdg@gmail.com
 Daniel Lloyd Shawhan=shawhd@rpi.edu
 Philip John Shaw=pshaw5@fordham.edu
 Oleg Shchetinin=oleg@fastmail.fm
 Gary Stephen Shea=gss2@st-andrews.ac.uk
 John Shea=shea@econ.umd.edu
 Paul Shea=pshea@bates.edu
 Mordechai Shechter=shechter@econ.haifa.ac.il
 Kevin Daniel Sheedy=k.d.sheedy@lse.ac.uk
 John Sheehan=john.sheehan@ucd.ie
 Jeffrey Sheen=jeffrey.sheen@mq.edu.au
 Steven Sheffrin=smsheffrin@tulane.edu
 Emad Abd Elmessih Shehata=emadstat@hotmail.com
 Shahbaz Sheikh=ssheik2@uwo.ca
 Tanmaya Shekhar=tanmaya.shekhar@gmail.com
 Robert C. Shelburne=robert.shelburne@unece.org
 Natalya Shelkova=shelkovany@guilford.edu
 Karl Shell=karl.shell@cornell.edu
 Maria Aleksandrovna Sheluntcova=msheluntsova@hse.ru
 Ashley Chunli Shen=shenchunli@gmail.com
 Li Sheng=edmundsheng@ipm.edu.mo
 Liugang Sheng=lsheng@cuhk.edu.hk
 Xuguang Sheng=sheng@american.edu
 Yu Sheng=yusheng7713@gmail.com
 Jianfeng Shen=jianfeng.shen@unsw.edu.au
 Jung-Chin Shen=jcshen@yorku.ca
 Junyi Shen=shen@rieb.kobe-u.ac.jp
 Kailing SHEN=kailing.shen@gmail.com
 Leilei Shen=lshen@k-state.edu
 沈凌 (Ling Shen)=vwlde@hotmail.com
 Minggao Shen=minggao.shen@citi.com
 Ajay Shenoy=ajay.m.shenoy@gmail.com
 Wenyi Shen=wenyi.shen@okstate.edu
 Neil Shephard=shephard@fas.harvard.edu
 Ben Shepherd=ben@developing-trade.com
 Debra Lynne Shepherd=debrashepherd@sun.ac.za
 Oleksandr Shepotylo=oshepotylo@hse.ru
 Kevin Sheppard=kevin.sheppard@economics.ox.ac.uk
 Stephen Sheppard=stephen.c.sheppard@williams.edu
 Roman M. Sheremeta=rshereme@gmail.com
 Brandon J. Sheridan=bsheridan@noctrl.edu
 Glenn Sheriff=sheriff.glenn@epa.gov
 Itai Sher=isher@umn.edu
 Stephen Sherlock=ssherlock@gmail.com
 Ann Sherman=ann.sherman@depaul.edu
 Joshua Sherman=joshua.sherman@univie.ac.at
 Eytan Sheshinski=mseytan@mscc.huji.ac.il
 Andrey Shevchuk=shevchuk@hse.ru
 Eugenia Shevtsova=y.shevtsova@liverpool.ac.uk
 Christos Shiamptanis=cshiamptanis@wlu.ca
 Akihisa Shibata=shibata@kier.kyoto-u.ac.jp
 Yeung-Nan Shieh=ynshieh@yahoo.com
 Michael A. Shields=mshields@unimelb.edu.au
 Michael P. Shields=shiel1mp@cmich.edu
 Leslie Shiell=leslie.shiell@uottawa.ca
 Abdulaziz Behiru Shifa=abshifa@maxwell.syr.edu
 Admasu Shiferaw=ashiferaw@wm.edu
 Yosuke Shigemi=yousuke.shigemi@boj.or.jp
 Hitoshi Shigeoka=hitoshi_shigeoka@sfu.ca
 Shinichi Shigetomi=sigetomi@ide.go.jp
 He-ling Shi=he-ling.shi@monash.edu
 Hui-Tzu Shih=sophia_shih@cier.edu.tw
 Jhih-Shyang Shih=shih@rff.org
 Hui Shi=shihui710@yahoo.com.cn
 Jingye SHI=sjy@swufe.edu.cn
 Kang Shi=kangshi@cuhk.edu.hk
 Serge Shikher=serge.shikher@usitc.gov
 Claudio Djissey Shikida=cdshikida@gmail.com
 Lan Shi=lshi@urban.org
 Lei Shi=lei.shi-2@student.uts.edu.au
 Robert J. Shiller=robert.shiller@yale.edu
 Nikhil Chandra Shil, ACMA=nikhilacc@yahoo.com
 Andrey Shilov=zrk1@yandex.ru
 Kenichi Shimamoto=k.shimamoto@bham.ac.uk
 Abebe Shimeles=a.shimeles@afdb.org
 Robert Shimer=shimer@uchicago.edu
 Hiroshi Shimizu=shimizu@iir.hit-u.ac.jp
 Takashi Shimizu=tshimizu@kansai-u.ac.jp
 Satoshi Shimizutani=sshimizutani@iips.org
 Tatsuya Shimizu=tatsuya_shimizu@ide.go.jp
 Jungwook Shim=sim0625@gmail.com
 Tetsuya Shimomura=shimomura-t2vt@mlit.go.jp
 Shafiun Nahin Shimul=shafiun@huskers.unl.edu
 Naoki Shinada=naoki.shinada@pobox.com
 Nan Shi=nan.shi@durham.ac.uk
 Dongsoo Shin=dshin@scu.edu
 Anirudh Shingal=anirudh.shingal@wti.org
 Tetsuya Shinkai=shinkai@kwansei.ac.jp
 Kwanho Shin=khshin@korea.ac.kr
 Edward Shinnick=e.shinnick@ucc.ie
 Judith A. Shinogle=jshinogle@rti.org
 Junnosuke Shino=junnosuke.shino@gmail.com
 Richard T. Shin=rtshin@gmail.com
 Mototsugu Shintani=mototsugu.shintani@vanderbilt.edu
 Yongcheol Shin=yongcheol.shin@york.ac.uk
 Youngki Shin=yshin29@uwo.ca
 Arthur F. Shipman=art.shipman@gmail.com
 Shigenori Shiratsuka=shigenori.shiratsuka@boj.or.jp
 Mehdi Shirkosh=mehdis112000@yahoo.com
 Galina V. Shirokova=shirokova@gsom.pu.ru
 Alexander Shirov=schir@ecfor.ru
 Shouyong Shi=shouyong@chass.utoronto.ca
 Shu-Ping Shi=shuping.shi@mq.edu.au
 Tian Shi=tian.shi@sa.gov.au
 Carol Hua Shiue=shiue@colorado.edu
 Edward Shiu=e.shiu@bangor.ac.uk
 Gerald E. Shively=shivelyg@purdue.edu
 Xiaojun Shi=sxjstein@gmail.com
 Xiaoping Shi=serena2@njau.edu.cn
 Xiaoxia Shi=xiaoxia.shi@gmail.com
 Xinzheng Shi=shixzh@sem.tsinghua.edu.cn
 Xunpeng Shi=xunpeng.shi@gmail.com
 Shiyan Anatoliy A.=aa_shiyan@mail.ru
 Yaojiang Shi=syj8882002@yahoo.com.cn
 Yunnan Shi=yunnan.shi@univ-rennes1.fr
 Ovsey Shkaratan=ovsey@hse.ru
 Stanislav Edward Shmelev=stanislav.shmelev@googlemail.com
 Artyom Shneyerov=artyom239@gmail.com
 William Shobe=shobe@virginia.edu
 Gary Lee Shoesmith=shoesmgl@wfu.edu
 Jason Shogren=jramses@uwyo.edu
 Masahiro Shoji=shoji@seijo.ac.jp
 Abu Syeid Mohammad Parves Shonchoy=abu@ide.go.jp
 Lara Shore-Sheppard=lshore@williams.edu
 Jamsheed Shorish=jshorish@gmail.com
 Mikhael Shor=mike.shor@uconn.edu
 Jacob M. Short=jshort25@uwo.ca
 Anja K. Shortland=anja.shortland@kcl.ac.uk
 James Samuel Shortle=jshortle@psu.edu
 منهل شوتر Manhal Shotar (Manhal M. Shotar)=manhalshotar@yahoo.com
 Mark H. Showalter=mhs@byu.edu
 Min B. Shrestha=minshrestha@nrb.org.np
 Shailesh Shrestha=shailesh.shrestha@sruc.ac.uk
 Ronald E. Shrieves=rshrieve@utk.edu
 Mark D. Shroder=mark.d.shroder@hud.gov
 Ze'ev Shtudiner=zeevs@ariel.ac.il
 Geoffrey Shuetrim=geoff@galexy.net
 William F. Shughart II=william.shughart@usu.edu
 Malik Shukayev=mshukayev@bankofcanada.ca
 Megha Shukla=meghashukla2001@yahoo.com
 Paurav Shukla=paurav.shukla@gcu.ac.uk
 Ghazi Shukur=ghazi.shukur@ihh.hj.se
 Matthew Shum=mshum@caltech.edu
 Pauline M. Shum=pshum@yorku.ca
 Nicholas Shunda=nicholas_shunda@redlands.edu
 Yan Shu=shuyan@swufe.edu.cn
 Julia Shvets=js591@cam.ac.uk
 Irma Shyle=irmitash@yahoo.com
 Oz Shy=ozshy@ozshy.com
 Clemens Sialm=clemens.sialm@mccombs.utexas.edu
 Barbara Sianesi=barbara_s@ifs.org.uk
 Nawid Siassi=nawid.siassi@uni-konstanz.de
 Philipp Sibbertsen=sibbertsen@statistik.uni-hannover.de
 Anne Sibert=asibert@econ.bbk.ac.uk
 Luke Sibieta=luke_s@ifs.org.uk
 Edgardo Sica=e.sica@unifg.it
 Daniel Sichel=dsichel@wellesley.edu
 Luigi Siciliani=ls24@york.ac.uk
 Pierre Sicsic=pierre.sicsic@banque-france.fr
 Terry Sicular=sicular@uwo.ca
 Khalid Hassan Ali Siddig=khalidhasiddig@yahoo.com
 Hammad A. Siddiqi=h.siddiqi@uq.edu.au
 Omer Siddique=o.siddique06@fulbrightmail.org
 Zahra Siddique=z.siddique@reading.ac.uk
 Danish Ahmed Siddiqui=daanish79@hotmail.com
 Rehana Siddiqui=rehana@pide.org.pk
 Marco Sideri=msideri@crenos.unica.it
 Modibo SIDIBE=modibo.sidibe@duke.edu
 Сидорчук Роман Роальдович (Roman Sidorchuk)=muller@mail.ru
 Oleg Sidorkin=oleg.sidorkin@cerge-ei.cz
 Alexander Sidorov=alex.v.sidorov@gmail.com
 Ralph Bernd Siebert=rsiebert@purdue.edu
 Stan Siebert=w.s.siebert@bham.ac.uk
 Franz Krige Siebrits=krigesiebrits@sun.ac.za
 Jan-Peter Siedlarek=janpeter.siedlarek@gmail.com
 Thomas Siedler=thomas.siedler@wiso.uni-hamburg.de
 Iulia Siedschlag=iulia.siedschlag@esri.ie
 Christian Siegel=c.siegel@exeter.ac.uk
 Donald S. Siegel=dsiegel@uamail.albany.edu
 Peter Siegelman=peter.siegelman@law.uconn.edu
 Melissa Siegel=melissa.siegel@maastrichtuniversity.nl
 Stephan Siegel=ss1110@u.washington.edu
 Olaf Siegert=o.siegert@zbw.eu
 John J. Siegfried=john.siegfried@vanderbilt.edu
 Gernot Sieg=gernot.sieg@uni-muenster.de
 Mark V. Siegler=msiegler@csus.edu
 Sebastian Siegloch=siegloch@iza.org
 Arjen Siegmann=a.h.siegmann@vu.nl
 Michael Siemer=michael.siemer@frb.gov
 Lars-H. R. Siemers=siemers@vwl.wiwi.uni-siegen.de
 Thomas Siemsen=thomas.siemsen@econ.lmu.de
 Eva M. Sierminska=esiermin@jhu.edu
 Hans Henrik Sievertsen=hans.henrik.sievertsen@econ.ku.dk
 Fiona D. Sigalla=fionasigalla@gmail.com
 Hilary Sigman=hsigman@rutgers.edu
 Marcello Signorelli=marcello.signorelli@unipg.it
 Giovanni Signorello=g.signorello@unict.it
 Federico M. Signoretti=federicomaria.signoretti@bancaditalia.it
 Rodolfo Signorino=rodolfo.signorino@unipa.it
 Ombretta Signori=ombretta.signori@axa-im.com
 Nathalie Sigot=nsigot@univ-paris1.fr
 Christian Sigouin=csigouin@vax2.concordia.ca
 Waleska Siguenza=waleska.siguenza@ehu.es
 Jósef Sigurdsson=josefsig@gmail.com
 Dr. Sikder Md. Anowarul Islam=sikder08@hotmail.com
 Pierre Siklos=psiklos@wlu.ca
 Grzegorz Sikora=grzegorz.sikora@pwr.wroc.pl
 Jacques Silber=jsilber_2000@yahoo.com
 Maria Silea Ghisa=maria.ghisasilea@univ-angers.fr
 Mary A. Silles=m.silles@hull.ac.uk
 Keith Sill=keith.sill@phil.frb.org
 Alan Cosme Rodrigues da Silva=alan.cosme@bcb.gov.br
 Alexandre Silva=alexandre-manoel.silva@ipea.gov.br
 Andrea Rojao Silva=andrea.silva@ics.ul.pt
 Andre C. Silva=acsilva@novasbe.pt
 Armando Silva=armandosilva@eu.ipp.pt
 Bartolomeu Leite da Silva=blsic@hotmail.com
 Maria Leonor da Silva Carvalho=leonor@uevora.pt
 César Roberto Leite da Silva=crlsilva@pucsp.br
 Christian Luiz da Silva=christiansilva@utfpr.edu.br
 Dimaria Silva e Meirelles=dmeirelles@gmail.com
 Emilson Caputo Delfino Silva=emilson@ualberta.ca
 Ester Gomes Silva=esilva@letras.up.pt
 Filipe Silva=filipeourico@gmail.com
 Francisca Silva=fsilvat@uc.cl
 Guilherme Jonas Costa Da Silva=guilhermejonas@yahoo.com.br
 Jérôme Silva=jerome.silva@gmail.com
 Joana Silva=jsilva@worldbank.org
 João Carlos Domingos da Silva, Sr.=joaocds@unifacs.br
 João Cerejeira Silva=jccsilva@eeg.uminho.pt
 Joaquim Ramos Silva=jrsilva@iseg.utl.pt
 Jorge Daniel Faria Silva=jorgefariasilva@gmail.com
 José Ignacio Silva=j.i.silva-becerra@kent.ac.uk
 Julie A. Silva=jasilva@ufl.edu
 Artur C. B. da Silva Lopes=asl@iseg.utl.pt
 Marcelo Eduardo Alves da Silva=marcelo.easilva@ufpe.br
 Maria José Silva=msilva@ubi.pt
 Olmo Silva=o.silva@lse.ac.uk
 Patrícia Pereira da Silva=patsilva@fe.uc.pt
 Pedro M. Silva=pmarques@ubi.pt
 Peri Agostinho da Silva, Jr.=pdasilva@k-state.edu
 Maria CAS Portela=csilva@porto.ucp.pt
 Param Silvapulle=param.silvapulle@buseco.monash.edu.au
 Ricardo Gonçalves Silva=rgs.rsilva@gmail.com
 Sandra Tavares Silva=sandras@fep.up.pt
 Tomás Silva=tfposilva@gmail.com
 Victor Hugo de Oliveira Silva=victor.hugo@ipece.ce.gov.br
 Florent Silve=florent.silve@cantab.net
 Fernando Gaiger Silveira=fernando.gaiger@ipea.gov.br
 Annastiina Silvennoinen=silvennoinen@qut.edu.au
 Gerald Silverberg=gerald.silverberg@maastrichtuniversity.nl
 Dan Silverman=daniel.silverman.1@asu.edu
 Mick Silver=msilver@imf.org
 Randy G. Silvers=sirandol@deakin.edu.au
 David N. Silverstein=davidsi@kth.se
 Brian Silverstone=silver@waikato.ac.nz
 Antonio Luis Silvestre=als@iseg.utl.pt
 Paolo Silvestri=paolo.silvestri@unito.it
 Marinescu Mihaela Silvia=marinescu_mihaela_silvia@yahoo.com
 Riccardo Silvi=riccardo.silvi@unibo.it
 Ani Rudra Silwal=a.silwal@sussex.ac.uk
 Elena Silyakova=silyakova@gmail.com
 Yuri V. Simachev=ysimachev@yandex.ru
 Radu Simandan=radusimandan@yahoo.com
 Inês Simão=ines_simao_@hotmail.com
 Leopold Simar=leopold.simar@uclouvain.be
 Djamester A. Simarmata=da.simarmata@gmail.com
 Emilia Simeonova=emilia.simeonova@gmail.com
 Ralitsa Simeonova-Ganeva=r_ganeva@feb.uni-sofia.bg
 Can F.N. Mugan=mugan@metu.edu.tr
 Ovidiu Laurian SIMINA=ovidiusimina@yahoo.com
 Marian Siminica=msiminica@yahoo.com
 Peter Matthew Siminski=siminski@uow.edu.au
 Timothy T. Simin=tsimin@psu.edu
 Dalia Simion=daliasimion@yahoo.com
 Felix Simione, Sr.=fsimione@gmail.com
 Scott Paul Simkins=scott.simkins@gmail.com
 Michael Simkovic=msimkovic@gmail.com
 Phillip Ray Simmons=psimmons@une.edu.au
 Robert Simmons=r.simmons@lancaster.ac.uk
 Marta C. N. Simões=mcsimoes@fe.uc.pt
 Nadia Simoes=nadia.simoes@iscte.pt
 Pedro Simões=psimoes@civil.ist.utl.pt
 Rodrigo Simões=limoes@cedeplar.ufmg.br
 Jean-Guy Simonato=jean-guy.simonato@hec.ca
 David Eliot Simon=david.simon@uconn.edu
 Xavier Simón Fernández=xsimon@uvigo.es
 Hipolito Simon=hsimon@ua.es
 Jenny Simon=jenny.simon@hhs.se
 Kosali Ilayperuma Simon=simonkos@indiana.edu
 Leo K. Simon=leosimon@berkeley.edu
 Véronique Simonnet=veronique.simonnet@univ-paris1.fr
 Zoran Dragoljub Simonovic=zoki@medianis.net
 Andras Simonovits=simonov@econ.core.hu
 Ina Simonovska=inasimonovska@ucdavis.edu
 Sandor Simon=simonsandor5@me.com
 Marianne Simonsen=msimonsen@econ.au.dk
 Uri Simonsohn=usimonsohn@ucsd.edu
 Itamar Simonson=itamars@stanford.edu
 Theodore Simos=tsimos@cc.uoi.gr
 Hrvoje Šimović=hsimovic@efzg.hr
 Simpasa, Anthony=amsimpasa@gmail.com
 Richard Simper=richard.simper@nottingham.ac.uk
 Brian P. Simpson=bsimpson@nu.edu
 James Simpson=james@clio.uc3m.es
 John Lockyer Simpson=simpsonj@cbs.curtin.edu.au
 Nicole B. Simpson=nsimpson@colgate.edu
 Charles Sims=cbsims@utk.edu
 Christopher Sims=sims@princeton.edu
 mevludiye simsek, Jr.=simsekms28@yahoo.com
 Eric Sims=esims1@nd.edu
 Paul Edward Simshauser=msimshau@hotmail.com
 William Sims=william.sims@concordia.ca
 Laurent Simula=laurent.simula@nek.uu.se
 Jurica Šimurina=jsimurina@efzg.hr
 Franz Sinabell=franz.sinabell@wifo.ac.at
 Christine Sinapi=christine.sinapi@escdijon.eu
 Dubravka Sinčić=dsincic@efzg.hr
 Friedrich Sindermann=friedrich.sindermann@uibk.ac.at
 Maximilian Sindram=maximilian.sindram@tum.de
 Chetan B. Singai=chetanbsingai@gmail.com
 Marcos Singer=msinger@uc.cl
 Nico Singer=nico.singer@uni-rostock.de
 Aarti Singh=aarti.singh@sydney.edu.au
 Abhijeet Singh=abhijeet.singh@economics.ox.ac.uk
 Ajit Singh=as14@cam.ac.uk
 Monica Singhal=monica_singhal@harvard.edu
 Saurabh Singhal=saurabh@wider.unu.edu
 Anshul Kumar Singh=ansks@iitk.ac.in
 Anurag Singh=anuragbhadauria@yahoo.com
 Bhartendu Singh=bsinghmzu@yahoo.com
 Bhupal Singh=bhupalsingh1@gmail.com
 Gurmeet Singh=singh_g@usp.ac.fj
 Indervir Singh=indervirs@gmail.com
 Jai Pal Singh=jpsingh@hau.ernet.in
 Karan Singh=karan@icrier.res.in
 Krishna Murari Singh=m.krishna.singh@gmail.com
 Lakhwinder Singh=lakhwindergill@pbi.ac.in
 Nirvikar Singh=boxjenk@ucsc.edu
 Rahul Singh=rahul.singh@bimtech.ac.in
 Rajdeep Singh=rajsingh@umn.edu
 Rajesh Singh=rsingh@iastate.edu
 Raju Jan SINGH=rsingh9@worldbank.org
 Ram Singh=ramsingh@econdse.org
 Sarjinder Singh=sarjinder@yahoo.com
 Satyendra Kumar Singh=sty_singh@yahoo.com
 Saurabh Singh=saurabhsingh@consultant.com
 Sudhir K. Singh=sudhir219@gmail.com
 Sunny Kumar Singh=sunnysingh.gipe@gmail.com
 Suresh Prasad Singh=sps@cuts.org
 Tejinder Singh=tsingh@ncaer.org
 Vik Singh=micro_economics@hotmail.com
 Vivek Singh=vatsmala@umich.edu
 John Singleton=singojohn@hotmail.com
 John D. Singleton=john.singleton@duke.edu
 Perry Douglas Singleton, II=psinglet@syr.edu
 Tien Foo Sing=rststf@nus.edu.sg
 Anushree Sinha=asinha@ncaer.org
 Arunima Sinha=as2801@columbia.edu
 Dipendra Sinha=dsinha@apu.ac.jp
 Kanhaiyaa Kumar Sinha,=kumarverma061@gmail.com
 Kompal Sinha=kompal.sinha@monash.edu
 Narain Sinha=sinhan@mopipi.ub.bw
 Pankaj Sinha=pankaj-sinha@fms.edu
 Tapen Sinha=tapen@itam.mx
 Uday Bhanu Sinha=sinha.uday@gmail.com
 Daniel Lavarda Sinigaglia=dsinigaglia@gmail.com
 Jasmin Sin=jasmin.sin@bristol.ac.uk
 Rudolf R. Sinkovics=rudolf.sinkovics@manchester.ac.uk
 Hans-Werner Sinn=sinn@ifo.de
 Georgia Siougle=gsiougle@aueb.gr
 Gregorios Siourounis=siourounis@yahoo.com
 Aloysius Siow=siow@chass.utoronto.ca
 Ciprian Șipoș (Ciprian Sipos)=ciprian.sipos@e-uvt.ro
 Carmen Gabriela Sirbu=carmensirbu@univ-danubius.ro
 Andrei Sirchenko=asirchenko@hse.ru
 Adiatma YM Siregar=adiatma.siregar@fe.unpad.ac.id
 Reza Y. Siregar=rezasiregar@yahoo.com
 Kavita Sirichand=k.sirichand@lboro.ac.uk
 Lucie Sirieix=sirieix@supagro.inra.fr
 Selahattin Murat ŞİRİN=msirin@epdk.gov.tr
 Mahinda Siriwardana=asiriwar@une.edu.au
 Ibrahim Sirkeci=sirkeci@yahoo.com
 Gabriela Sirkis=gsirkis@cema.edu.ar
 Espen Sirnes=espen.sirnes@uit.no
 Smita Sirohi=smitasirohi@yahoo.com
 Andrea Sironi=andrea.sironi@unibocconi.it
 Emanuela Sirtori=sirtori@csilmilano.com
 Martin Sirucek=sirucek@gmail.com
 Nicolas Sirven=nicolas.sirven@parisdescartes.fr
 Dana Sisak=sisak@ese.eur.nl
 Dana Gabriela Sisea=danasiseea@yahoo.com
 Elif Sisli Ciamarra=esisli@brandeis.edu
 Carolyn Sissoko=csissoko5@gmail.com
 Yaya Sissoko=ysissoko@iup.edu
 Andrea Sisto=sistoand80@libero.it
 Roberta Sisto=r.sisto@unifg.it
 Hokky Situngkir=hokkysitungkir@gmail.com
 Bruno Sitzia=bruno.sitzia@unibocconi.it
 Henry E. Siu=hankman@mail.ubc.ca
 Tak Kuen Siu=ktksiu2005@gmail.com
 K. Jothi Sivagnanam=kjothisiva24@gmail.com
 Elizaveta Sivak=esivak@hse.ru
 Lucio Siviero=lsiviero@unict.it
 Stefano Siviero=stefano.siviero@bancaditalia.it
 Martin Daniel Siyaranamual=siyaranamual.martin@fe.unpad.ac.id
 Anna Sjögren=anna.sjogren@ifau.uu.se
 Gabriella Sjögren Lindquist=gabriella.lindquist@sofi.su.se
 Tomas Sjögren=tomas.sjogren@econ.umu.se
 Fredrik Sjöholm=fredrik.sjoholm@nek.lu.se
 William Sjostrom=w.sjostrom@ucc.ie
 Morten Skak=mos@sam.sdu.dk
 Dorota Skala=dskala@wneiz.pl
 Joakim Skalin=joakim.skalin@konj.se
 Ali Skalli=skalli@u-paris2.fr
 David Benjamin Skarbek=davidskarbek@gmail.com
 Marinko Skare=mskare@efpu.hr
 Vatroslav Skare=vskare@efzg.hr
 Susan Skeath=sskeath@wellesley.edu
 Per Skedinger=per.skedinger@ifn.se
 David R. Skeie=david.skeie@ny.frb.org
 Ed Skelton=ed.skelton@dal.frb.org
 Alexandra Jane Skew=ajskew@essex.ac.uk
 Alexandre Skiba=askiba@uwyo.edu
 Bernd Skiera=skiera@wiwi.uni-frankfurt.de
 Jonathan Skinner=jonathan.skinner@dartmouth.edu
 Georgia Skintzi=gskintzi@aueb.gr
 Vasiliki Skintzi=vikiski@uop.gr
 Johannes Atle Skjeltorp=jsk@nbim.no
 Terje Skjerpen=terje.skjerpen@ssb.no
 Peter Skogman Thoursie=peter.thoursie@ne.su.se
 Karel Skokan=skokan@opf.slu.cz
 Hazbo Skoko=hskoko@csu.edu.au
 Tristan Skolrud=tristan.skolrud@email.wsu.edu
 Anders Skonhoft=anders.skonhoft@svt.ntnu.no
 Nora Skopek=nora.skopek@uni-bamberg.de
 Michal Skořepa=m.sko@seznam.cz
 Irina Ivanovna Skorobogatykh=iskorobogatykh@gmail.com
 Peter Skott=pskott@econs.umass.edu
 Emmanuel Skoufias=eskoufias@worldbank.org
 Spyros P. Skouras=skouras@aueb.gr
 Christian Stejner Skovsgaard=chsko@sam.sdu.dk
 Blanka Skrabic Peric=bskrabic@efst.hr
 Vasiliki Skreta=vskreta@gmail.com
 Anton Skrobotov=antonskrobotov@gmail.com
 Dimitris Skuras=skuras@econ.upatras.gr
 Monika Slaba=monika.slaba@yahoo.com
 Jiri (Jirka) Slacalek=jiri.slacalek@gmail.com
 Tomas Slacik=tomas.slacik@ecb.int
 Margaret Slade=m.slade@mac.com
 Jan Sladkowski=sladk@us.edu.pl
 Karel Sladký=sladky@utia.cas.cz
 Martin Slanicay=slanicay@mail.muni.cz
 Alexander Slastnikov=slast@cemi.rssi.ru
 Gary John Robert Slater=g.slater@leeds.ac.uk
 Edward Slattery=eslattery@ers.usda.gov
 Trajko Slaveski=slaveski@eccf.ukim.edu.mk
 Slavi Slavov=slavi.t.slavov@gmail.com
 Joanna Kinga Sławatyniec=joanna.slawatyniec@graduateinstitute.ch
 Aurélie Slechten=aslechte@ulb.ac.be
 Katarzyna Śledziewska=k.sledziewska@uw.edu.pl
 Allan G. Sleeman=asleeman@telebyte.com
 Olaf C.H.M. Sleijpen=o.sleijpen@maastrichtuniversity.nl
 Tilman Slembeck=tilman.slembeck@unisg.ch
 Joel Slemrod=jslemrod@umich.edu
 Irina Slinko=irina.a.slinko@gmail.com
 Al Slivinski=aslivins@uwo.ca
 Olga Slivko=slivko@zew.de
 Przemyslaw Sliwa=przemyslaw.sliwa@uk.bnpparibas.com
 Frank Allen Sloan=fsloan@duke.edu
 Brian W Sloboda`=gr8694@verizon.net
 Sergey Slobodyan=sergey.slobodyan@cerge-ei.cz
 Torsten Slok=torstenslok@gmail.com
 Agnieszka Slomka-Golebiowska=aslomka@sgh.waw.pl
 Fabian Slonimczyk=fslonimczyk@hse.ru
 Randolph Sloof=r.sloof@uva.nl
 Veerle Slootmaekers-Miranda=veerle.miranda@oecd.org
 Birgitte Sloth=bisl@samf.ku.dk
 Oleksiy Sluchynsky=osluchynskyy@worldbank.org
 Roderik van Sluis=rvansluis@wxs.nl
 Nicholas Sly=sly@uoregon.edu
 Melinda Smale=msmale@msu.edu
 Kenneth A. Small=ksmall@uci.edu
 Aaron Dean Smallwood=smallwood@uta.edu
 David J.C. Smant=djcsmant@gmail.com
 Michael Smart=msmart@economics.utoronto.ca
 Sinne Smed=ss@ifro.ku.dk
 Stephan Smeekes=s.smeekes@maastrichtuniversity.nl
 Valerie Smeets=vas@asb.dk
 Alessandra Smerilli=alessandra.smerilli@uea.ac.uk
 Maciej Smętkowski=msmetkowski@uw.edu.pl
 Mike Smet=mike.smet@kuleuven.be
 Lodewijk Smets=lodewijk.smets@ua.ac.be
 Kent Smetters=smetters@wharton.upenn.edu
 Katerina Smidkova=katerina.smidkova@cnb.cz
 Martin Smid=martin@klec.cz
 Sławomir Śmiech=smiechs@uek.krakow.pl
 Saul Smilansky=smilsaul@research.haifa.ac.il
 Maria M. Smirnova=smirnova@gsom.pu.ru
 Natalia V. Smirnova=natalia.smirnova@aier.org
 Vladimir Smirnov=vladimir.smirnov@sydney.edu.au
 Larisa Smirnykh=lsmirnykh@hse.ru
 Aaron Smith=adsmith@ucdavis.edu
 Han Smit=jsmit@few.eur.nl
 Andrew S.J. Smith=a.s.j.smith@its.leeds.ac.uk
 Anthony A. Smith=tony.smith@yale.edu
 Ben O. Smith=tazz_ben@ad.wsu.edu
 Christie Smith=christie.smith@rbnz.govt.nz
 Constance Smith=constance.smith@ualberta.ca
 Daniel R. Smith=d4.smith@qut.edu.au
 David M. Smith=ds693@albany.edu
 Douglas E. Smith=des9907@gmail.com
 Eric F. Smith=esmith@essex.ac.uk
 Howard William Smith=howard.smith@economics.ox.ac.uk
 Ian Smith=is@st-and.ac.uk
 James D. Smith=smith.james-d@epa.gov
 James L. Smith=jsmith@mail.cox.smu.edu
 James P. Smith=smith@rand.org
 Janet Kiholm Smith=janet.smith@cmc.edu
 Jeffrey S. Smith=smithjs@vmi.edu
 Jeffrey Andrew Smith=econjeff@umich.edu
 Jennifer C. Smith=jennifer.smith@warwick.ac.uk
 John Alan Smith=smithj@camden.rutgers.edu
 Josephine M. Smith=jsmith@stern.nyu.edu
 Justin Smith=jusmith@wlu.ca
 Karen Elizabeth Smith=ksmith@ui.urban.org
 Keith Smith=keith.smith@utas.edu.au
 Lones Smith=lones.smith@gmail.com
 L. Vanessa Smith=vanessa.smith@york.ac.uk
 Mark Griffin Smith=msmith@coloradocollege.edu
 Matthew E. Smith=matt.smith@nyu.edu
 Matthew Luke Smith=matthew.smith@sydney.edu.au
 Michael Stanley Smith=mike.smith@mbs.edu
 Nina Smith=nsmith@econ.au.dk
 Peter Smith=pns2@york.ac.uk
 Richard A. Smith=richardsmith212@yahoo.com
 Richard B. Smith=smithrb@usfsp.edu
 Richard J. Smith=rjs27@econ.cam.ac.uk
 Richard L. Smith, II=richard.smith@ucr.edu
 Richard Todd Smith=smithrt@ualberta.ca
 Ronald Smith=r.smith@bbk.ac.uk
 Stephen Smith=stephen.smith@ucl.ac.uk
 Stephen C. Smith=ssmith@gwu.edu
 Stephen L. S. Smith=stephen.smith@gordon.edu
 Thomas More Smith=aceitreasurer@gmail.com
 Tom Smith=tom.smith@bankofengland.co.uk
 Trenton G. Smith=trent.smith@otago.ac.nz
 Valdemar Smith=vsmith@asb.dk
 William Doyle Smith=wsmith@utep.edu
 Martijn Smit=m.j.smit@uu.nl
 Wendy Smits=wmts@cbs.nl
 Šime Smolić=ssmolic@efzg.hr
 Marcel Smolka=msmolka@econ.au.dk
 Aliaksei Smolski=refor@mail.ru
 Grega Smrkolj=grega.smrkolj@gmail.com
 Sjak Smulders=j.a.smulders@uvt.nl
 Magdalena Smyk=msmyk@wne.uw.edu.pl
 Emer Smyth=emer.smyth@esri.ie
 Russell Smyth=russell.smyth@monash.edu
 Stuart Snaith=ssnaith@essex.ac.uk
 Hal W. Snarr=hsnarr@westminstercollege.edu
 Stacy Ellen Sneeringer=ssneeringer@ers.usda.gov
 Henri Sneessens=henri.sneessens@uni.lu
 Andy Snell=a.j.snell@ed.ac.uk
 Martin Snell=martin.snell@port.ac.uk
 Florian Sniekers=f.j.t.sniekers@uva.nl
 Graeme Donald Snooks=seouenaca@gmail.com
 Kenneth A. Snowden=snowden@uncg.edu
 Dennis Snower=dennis.snower@ifw-kiel.de
 Brett Richard Snyder=snyder.brett@epa.gov
 Christopher Mark Snyder=chris.snyder@dartmouth.edu
 Donald L. Snyder=don.snyder@usu.edu
 Ralph David Snyder=ralph.snyder@monash.edu
 Susan Snyder=sksnyder@stanfordalumni.org
 Ana Cristina Soares=acsoares@bportugal.pt
 Carla Soares=csoares@bportugal.pt
 Fernando Brito Soares=fbsoares@fe.unl.pt
 Jorge Soares=jsoares@udel.edu
 Rodrigo R. Soares=rodrigo.reis.soares@fgv.br
 Sergei Suarez Dillon Soares=sergei.soares@ipea.gov.br
 Francesco Sobbrio=francesco.sobbrio@unicatt.it
 Giuseppe Sobbrio=sobbriog@unime.it
 Joel Sobel=jsobel@ucsd.edu
 Ирина Владимировна Соболева (Irina Vladimirovna Soboleva)=sobolevaiv@gmail.com
 Nuno Sobreira=nsobreira@iseg.ulisboa.pt
 Rogerio Sobreira=rogerio_sobreira@uol.com.br
 Maurizio Sobrero=maurizio.sobrero@unibo.it
 Tiberiu Socaciu=tibisocaciu@gmail.com
 Claudio Socci=socci_claudio@unimc.it
 Mieczysław Wacław Socha=socha@wne.uw.edu.pl
 Anna Soci=anna.soci@unibo.it
 Aura Gabriela Socol=auragabrielasocol@yahoo.com
 Johan Söderberg=johan.soderberg@ne.su.se
 Magnus Söderberg=magnus.soderberg@mines-paristech.fr
 Anson Soderbery=asoderbe@purdue.edu
 Mans M. Soderbom=mans.soderbom@economics.gu.se
 Patrik Söderholm=patrik.soderholm@ltu.se
 Paul Söderlind=paul.soderlind@unisg.ch
 Ulrica Söderlind=ulrica.soderlind@ekohist.su.se
 Jan Edvin Södersten=jan.sodersten@nek.uu.se
 Lars Söderström=lars.soderstrom@nek.lu.se
 Ulf Söderström=ulf.soderstrom@riksbank.se
 Mauro Sodini=m.sodini@ec.unipi.it
 Epiphane Sodjinou=sodjinoue@gmail.com
 Koffi SODOKIN=ksodokin@tg.refer.org
 Brian P. Soebbing=bsoebb1@lsu.edu
 Christian Soegaard=c.soegaard@warwick.ac.uk
 Adriaan Soetevent=a.r.soetevent@rug.nl
 Catherine Sofer=catherine.sofer@univ-paris1.fr
 Wolfgang Sofka=ws.smg@cbs.dk
 Ofelia Cristina Sofran=ofe09@rdslink.ro
 Hizir Sofyan=hizir@hizir.net
 Jakob Egholt Søgaard=jes@econ.ku.dk
 Vasilios Sogiakas=vasilios.sogiakas@glasgow.ac.uk
 Nils C. SOGUEL=nils.soguel@unil.ch
 Kazi Sohag=sohagkaziewu@gmail.com
 Thomas Pave Sohnesen=thomas@sohnesen.dk
 Niloufer Sohrabji=sohrabji@simmons.edu
 Elvira Sojli=esojli@rsm.nl
 Aaron J. Sojourner=asojourn@umn.edu
 Alexandre Sokic=alexandre.sokic@esce.fr
 Anna Sokolova=avsokolova@hse.ru
 Anna Valerievna Sokolova=asokolova@hse.ru
 Ekaterina V. Sokolova=sokolova@gsom.pu.ru
 Ilya Sokolov=sokolov@iep.ru
 Olena Sokolovska=elena.lukyanenko@gmail.com
 Yuri I. Sokolov=yuri.iv.sokolov@gmail.com
 Marcin Sokolowski, Jr.=m-sokolowski@wp.pl
 Senay Sokullu=senay.sokullu@bristol.ac.uk
 Martin Sola=msola@utdt.edu
 Eilon Solan=eilons@post.tau.ac.il
 Angel Solano-Garcia=asolano@ugr.es
 Sergio Sola=sergio.sola@graduateinstitute.ch
 Anne SOLAZ=solaz@ined.fr
 Martin Solberger=martin.solberger@statistics.uu.se
 Juan Carlos Soldano Deheza=jsoldano@apis.com.br
 Gerasimos T. Soldatos=soldgera@yahoo.com
 Victoria Soldevila=mariavictoria.soldevila@urv.cat
 Aida Solé Auró=aidasole@ub.edu
 Leh-chyan So=lcso@mx.nthu.edu.tw
 Majid Soleimani-damaneh=soleimani@khayam.ut.ac.ir
 Albert Solé-Ollé=asole@ub.edu
 Ibrahim Soliman=ibsoliman@hotmail.com
 Andres Solimano=asolimano@gmail.com
 Mario Soliño=solino.mario@inia.es
 Alex Solis=alex.solis@nek.uu.se
 Daniel Solis=daniel.solis@famu.edu
 Maria Solitander=maria.solitander@hankensse.fi
 Nikodemus Solitander=nikodemus.solitander@hanken.fi
 Olga Solleder=olga.solleder@graduateinstitute.ch
 René Söllner=rene.soellner@destatis.de
 Fátima Sol Murta=fasol@fe.uc.pt
 Isidro Soloaga=isidro.soloaga@ibero.mx
 Vasily Solodkov=vsolodkov@hse.ru
 Denisa Maria Sologon=denisa.sologon@ceps.lu
 Bernard Daniel Solomon=bernardsolomon79@gmail.com
 Daniela Cristina Solomon=solomon_daniela@yahoo.com
 Sorin Solomon=co3giacs@gmail.com
 Dionysios K. Solomos=solomario2004@hotmail.com
 Solomos Solomou=ss19@econ.cam.ac.uk
 Orville Jose C. Solon=jose_orville.solon@up.edu.ph
 Benjamin L. Solow=ben.solow@gmail.com
 Vincent Soltes=vincent.soltes@tuke.sk
 Rohini Somanathan=rohini@econdse.org
 Ashok Som=ashoksom@yahoo.com
 Craig Tsuriel Somerville=tsur.somerville@sauder.ubc.ca
 Alessandro Sommacal=alessandro.sommacal@univr.it
 Frank Somogyi=frank.somogyi@bundesbank.de
 Robert Somogyi=robert.somogyi@gmail.com
 Agapi L. Somwaru=agapi.somwaru@gmail.com
 Jens Sondergaard=jens.sondergaard@nomura.com
 Kim Mannemar Sønderskov=ks@ps.au.dk
 E. Young Song=eysong@sogang.ac.kr
 Haiyan Song=hmsong@polyu.edu.hk
 Inho Song=inhosong@gmail.com
 Jae Song=jae.song@ssa.gov
 Joanne Song=jihs@uci.edu
 Lei Lei Song=lsong@adb.org
 Minjae Song=msong@post.harvard.edu
 Shunfeng Song=song@unr.edu
 Xiumei Song=xiumei.song@gmail.com
 Xueda Song=xsong@yorku.ca
 Xuetao Song=xsong5@ncsu.edu
 Yang Song=ys337@cornell.edu
 Yong Song=ysong1@gmail.com
 Zheng Michael Song=zsong@fudan.edu.cn
 Konstantin Sonin=ksonin@nes.ru
 Alper Sönmez=alpersonmez80@gmail.com
 Tayfun Sönmez=sonmezt@bc.edu
 Joep Sonnemans=joepsonnemans@gmail.com
 Jung Won Sonn=j.sonn@ucl.ac.uk
 Tetsushi Sonobe=sonobete@grips.ac.jp
 Jon Sonstelie=jon@econ.ucsb.edu
 Alessandro Sontuoso=sontuoso@sas.upenn.edu
 Neeraj Sood=nsood@healthpolicy.usc.edu
 Puneet Sood=puneetsood.phd@gmail.com
 Abdol Soofi=soofi@uwplatt.edu
 Kwok Tong Soo=k.soo@lancaster.ac.uk
 Siew-Voon Soon=sv_soon2001@yahoo.com
 Rajeev Sooreea=rajeev.sooreea@dominican.edu
 Petar Sopek=psopek@gmail.com
 Barry Sopher=sopher@econ.rutgers.edu
 Thepthida Sopraseuth=thepthida.sopraseuth@u-cergy.fr
 Luminita Soproni=lumivoicu@yahoo.com
 Kimmo Soramäki=kimmo@soramaki.net
 Annamaria Sorato=amsorato@unive.it
 Serena Sordi=serena.sordi@unisi.it
 Claudio Soregaroli=claudio.soregaroli@unicatt.it
 Tina Søreide=tina.soreide@gmail.com
 Gilad Sorek=gms0014@auburn.edu
 Allan Sørensen=allans@asb.dk
 Anders Sørensen=as.eco@cbs.dk
 Erik Ø. Sørensen=erik.sorensen@nhh.no
 Kenneth Lykke Sørensen=kely@kora.dk
 Michael Sørensen=michael@math.ku.dk
 Peter Norman Sørensen=peter.sorensen@econ.ku.dk
 Soren Tang Sorensen=soren.sorensen@nera.com
 Steffen Sorensen=steffen.sorensen@citi.com
 Todd A. Sorensen=todd.sorensen@ucr.edu
 Susanne Soretz=soretz@uni-greifswald.de
 Lars Sørgard=lars.sorgard@nhh.no
 Marco Maria Sorge=marco.m.sorge@gmail.com
 Gerhard Sorger=gerhard.sorger@univie.ac.at
 Zakaria Sorgho=zakaria.sorgho@gmail.com
 Fabián Eduardo Soria Merino=loro_soria@hotmail.com
 Petar Sorić=psoric@efzg.hr
 Laerte Sorini=laerte.sorini@uniurb.it
 Sylvain Sorin=sylvain.sorin@imj-prg.fr
 Constantine Sergeevich Sorokin=csorokin@hse.ru
 Jorge Eduardo de Castro Soromenho=jecs@usp.br
 Maddalena Sorrentino=maddalena.sorrentino@unimi.it
 Pilar Sorribas-Navarro=psorribas@ub.edu
 M. Teresa Sorrosal Forradellas=mariateresa.sorrosal@urv.cat
 Maximiliano Sosa Andrés=maximiliano.sosa@towerswatson.com
 Walter Sosa Escudero=wsosa@udesa.edu.ar
 Ramiro Sosa Navarro=ramiro.sosanavarro@univ-evry.fr
 Cesar Sosa Padilla=cesarsp@mcmaster.ca
 Kim Sosin=ksosin@unomaha.edu
 Anna Sosnovskaya=german.amaranis@gmail.com
 Kirill Sossounov=ksosunov@nes.ru
 Simon Sosvilla-Rivero=sosvilla@ccee.ucm.es
 Renata Sotirov=r.sotirov@uvt.nl
 Sergey Sotnikov=ssot@hotmail.com
 Ariel Soto, Sr.=arsoto@udec.cl
 Claudio Soto=csotog@bcentral.cl
 Gloria M. Soto=gsoto@um.es
 Mauricio Soto=msoto@imf.org
 Raimundo Soto=raimundo.soto@gmail.com
 Victoria Eugenia Soto=victoriae.soto@gmail.com
 Tommi Sottinen=tommi.sottinen@gmail.com
 Claudio Sottoriva=claudio.sottoriva@unicatt.it
 Saïd Souam=souam@ensae.fr
 Antoine Soubeyran=antoine.soubeyran@univ-amu.fr
 Raphaël Soubeyran=soubeyra@supagro.inra.fr
 Michael Soucek=soucek@europa-uni.de
 Jan Soudek=honza.soudek@gmail.com
 Elias Soukiazis=elias@fe.uc.pt
 Nicolas Soulié=nicolas.soulie@u-psud.fr
 Ioannis Souliotis=souliotis.io@gmail.com
 Laura Sour=laura.sour@anahuac.mx
 Filipe J. Sousa=fjmsousa@uma.pt
 João Sousa=joao.sousa@ecb.int
 Lucia Paiva Martins Sousa=lsousa@mat.estv.ipv.pt
 Pedro Sousa=pasousa@direito.up.pt
 Alfonso Sousa-Poza=alfonso.sousa-poza@uni-hohenheim.de
 Ricardo Jorge Magalhães de Abreu Santos Sousa=rjsousa@eeg.uminho.pt
 Rita Martins de Sousa=martins@iseg.utl.pt
 Clive Southey=csouthey@uoguelph.ca
 André Portela Souza=andre.portela.souza@fgv.br
 Carla Souza=carla.aguilar@fjp.mg.gov.br
 José Ronaldo de Castro Souza, Jr.=ronaldo.souza@ipea.gov.br
 Nelson Souza-Sobrinho=nelson.souza@bcb.gov.br
 Robert Aurelian Sova=robertsova@yahoo.com
 Nii Kwaku Sowa=niisowa@gmail.com
 Fallaw Sowell=fs0v@andrew.cmu.edu
 Mousse Ndoye SOW=papamousse@yahoo.fr
 Baris Soybilgen=baris.soybilgen@bahcesehir.edu.tr
 Ugurlu Soylu=soylu@kuveytturk.de
 Mehmet Ali Soytas=mehmet.soytas@ozyegin.edu.tr
 Ugur Soytas=soytas@metu.edu.tr
 Amedeo Spadaro=amedeo.spadaro@uib.es
 Michael Spagat=m.spagat@rhul.ac.uk
 Heinz-Peter Spahn=peter.spahn@uni-hohenheim.de
 Paul Bernd Spahn=pbspahn@mac.com
 Jiří Špalek=spalek@econ.muni.cz
 Marina-Eliza Spaliara=marina.spaliara@glasgow.ac.uk
 Stefano Spalletti=spalletti@unimc.it
 Marco Spallone=mspallone@luiss.it
 Federico Spandonaro=federico.spandonaro@uniroma2.it
 Morten Spange=mortenspange@hotmail.com
 Francesco Spano=francesco.spano@unimi.it
 Aris Spanos=aris@vt.edu
 Loukas Spanos=loukas.spanos@gmail.com
 Chad Sparber=csparber@colgate.edu
 Fabrizio Spargoli=fabrizio.spargoli@upf.edu
 Gordon Sparks=sparksg@econ.queensu.ca
 Robert Sparrow=mail@robertsparrow.net
 Nikola Spatafora=nspatafora@gmail.com
 Luca Spataro=l.spataro@ec.unipi.it
 Charalambos Spathis=hspathis@econ.auth.gr
 Julius Spatz=julius.spatz@gtz.de
 Nicholas Spaull=nicholasspaull@gmail.com
 Filippo Spazzini=filippo.spazzini@edison.it
 Stephen Spear=ss1f@andrew.cmu.edu
 Stefan Soenke Speckesser=stefan.speckesser@employment-studies.co.uk
 Lee C. Spector=00lcspector@bsu.edu
 Ann O'Ryan Spehar=aospehar@uas.alaska.edu
 Barbara Spencer=barbara.spencer@sauder.ubc.ca
 Christopher Spencer=c.g.spencer@lboro.ac.uk
 Michael A. Spencer=michael.spencer@mnsu.edu
 Peter Damian Spencer=ps35@york.ac.uk
 JC Spender=jcspender@yahoo.com
 Hannes Spengler=hsp@gmx.org
 Jörg L. Spenkuch=j-spenkuch@kellogg.northwestern.edu
 Stefan Sperlich=stefan.sperlich@unige.ch
 Lena Lindbjerg Sperling=lenalindbjergsperling@gmail.com
 Alexander Spermann=spermann@iza.org
 Joanne Spetz=joanne.spetz@ucsf.edu
 Eli Spiegelman=spiegele@vaniercollege.qc.ca
 Mark M Spiegel=mark.spiegel@sf.frb.org
 Peter Spiegler=peter.spiegler@umb.edu
 Ran Spiegler=r.spiegler@ucl.ac.uk
 David J. Spielman=d.spielman@cgiar.org
 Christian Spielmann=c.spielmann@ucl.ac.uk
 Philip Spies=phspies@iafrica.com
 Katharina Christa Spiess=kspiess@diw.de
 Seymour Spilerman=ss50@columbia.edu
 Antonio Spilimbergo=aspilimbergo@imf.org
 Aristotelis Spiliotis=aspiliotis@bankofgreece.gr
 Jörg Spiller=spiller@europa-uni.de
 Luca Spinesi=luca.spinesi@uniroma3.it
 Lawrence M. Spizman=larry.spizman@oswego.edu
 Mark Spoerer=mark.spoerer@ur.de
 Enrico Spolaore=enrico.spolaore@tufts.edu
 Kenneth Spong=ken.r.spong@kc.frb.org
 Thomas L. Sporleder=sporleder.1@osu.edu
 Michael Sposi=msposi1981@gmail.com
 John Michael Spraggon=jmspragg@resecon.umass.edu
 Aldo Spranzi=aldo.spranzi@tiscali.it
 Reinhard Spree=rus.spree@t-online.de
 Maresa Sprietsma=sprietsma@zew.de
 Matthew G. Springer=matthew.g.springer@vanderbilt.edu
 Jaap Spronk=jspronk@rsm.nl
 Robert A. Sproule=ra_sproule@shaw.ca
 Michael Sproul=msproul@usc.edu
 Rok Spruk=r.spruk@uu.nl
 Yves Sprumont=yves.sprumont@umontreal.ca
 John Arthur Spry=jaspry@stthomas.edu
 Cristi Spulbar=cristi_spulbar@yahoo.com
 Daniel F. Spulber=jems@kellogg.northwestern.edu
 Stephen Josiah Spurr=sspurr@wayne.edu
 Eleftherios Spyromitros=espyromi@ierd.duth.gr
 Mara Squicciarini=mara.squicciarini@econ.kuleuven.be
 Mariagrazia Squicciarini=mariagrazia.squicciarini@oecd.org
 Francesco Squintani=f.squintani@warwick.ac.uk
 David Alexandre Sraer=dsraer@princeton.edu
 Samir Srairi=srairisamir3@gmail.com
 Ranjan Sreedharan=ranjan.sreedharan@gmail.com
 Martin Srholec=martin.srholec@cerge-ei.cz
 M. Sarma SriGowri Sanker=srigowri.sanker@gmail.com
 Chittur Subramanian Srinivasan=c.s.srinivasan@reading.ac.uk
 Naveen Srinivasan=naveen@igidr.ac.in
 Sumati Srinivas=ssrinivas@radford.edu
 Pratompong Srinuan=pratompong.s@nbtc.go.th
 Mankal Sriram=mssriram@gmail.com
 Preety Pratima D. Srivastava (nee Ramful)=preety.ramful@buseco.monash.edu.au
 Thanes Sriwichailamphan=thanes@econ.cmu.ac.th
 Christian Staat=cstaat@ulb.ac.be
 Derek Stacey=dstacey@economics.ryerson.ca
 John Stachurski=john.stachurski@anu.edu.au
 Mitja Stadje=m.a.stadje@uvt.nl
 Karsten Staehr=karsten.staehr@ttu.ee
 Stefano Staffolani=s.staffolani@univpm.it
 Jesper Stage=jesper.stage@miun.se
 Jonas Staghøj=jst@nationalbanken.dk
 Carlo Stagnaro=carlo.stagnaro@brunoleoni.it
 Frank Stähler=frank.staehler@uni-tuebingen.de
 Nikolai Stähler=nikolai.staehler@bundesbank.de
 Harald Edgar Stahl=harald.stahl@bundesbank.de
 Sebastian Stahl=sstahl@uni-potsdam.de
 Gabriel Staicu=gabistaicu@yahoo.com
 Doug Staiger=douglas.staiger@dartmouth.edu
 Robert W. Staiger=rstaiger@wisc.edu
 Anthony Staines=anthony.staines@gmail.com
 Mark Staley=staleymark@hotmail.com
 Pierre St-Amant=pstamant@bankofcanada.ca
 Theodoros V. Stamatopoulos=stamth@otenet.gr
 Erik Stam=e.stam@uu.nl
 James Stamey=james_stamey@baylor.edu
 Pascal St-Amour=pascal.st-amour@unil.ch
 Marco Stampini=mstampini@iadb.org
 Luca Stanca=luca.stanca@unimib.it
 Elena Stancanelli=elena.stancanelli@univ-paris1.fr
 Anderson Eduardo Stanciole=aes118@gmail.com
 Stanciu Oana Alexandrina=oanaalexa@yahoo.com
 Ofelia Cristina Stanciu=ofelia.stanciu@gmail.com
 Alin Stancu=alinstancu@mk.ase.ro
 Andrei Stanculescu=stanculescuandrei@yahoo.com
 Gabriele Standardi=gabriele.standardi@feem.it
 Lardo Stander=lardo.stander@up.ac.za
 Piotr Leszek Stanek=stanekp@uek.krakow.pl
 Jon Desmond Stanford=jonstan2@bigpond.net.au
 Anna Stangl=stangl@ifo.de
 Cristian Nicolae Stanica=stanica_cris@yahoo.com
 Nenad Stanišić=nstanisic@kg.ac.rs
 Dariusz Stańko=dariusz.stanko@gmail.com
 Petar Stankov=pstankov@cerge-ei.cz
 Denise Stanley=dstanley@fullerton.edu
 T. D. Stanley=stanley@hendrix.edu
 Angela A. Stanton=angela@angelastanton.com
 Charlotte Y. Stanton=stantonc@stanford.edu
 David Ian Stanton=david.stanton@anu.edu.au
 Tom Stargardt=tom.stargardt@wiso.uni-hamburg.de
 Catalin Starica=catalin.starica@unine.ch
 Chris Starmer=chris.starmer@nottingham.ac.uk
 Carine Staropoli=carine.staropoli@univ-paris1.fr
 Marta Starostka-Patyk=marta_sp@zim.pcz.pl
 Martha Starr=mstarr@american.edu
 Richard Startz=startz@econ.ucsb.edu
 Halina Starzyczna=starzyczna@opf.slu.cz
 Antonio Stasi=a.stasi@unifg.it
 Lenka Stastna (Gregorova)=stastna@fsv.cuni.cz
 Piotr Wojciech Staszkiewicz=piotr.staszkiewicz@mail.com
 Amanda Stathopoulos=amanda.stathopoulos@epfl.ch
 Vania Statzu=vania.statzu@crenos.unica.it
 Kevin E. Staub=kevin.staub@unimelb.edu.au
 Roberta Blass Staub=roberta.blass@bcb.gov.br
 Matthias Staudigel=matthias.staudigel@agrar.uni-giessen.de
 Alexander Staus=astaus@uni-hohenheim.de
 Daniel Stavarek=stavarek@opf.slu.cz
 Alexandra Stavinskaya=astavinskaya@arett.ru
 Jana Stávková=stavkova@mendelu.cz
 Vania Stavrakeva=vania.stavrakeva@gmail.com
 Athanassios Stavrakoudis=astavrak@cc.uoi.gr
 Emil S Stavrev=estavrev@imf.org
 Eleni Stavridou=stavridoueleni@yahoo.gr
 Olena Stavrunova=olena.stavrunova@uts.edu.au
 Jeffrey W. Steagall=jeffsteagall@weber.edu
 Sally Clark Stearns=sally_stearns@unc.edu
 Jack Douglas Stecher=jstecher@cmu.edu
 Mark Steel=m.f.steel@stats.warwick.ac.uk
 Thomas Steenburgh=steenburght@darden.virginia.edu
 Christodoulos Stefanadis=cstefana@unipi.gr
 Camelia Stefanescu=stefanescucamelia@ymail.com
 Laura Ştefănescu=laurastef73@yahoo.com
 Mihaela Stefanescu=mihaella.stefanescu@gmail.com
 Razvan Stefanescu=rzvn_stefanescu@yahoo.com
 Luciano Stefanini=lucste@uniurb.it
 Ionela Georgiana Stefan=stgeorgiana@yahoo.com
 Ulrike Stefani=ulrike.stefani@uni-konstanz.de
 Spiro Stefanou=ttc@psu.edu
 Radosław Stefański=radek.stefanski@ecn.ulaval.ca
 Sascha Steffen=sascha.steffen@esmt.org
 Klaus Stegemann=stegemak@econ.queensu.ca
 Thomas Michael Steger=steger@wifa.uni-leipzig.de
 Jan-Henrik Steg=jsteg@uni-bielefeld.de
 Mojgan Stegl=mojgan.stegl@googlemail.com
 Alison Stegman=alison.irvine@live.com.au
 Tim Stegmann=tim.stegmann@uni-due.de
 Milan Stehlik=milan.stehlik@jku.at
 Sven Jari Stehn=jari.stehn@gs.com
 Thomas J Steichen=tjs.bbmail@gmail.com
 Eva-Maria Steiger=steiger@econ.lmu.de
 Heidi Steiger=heidi.steiger@gmail.com
 Matjaz Steinbacher=matjaz.steinbacher@gmail.com
 Mitja Steinbacher=mitja.steinbacher@gmail.com
 Federico Steinberg=federico.steinberg@uam.es
 Joseph Bowlin Steinberg=joseph.steinberg@utoronto.ca
 Richard Steven Steinberg=rsteinbe@iupui.edu
 Andreas Steiner=asteiner@uni-osnabrueck.de
 Bodo E. Steiner=bsteiner@sam.sdu.dk
 Jakub Steiner=jakub.steiner@cerge-ei.cz
 Ernesto Stein=ernestos@iadb.org
 Susan Steiner=ssteiner@diw.de
 Mariano Steinert=marianosteinert@gmail.com
 Walter Steingress=walter.steingress@umontreal.ca
 Max Friedrich Steinhardt=steinhardt@hsu-hh.de
 Andreas Steinhauer=andreas.steinhauer@econ.uzh.ch
 Ralf Steinhauser=ralf.steinhauser@wiso.uni-hamburg.de
 Karl W. Steininger=karl.steininger@uni-graz.at
 Martin Steininger=steininger@bulwiengesa.de
 Ingrid Stein=ingrid.stein@bundesbank.de
 Jeremy Stein=jeremy_stein@harvard.edu
 Sven Steinkamp=sven.steinkamp@uni-osnabrueck.de
 Luke Comins Donohoe Stein=luke.stein@asu.edu
 Andreas Steinmayr=asteinmayr@uchicago.edu
 W Edward Steinmueller=w.e.steinmueller@sussex.ac.uk
 William Henry Steinwascher=william.henry@udlap.mx
 Ladislav Stejskal=ladislav.stejskal@mendelu.cz
 Herman O. Stekler=hstekler@gwu.edu
 Andrea Stella=andrea.stella@frb.gov
 Fabio Stella=stella@disco.unimib.it
 Bart Stemmet=bartstemmet@gmail.com
 Anders Stenberg=anders.stenberg@sofi.su.se
 Alexis Stenfors=as129@soas.ac.uk
 Anne STENGER=stenger@nancy-engref.inra.fr
 Thanasis Stengos=tstengos@uoguelph.ca
 Mikael Stenkula=mikael.stenkula@ifn.se
 Johan Stennek=johan.stennek@economics.gu.se
 Lars Stentoft=lars.stentoft@uwo.ca
 Josip Stepanic=josip.j.stepanic@fsb.hr
 Ignat Stepanok=ignat.stepanok@ifw-kiel.de
 Anastasia N. Stepanova=anstepanova@hse.ru
 Sergey Stepanov=sstepanov@hse.ru
 Andreas Stephan=andreas.stephan@jibs.hj.se
 Johannes Florian Stephan=johannes.stephan@web.de
 Constantinos Stephanou=costas.stephanou@bis.org
 Sabine Stephan=sabine-stephan@boeckler.de
 Andrew T. Stephen=andrew@andrewstephen.net
 Eric L G Stephens=eric.stephens@carleton.ca
 Michael Stepner=stepner@mit.edu
 Olivier Sterck=olivier.sterck@economics.ox.ac.uk
 Henri Sterdyniak=sterdyniak@sciences-po.fr
 Elmer Sterken=e.sterken@rug.nl
 Alessandro Sterlacchini=a.sterlacchini@univpm.it
 David I. Stern=sterndavidi@yahoo.com
 Gabriel Sterne=gabriel.sterne@exotix.co.uk
 Jon Stern=jon.stern.1@city.ac.uk
 Michael L. Stern=sternml@auburn.edu
 Robert M. Stern=rmstern@umich.edu
 Steven Stern=sns5r@virginia.edu
 Valerio Sterzi=valerio.sterzi@unibocconi.it
 Ivan Stetsyuk=ivan@temple.edu
 Bernard Steunenberg=b.steunenberg@cdh.leidenuniv.nl
 Dalibor Stevanovic=dstevanovic.econ@gmail.com
 Lonnie Kent Stevans=acslks@hofstra.edu
 John Stevens=john.j.stevens@frb.gov
 Katrien Stevens=katrien.stevens@sydney.edu.au
 Margaret Stevens=margaret.stevens@economics.ox.ac.uk
 Betsey Stevenson=betseys@umich.edu
 Franklin Steves=stevesf@ebrd.com
 Chris Stewart=c.stewart@kingston.ac.uk
 Colin Stewart=colin.stewart@utoronto.ca
 Hayden Stewart=hstewart@ers.usda.gov
 Jennifer M. Stewart=jennifer_stewart@carleton.ca
 Kenneth George Stewart=kstewart@uvic.ca
 Mark Stewart=mark.stewart@warwick.ac.uk
 Iryna Stewen=iryna.stewen@uni-mainz.de
 Joel Stiebale=joel.stiebale@nottingham.ac.uk
 Harald W. Stieber=harald.stieber@ec.europa.eu
 Pascal Christian Stiefenhofer=ps515@york.ac.uk
 Kyle W. Stiegert=kwstiegert@gmail.com
 Nils Stieglitz=nst@sam.sdu.dk
 Michael Stierle=stierle2001@yahoo.de
 Ulrike Stierle-von Schuetz=ulrike.stierle-von-schutz@ec.europa.eu
 David Stifel=stifeld@lafayette.edu
 Alfred M. Stiglbauer=alfred.stiglbauer@oenb.at
 Denis Stijepic=denis.stijepic@fernuni-hagen.de
 Jean-Philippe Stijns=jstijns@imf.org
 Richard Perry Stillman=stillman@ers.usda.gov
 Steven Stillman=steven.stillman@otago.ac.nz
 Michael Stimmelmayr=stimmelmayr@kof.ethz.ch
 Maxwell Stinchcombe=max.stinchcombe@gmail.com
 Todd R. Stinebrickner=trstineb@uwo.ca
 Antonella Stirati=antonella.stirati@uniroma3.it
 Claudia Stirboeck=claudia.stirboeck@bundesbank.de
 Dan Stirbu=dan@ndconsulting.ro
 Kevin Stiroh=stiroh84@optonline.net
 Sarah See Stith=ssstith@umich.edu
 John Stiver=john.stiver.2@nd.edu
 Helmut Stix=helmut.stix@oenb.at
 Andrea Stocchetti=stocchetti@unive.it
 Engelbert Stockhammer=e.stockhammer@kingston.ac.uk
 David R. Stockman=stockman@udel.edu
 James P. Stodder=stoddj@rpi.edu
 Jana Stöver=stoever@hwwi.org
 Andreea Stoian=andreea.stoian@fin.ase.ro
 Eduard Alexandru Stoica=eduard.stoica@ulbsibiu.ro
 Ovidiu Stoica=ostoica@uaic.ro
 Evarist Stoja=e.stoja@bristol.ac.uk
 Nebojsa Stojcic=nstojcic@unidu.hr
 Houston H. Stokes=hhstokes@uic.edu
 Jeffrey R. Stokes=jeffrey.stokes@uni.edu
 Anthony Robert Stokes=t.stokes@mary.acu.edu.au
 Hildegunn Ekroll Stokke=hildegunnes@svt.ntnu.no
 A.C.J. Stokman=a.c.j.stokman@dnb.nl
 Mikhail Stolbov=stolbov_mi@mail.ru
 Lars A Stole=lars.stole@chicagobooth.edu
 Roman Stöllinger=stoellinger@wiiw.ac.at
 Hervé Stolowy=stolowy@hec.fr
 Michael Stolpe=michael.stolpe@ifw-kiel.de
 Christian A. Stoltenberg=c.a.stoltenberg@uva.nl
 Daniel F. Stone=dstone@bowdoin.edu
 Joe A. Stone=jstone@uoregon.edu
 Paul Leonard Stoneman=paul.stoneman@wbs.ac.uk
 Mark Richard Stone=mstone@imf.org
 Michael P. Stone=michael.p.stone@gmail.com
 Jan Stoop=stoop@ese.eur.nl
 Michael Stops=michael.stops@iab.de
 Maxim A. Storchevoy=storchevoy@gsom.pu.ru
 Karl Storchmann=karl.storchmann@nyu.edu
 Johanna Storck=jstorck@diw.de
 Paul Storer=paul.storer@wwu.edu
 Kjetil Storesletten=kjetil.storesletten@econ.uio.no
 Philip Alexander Stork=p.a.stork@vu.nl
 Virgil Henry Storr=vstorr@gmu.edu
 Daniela Storti=storti@inea.it
 Giuseppe Storti=storti@unisa.it
 John E. Stovall=j.stovall@warwick.ac.uk
 Till Stowasser=till.stowasser@econ.lmu.de
 John D. Stowe=stowej@ohio.edu
 Andrey Stoyanov=andreyst@yorku.ca
 Petia Stoytcheva=psstoytcheva@salisbury.edu
 Sebastiaan (Bas) Michael Straathof=s.m.straathof@cpb.nl
 Livio Stracca=livio.stracca@ecb.int
 Rodney Strachan=r.strachan@uq.edu.au
 Eduardo Strachman=eduardo.strachman@gmail.com
 Andreea Strambu-Dima=dimandreea@yahoo.com
 John Kevin Stranlund=stranlund@resecon.umass.edu
 Alexandru Stratan=alex_stratan@yahoo.com
 Francesco Strati=francesco.strati@unisi.it
 Thomas Stratmann=tstratma@gmu.edu
 Stephane Straub=stephane.straub@tse-fr.eu
 Tobias Straumann=tobias.straumann@econ.uzh.ch
 Odd Rune Straume=o.r.straume@eeg.uminho.pt
 Marc-Olivier Strauss-Kahn=mosk@banque-france.fr
 Robert Strauss=rpstrauss@gmail.com
 Roland Strausz=strauszr@wiwi.hu-berlin.de
 Nikos Stravelakis=stravelakis.n@gmail.com
 Michel Strawczynski=michel.strawczynski@mail.huji.ac.il
 Pawel Strawinski=pstrawinski@wne.uw.edu.pl
 Mark Strazicich=strazicichmc@appstate.edu
 Borut Strazisar=borut.strazisar@guest.arnes.si
 Jorge M. Streb=jms@cema.edu.ar
 Denis Strebkov=strebkov@hse.ru
 Ilya A. Strebulaev=istrebulaev@stanford.edu
 Nora Strecker=strecker@kof.ethz.ch
 Andrew David Street=andrew.street@york.ac.uk
 Ekaterina Streltsova=kstreltsova@hse.ru
 Stefan Stremersch=stremersch@ese.eur.nl
 Alexander Stremitzer=stremitzer@law.ucla.edu
 Hanno Stremmel=hanno.stremmel@whu.edu
 Peter Alfred Streufert=pstreuf@uwo.ca
 Ingvar A. Strid=ingvar.strid@riksbank.se
 Martin Strieborny=strieborny@gmail.com
 Leo Strijbosch=l.w.g.strijbosch@uvt.nl
 Birgit Strikholm=birgit.strikholm@gmail.com
 Marco Stringa=marco.stringa@db.com
 Edward Peter Stringham=edward.stringham@gmail.com
 Ludmila Striukova=l.striukova@ucl.ac.uk
 Thomas Strobel=strobel@ifo.de
 Eric Albert Strobl=eric.strobl@polytechnique.edu
 Per Stromberg=per.stromberg@sifr.org
 Winslow Strong=winslow.strong@gmail.com
 Harald Strotmann=harald.strotmann@hs-pforzheim.de
 Caleb Stroup=jamescalebstroup@gmail.com
 Chiara Strozzi=chiara.strozzi@unimore.it
 Carlo Strub=cs@carlostrub.ch
 Holger Strulik=holger.strulik@wiwi.uni-goettingen.de
 Bruno H. Strulovici=b-strulovici@northwestern.edu
 Erin C. Strumpf=erin.strumpf@mcgill.ca
 Piotr Stryszowski=piotr.stryszowski@oecd.org
 Tomasz Strzalecki=tomasz_strzalecki@harvard.edu
 Paweł Strzelecki=strzeleckip@gmail.com
 Harborne W. Stuart, Jr.=hstuart@stern.nyu.edu
 Heiko Stueber=heiko.stueber@iab.de
 Rodolfo Stucchi=rstucchi@iadb.org
 Andrej Stuchlik=andrej.stuchlik@bertelsmann-stiftung.de
 Rogerio Studart=rstudart@worldbank.org
 Roman Studer=roman.studer@gmail.com
 Eric T. Stuen=estuen@uidaho.edu
 Martin Stuermer=martin.stuermer@uni-bonn.de
 Jan Leonard Stuhler=j.stuhler@ucl.ac.uk
 Jason Sturgess=jds224@georgetown.edu
 Brad Sturgill=sturgilb@gvsu.edu
 Daniel M. Sturm=d.m.sturm@lse.ac.uk
 Jan-Egbert Sturm=sturm@kof.ethz.ch
 Richard Werner Sturn=richard.sturn@uni-graz.at
 Alois Stutzer=alois.stutzer@unibas.ch
 Michael Stützer=michael.stuetzer@tu-ilmenau.de
 Sandy Suardi=s.suardi@latrobe.edu.au
 Ancor Suárez-Alemán=asuarez@acciones.ulpgc.es
 José Suárez-Lledó=jose.suarez-lledo@moodys.com
 Javier Suarez Pandiello=jspandi@uniovi.es
 Patricia Suárez=suarezcpatricia@uniovi.es
 Susan Subak=subak@alum.mit.edu
 Muhammad Subandi=ms24454@yahoo.com
 Turan Subasat=turan.subasat@ieu.edu.tr
 Viktor Subbotin=viktor.subbotin@u.northwestern.edu
 Julie Subervie=subervie@supagro.inra.fr
 Muhammad Imtiaz Subhani=drsubhani@hotmail.com
 Biwei Su=sue925sky@gmail.com
 Begoña Subiza=subiza@ua.es
 Andrey Subochev=asubochev@hse.ru
 Sairavi Subramaniam=sairavi72@gmail.com
 Viswanatha Sankara Rama Subramaniam=drvsrs@drvsrs.com
 Krishnamurthy Venkata Subramanian=krishnamurthy_subramanian@isb.edu
 Jan Sucháček=jan.suchacek@vsb.cz
 Petr Suchánek=suchanek@opf.slu.cz
 Peter Sudhölter=psu@sam.sdu.dk
 Nao Sudo=nao.sudou@boj.or.jp
 Dongwei Su=tdsu@jnu.edu.cn
 Jens Suedekum=suedekum@dice.hhu.de
 EnDer Su, Sr.=suender@ccms.nkfust.edu.tw
 Richard M. H. Suen=richard.suen@uconn.edu
 Wing Suen=wsuen@econ.hku.hk
 Rodrigo Suescun=rsuescun@worldbank.org
 Fadzlan Sufian=fsufian@gmail.com
 Shamnaaz B. Sufrauj=shamnaaz.sufrauj@gmail.com
 Shinya Sugawara=sugawara@e.u-tokyo.ac.jp
 Hajime Sugeta=sugeta@kansai-u.ac.jp
 Catur Sugiyanto=catursugiyanto@yahoo.com
 Nicolas Suhadolnik=npsuhadolnik@yahoo.com.br
 Sangwon Suh=ssuh@cau.ac.kr
 Raphaël Suire=raphael.suire@univ-rennes1.fr
 Sui Sui=sui.sui.66@gmail.com
 Ritha Sukadi Mata=rsukadim@ulb.ac.be
 Irina Sukhareva=i.sukhareva@forecast.ru
 Donggyu Sul=d.sul@utdallas.edu
 Abrar Suleiman=a.suleiman@sheffield.ac.uk
 Ryan Suleimann Lemand=leryan@gmail.com
 Elchin Suleymanov=elsuleymanov@qu.edu.az
 Malgorzata Sulimierska=ms70@sussex.ac.uk
 Giovanni Sulis=gsulis@unica.it
 James Xavier Sullivan=sullivan.197@nd.edu
 Michael Sullivan=michael.sullivan@occ.treas.gov
 Richard J. Sullivan=rick.j.sullivan@kc.frb.org
 Ryan Scott Sullivan=rssulliv@nps.edu
 Timothy Sean Sullivan=tsulliv@siue.edu
 Vladimir Sulov=vsulov@dir.bg
 Pascal Andrea Sulser=pascal.sulser@uni-konstanz.de
 Astrit Sulstarova=astrit.sulstarova@gmail.com
 Muyed Sultan=adiibtiger@yahoo.com
 Ussif Rashid Sumaila=r.sumaila@fisheries.ubc.ca
 Sudarno Sumarto=ssumarto@smeru.or.id
 Kutluk Kagan Sumer=kutluk@istanbul.edu.tr
 Kazuto Sumita=sumita@toyo.jp
 Katarzyna Sum=ksum@sgh.waw.pl
 William Roderick Summerhill, III=summerhill@ucla.edu
 Martin Summer=martin.summer@oenb.at
 Peter Summers=psummers@highpoint.edu
 Marijana Sumpor=msumpor@eizg.hr
 Takeki Sunakawa=takeki.sunakawa@gmail.com
 Bo Sun=bo.sun@gsm.pku.edu.cn
 Chia-Hung Sun=ecdchs@ccu.edu.tw
 Cong Sun 孙聪 (Cong Sun)=suncong05@gmail.com
 Asha Sundaram=assundar.wk@gmail.com
 Krishnamurthy Sundaram=sundaram@econdse.org
 Arun Sundararajan=asundara@stern.nyu.edu
 Shyam Sunder=shyam.sunder@yale.edu
 Uwe Sunde=uwe.sunde@lmu.de
 Marianne Sundström=masu@sofi.su.se
 Enes Sunel=enes.sunel@tcmb.gov.tr
 Eric Sun=ericsun@uchicago.edu
 Gang Sun=gs56@st-andrews.ac.uk
 Taeyoon Sung=tsung@yonsei.ac.kr
 Guang-Zhen Sun=gzsun@umac.mo
 Nesrin Sungur=nsungur@yahoo.com
 Hongfei Sun=hfsun@econ.queensu.ca
 孙佳婧 (Jiajing Sun)=jiajing.sun@gmail.com
 Kai Sun=ksun1@binghamton.edu
 孙立新 (SUN, Lixin)=sunlixin@gsm.pku.edu.cn
 Claudia Sunna=claudia.sunna@unisalento.it
 Puyang Sun=puyangsun@nankai.edu.cn
 Qi Sun=sun.qi@mail.shufe.edu.cn
 孙伟 (Wei Sun)=wsecon@gmail.com
 Yeneng Sun=matsuny@nus.edu.sg
 Yifei Sun=laabc00@gmail.com
 Yiguo Sun=yisun@uoguelph.ca
 Yixiao Sun=yisun@ucsd.edu
 Chonawee Supatgiat=chonawee@yahoo.com
 Nicolai Suppa=nicolai.suppa@tu-dortmund.de
 Moritz Suppliet=moritz.suppliet@dice.hhu.de
 Steven M. Suranovic=smsuran@gwu.edu
 Paolo Surico=psurico@london.edu
 Jordi Suriñach=jsurinach@ub.edu
 Juan Carlos Surís-Regueiro=jsuris@uvigo.es
 Komsan Suriya=suriyakomsan@yahoo.co.th
 Alexander Surkov=alexander.surkov@gmail.com
 Rendra Suroso=rs@cogsci.bandungfe.net
 Jay Surti=jsurti@imf.org
 Oktay Sürücü=oktay.surucu@uni-bielefeld.de
 Gheorghe Surugiu=gheorghe.surugiu@cmu-edu.eu
 Marius-Razvan Surugiu=mariussurugiu@yahoo.com
 Megananda Suryana=megakasep@yahoo.com
 Yohanes Surya=yohanes2surya@yahoo.com
 Dr. Armi Susandi, MT=armisusandi@yahoo.com
 Irina Olimpia Susanu=irinasusanu@gmail.com
 Monica Susanu=susanu_mnc@yahoo.com
 Vladyslav Y. Sushko=vlad.sushko@bis.org
 Anton B. Suslov=asuslov@hse.ru
 Nikita Ivanovich Suslov=nsus@academ.org
 Bora Süslü=sbora@mu.edu.tr
 Nathan Sussman=msussman@mscc.huji.ac.il
 Roman Sustek=sustek19@gmail.com
 Martin Suster=martin.suster@nbs.sk
 Charles Sutcliffe=c.m.s.sutcliffe@rdg.ac.uk
 Jordan F. Suter=jordan.suter@colostate.edu
 Rahel Suter=rahel.suter@econ.uzh.ch
 Mita H. Suthar=mitasuthar@yahoo.com
 Alan Sutherland=ajs10@st-and.ac.uk
 Douglas Sutherland=douglas.sutherland@oecd.org
 Matthias Sutter=matthias.sutter@uibk.ac.at
 Andrew J. Sutton=ajs510@york.ac.uk
 Farrukh Suvankulov=fsuvankulov@aya.yale.edu
 Sithanonxay Suvannaphakdy=oud_sdy@yahoo.com
 Xuejuan Su=xuejuan1@ualberta.ca
 Xunhua Su=xunhua.su@svt.ntnu.no
 Suyanto=suyanto@ubaya.ac.id
 Wim Suyker=w.b.c.suyker@cpb.nl
 Yongyang Su=ysu@suffolk.edu
 Yu-Tien Su=ytsu@yahoo.com
 Agne Suziedelyte=agne.suziedelyte@monash.edu
 Wilson Suzigan=wsuzigan@ige.unicamp.br
 Katsuhiko Suzuki=suzukick@jttk.zaq.ne.jp
 Kenji Suzuki=kenjisuz@meiji.ac.jp
 Michio Suzuki=msuzuki@e.u-tokyo.ac.jp
 Shiba Suzuki=shiba.suzuki@meisei-u.ac.jp
 Tomo Suzuki=tomo.suzuki@sbs.ox.ac.uk
 Toru Suzuki=toru.suzuki@uts.edu.au
 Yasushi Suzuki=szkya@apu.ac.jp
 Yasutoyo Suzuki=syasutoyosaka@yahoo.co.jp
 Kotaro Suzumura=k.suzumura@waseda.jp
 Helena Svaleryd=helena.svaleryd@nek.uu.se
 Natálie Švarcová=svarcova@fsv.cuni.cz
 Michael Svarer=michael@svarer.dk
 Justin Svec=jsvec@holycross.edu
 Dick Svedin=dick.svedin@miun.se
 Tommy Sveen=tommy.sveen@bi.no
 Jan Svejnar=svejnar@umich.edu
 Gert Tinggaard Svendsen=gts@ps.au.dk
 Lars E.O. Svensson=lars.svensson@iies.su.se
 Lars-Gunnar Svensson=lars-gunnar.svensson@nek.lu.se
 Mikael Svensson=mikael.svensson@kau.se
 Richard Svensson=richard.svensson@gu.se
 Roger Svensson=roger.svensson@ifn.se
 Sergey Sveshnikov=sveshnikovsv@yandex.ru
 Светлана Георгиевна Кирдина (Kirdina Svetlana)=kirdina@bk.ru
 Nikolai Svetlov=svetlov@timacad.ru
 Sergey Gennadievech Svetunkov, Sr.=sergey@svetunkov.ru
 Kateryna T. Svieshnikova=catherinesvesh@mail.ru
 Patrik Svoboda=ucpatrik@mendelu.cz
 Shirley Svorny=shirley.svorny@csun.edu
 Joanna K. Swaffield=jo.swaffield@york.ac.uk
 Mamata Swain=mama_swain@hotmail.com
 Joffre Swait=joffre.swait.jr@gmail.com
 John Kim Swales=j.k.swales@strath.ac.uk
 Brent Murray Swallow=brent.swallow@ales.ualberta.ca
 Stephen Koch Swallow=stephen.swallow@uconn.edu
 Otto Swank=swank@few.eur.nl
 Eric T. Swanson=eric.swanson@sf.frb.org
 Joseph A. Swanson=joes@kellogg.northwestern.edu
 Norman R. Swanson=nswanson@econ.rutgers.edu
 Timothy Swanson=tim.swanson@graduateinstitute.ch
 Trevor Swan=peter.swan@unsw.edu.au
 J. Todd Swarthout=swarthout@gsu.edu
 Julia Swart=j.swart@uu.nl
 Eik Leong Swee=eswee@unimelb.edu.au
 Arthur Sweetman=arthur.sweetman@mcmaster.ca
 Deborah L. Swenson=dswenson@ucdavis.edu
 Detlef Swieter=d.swieter@freenet.de
 Gregory P. Swinand=gswinand@londecon.co.uk
 Alan Swinbank=a.swinbank@reading.ac.uk
 Jeroen Swinkels=j-swinkels@kellogg.northwestern.edu
 Laurens A. P. Swinkels=laurens.swinkels@planet.nl
 Johan Swinnen=jo.swinnen@econ.kuleuven.be
 Kenneth Swinnerton=swinnerton.kenneth@dol.gov
 Zbigniew Switalski=z.switalski@wmie.uz.zgora.pl
 Kindy Rinaldy Syahrir=ksyahrir@gmail.com
 Amadou N. R. Sy=asy@imf.org
 Ekki Syamsulhakim=ekki.syamsulhakim@fe.unpad.ac.id
 Ewa Marta Syczewska=ewams@sgh.waw.pl
 Abdul Majid Syed=samajid89@yahoo.com
 Syed Omar Syed Agil=syedomar@unirazak.edu.my
 Iqbal A. Syed=i.syed@unsw.edu.au
 Manolis Syllignakis=msyllign@aueb.gr
 Mauro Sylos Labini=syloslabini@gmail.com
 Serginio Sylvain=serginio@uchicago.edu
 Spyridon D. Symeonides=ssymeoni@cc.uoi.gr
 George Symeonidis=symeonid@essex.ac.uk
 Lazaros Symeonidis=lazaros.symeonidis@stir.ac.uk
 Mouhamadou Sy=sy@pse.ens.fr
 George Syrichas=georgesyrichas@centralbank.gov.cy
 Jacek Syska=jacek@server.phys.us.edu.pl
 Georgiy Syunyaev=gsyunyaev@hse.ru
 Gábor G. Szabó=szabogg@econ.core.hu
 Andrea Szalavetz=aszalave@vki.hu
 Dezsoe Szalay=szalay@uni-bonn.de
 György Szapáry=ambassador.was@mfa.gov.hu
 Tomasz SZAPIRO=tszapiro@gmail.com
 Irena Szarowská=szarowska@opf.slu.cz
 Katarzyna Szarzec=k.szarzec@ue.poznan.pl
 Urszula Szczerbowicz=urszula.szczerbowicz@cepii.fr
 Agnieszka Szczypińska=agnieszka.szczypinska@mofnet.gov.pl
 Anna Szczypińska=zanna12@wp.pl
 Giorgio Szego=gsz.jbf@fastwebnet.it
 Istvan P Szekely=istvan-pal.szekely@ec.europa.eu
 Balazs Szent-Ivanyi=balazs.szentivanyi@uni-corvinus.hu
 Balázs Sziklai=sziklai.balazs@krtk.mta.hu
 Adam Szirmai=szirmai@merit.unu.edu
 Katarzyna Sznajd-Weron=katarzyna.weron@pwr.wroc.pl
 Szomolányi Karol=szomolan@euba.sk
 Rick Szostak=rick.szostak@ualberta.ca
 Daniel Szpiro=daniel.szpiro@neuf.fr
 Imre Szücs=icsusz@gmail.com
 Adam Szulc=aszulc@sgh.waw.pl
 Kenneth Ray Szulczyk=ken@ken-szulczyk.com
 Karol Szwagrzak=karol.s.flores@gmail.com
 Martin Szydlowski=martin.szydlowski@u.northwestern.edu
 Stefan Szymanski=stefansz@umich.edu
