 Felipe S. Iachan=felipe.iachan@fgv.br
 Andreea Iluzia Iacob=aiacob@ase.ro
 Mihaela Iacob=miuiacob@yahoo.com
 Severian Vladut Iacob=severianvladutiacob@yahoo.com
 Alessandra Iacobucci=alessandra.iacobucci@sciences-po.fr
 Donato Iacobucci=iacobucci@univpm.it
 Andreea-Oana Iacobuta=andreea_iacobuta@yahoo.com
 Fabrizio Iacone=fabrizio.iacone@york.ac.uk
 Roberto Iacono=roberto.iacono@hist.no
 Maurizio Iacopetta=maurizio.iacopetta@skema.edu
 Matteo Iacoviello=matteo.iacoviello@frb.gov
 Leonardo Iacovone=liacovone@worldbank.org
 Stefano Maria Iacus=stefano.iacus@unimi.it
 Laurence R. Iannaccone=larry@econzone.com
 Giovanna Iannantuoni=giovanna.iannantuoni@unimib.it
 Alfredo Ibáñez=alfre.ibanez@gmail.com
 Ana Maria Ibáñez=aibanez@uniandes.edu.co
 Lisette Ibanez=ibanez@supagro.inra.fr
 Javier Ignacio Ibarlucia=javier_ibarlucia@hotmail.com
 Pablo Ibarraran=pibarraran@iadb.org
 Jorge Ibarra - Salazar=jaibarra@itesm.mx
 Alejandro Ibarra-Yunez=aibarra@itesm.mx
 Mansor H. Ibrahim=mansorhi@hotmail.com
 Mohamed Abbas Ibrahim=albarsi2020@yahoo.com
 M V Ibrahimo=ibrahimo@iseg.utl.pt
 Rikke Ibsen=rikke@i2minds.dk
 Özgur İCAN=oican@anadolu.edu.tr
 Hibiki Ichiue=ichiue@gmail.com
 Stefaan Ide=stefaan.ide@nbb.be
 Byron Javier Idrovo=bidrovo@cchc.cl
 Todd Idson=tidson@bu.edu
 Roxana Idu=ridu@rockford.edu
 Vincent Iehlé=vincent.iehle@dauphine.fr
 Florian Ielpo=florian.ielpo@ensae.org
 Elisa Iezzi=elisa.iezzi@unibo.it
 Stefano Iezzi=stefano.iezzi@bancaditalia.it
 Cristi Iftene=cristiiftene@univ-ovidius.ro
 Zainab Iftikhar=zainab.kkhan@gmail.com
 Herrade Igersheim=igersheim@unistra.fr
 Iulia Igescu=ligescu@mopa.ae
 Clement Atewe U Ighodaro=clemigho2006@yahoo.com
 Ana Iglesias=ana.iglesias.casal@usc.es
 Emma M. Iglesias=emma.iglesias@udc.es
 Carlos Iglesias-Fernández=carlos.iglesias@uah.es
 Javier Iguiñiz=jiguini@pucp.edu.pe
 Keith Ihlanfeldt=kihlanfe@fsu.edu
 Iulian Ihnatov=iulian.ihnatov@uaic.ro
 Atsushi Iimi=aiimi@worldbank.org
 Michiko Iizuka=iizuka@merit.unu.edu
 Shinsuke Ikeda=ikeda@iser.osaka-u.ac.jp
 Yukihiro Ikeda=ikeda@econ.keio.ac.jp
 Masako Ikefuji=ikefuji@sam.sdu.dk
 Munenobu Ikegami=ikegami4@gmail.com
 Sylvanus Ikhide=sylvanus.ikhide@usb.ac.za
 Svetlana Ikonnikova=svetlana.ikonnikova@beg.utexas.edu
 Richard Andrew Iles=r.iles@griffith.edu.au
 Cordelius Ilgmann=cordeliusilgmann@gmx.de
 Dragos Ilie=dragosilie2002@yahoo.com
 Irina Ilina=iilina@hse.ru
 Kirill Ilinski=kirill.ilinski@fusionam.com
 Manuel Illueca=illueca@cofin.uji.es
 Pekka Ilmakunnas=pekka.ilmakunnas@aalto.fi
 Bogdan ILUT=bogdan.ilut@feaa.uaic.ro
 Katsushi S. Imai=katsushi.imai@manchester.ac.uk
 Susumu Imai=susumu.imai@uts.edu.au
 Zumrut Imamoglu=zumrut.imamoglu@bahcesehir.edu.tr
 Guido Imbens=imbens@stanford.edu
 Scott Andrew Imberman=imberman@msu.edu
 Michele Imbruno=michele.imbruno@imtlucca.it
 Jean M. Imbs=jean.imbs@parisschoolofeconomics.eu
 Serkan Imisiker=serkan.imisiker@tcmb.gov.tr
 Dan Immergluck=dan.immergluck@coa.gatech.edu
 Herwig Immervoll=herwig.immervoll@gmail.com
 Giovanni Immordino=giimmo@tin.it
 Gregorio Impavido=gimpavido@imf.org
 Andrea Imperia=andrea.imperia@uniroma1.it
 Roberto Impicciatore=roberto.impicciatore@unimi.it
 Muhammad Imran=imran.muhamd@gmail.com
 Ayse Imrohoroglu=ayse@marshall.usc.edu
 Selahattin Imrohoroglu=selo@marshall.usc.edu
 Kazuyuki Inagaki=inagaki@onomichi-u.ac.jp
 Özlem İnanç=oinanc1@gmail.com
 Tuğbay INAN=tugbay.inan@deu.edu.tr
 Onur Ince=inceo@appstate.edu
 Meltem Ince Yenilmez=meltem.ince@yasar.edu.tr
 Gabriela Inchauste=ginchauste@worldbank.org
 Eren Inci=ereninci@sabanciuniv.edu
 Nurul Indarti=nurulindarti@yahoo.com
 Indridi H. Indridason=ihi@hi.is
 Davide Infante=davide.infante@unical.it
 Gerardo Infante=g.infante@uea.ac.uk
 Lester Ingber=ingber@ingber.com
 Vicente Inglada=vinglada@mfom.es
 Roula Inglesi-Lotz=roula.inglesi-lotz@up.ac.za
 Beth Ingram=beth-ingram@uiowa.edu
 Salvatore Ingrassia=s.ingrassia@unict.it
 Robert Inklaar=r.c.inklaar@rug.nl
 Joachim Inkmann=jinkmann@unimelb.edu.au
 James Innes=james.innes@csiro.au
 Robert Innes=innes@cals.arizona.edu
 Alessandro Innocenti=alessandroinnocenti@live.it
 Atsushi Inoue=ainoue@smu.edu
 kotaro Inoue=inoue.k.aq@m.titech.ac.jp
 Takeshi Inoue=tinoue@ps.nanzan-u.ac.jp
 井上智弘 (Tomohiro Inoue)=ino.ict@gmail.com
 Aysu İnsel=aysu.insel@kemerburgaz.edu.tr
 Michael Insler=insler@usna.edu
 Margaret Insley=minsley@uwaterloo.ca
 Catalin Angelo Ioan=catalin_angelo_ioan@yahoo.com
 Valeriu Ioan-Franc=valeriufranc2007@yahoo.com
 Gina E. Ioan=ginafilote@yahoo.com
 Ildiko Ioan=ioanildiko@hotmail.com
 Yannis Ioannides=yannis.ioannides@tufts.edu
 Yiorgos Ioannidis=geoion@otenet.gr
 Vasso Ioannidou=v.p.ioannidou@uvt.nl
 Cornel Ionescu=caragea21@yahoo.com
 Anamaria Felicia Ionescu=felicia.ionescu@frb.gov
 Ionut Teodor Ionescu=ionut_teodor@yahoo.com
 Mariana Iootty=miootty@worldbank.org
 Marioara Iordan=miordan@ipe.ro
 Filip Teodor Iorgulescu=fileos1984@yahoo.com
 Giulia Iori=giulia.iori@mac.com
 Daniela Iorio=daniela.iorio@uab.es
 Пламен Йосифов (Plamen Iossifov)=piossifov@imf.org
 Alberto Iozzi=alberto.iozzi@uniroma2.it
 Jose Luis Iparraguirre=jose.iparraguirre@ageuk.org.uk
 Roberto Ippoliti=roberto.ippoliti@unipmn.it
 Azhar Iqbal=azharaerc@yahoo.com
 Javed Iqbal=javed.chughtai@gmail.com
 Javed Iqbal=javed_uniku@yahoo.com
 Kazi Iqbal=kazi.iqbal2013@gmail.com
 Muhammad Iqbal=miqbalpide@yahoo.com
 Nasir Iqbal=nasir@pide.org.pk
 Robert Aldo Iquiapaza=riquiapaza@gmail.com
 Delphine Irac=delphine.irac@banque-france.fr
 Susana Iranzo=susana.iranzo@urv.cat
 Alfonso Irarrazabal=alfonso.irarrazabal@norges-bank.no
 Ana Maria Iregui=airegubo@banrep.gov.co
 Jonathan Ireland=john.ireland@scotland.gsi.gov.uk
 Peter Ireland=peter.ireland@bc.edu
 Chaudhry Muhammad Irfan=cmirfan@yahoo.com
 Mohd Irfan=irfan@iitk.ac.in
 Nagore Iriberri=nagore.iriberri@upf.edu
 Alejandra Irigoin=m.a.irigoin@lse.ac.uk
 Sabina Irimie=bina2932@yahoo.com
 Doruk İriş=dorukiris@sogang.ac.kr
 Jean Jacques Iritié=jeanjacques.iritie@gmail.com
 Bernd Irlenbusch=bernd.irlenbusch@uni-koeln.de
 Andreas Irmen=airmen@uni.lu
 Duncan Standon Ironmonger=dsi@unimelb.edu.au
 Zuzana Iršová=zuzana.irsova@gmail.com
 Ian Irvine=ian.irvine@concordia.ca
 James Reid Irwin=irwin1jr@cmich.edu
 Xavier Irz=xavier.irz@mtt.fi
 Alan G Isaac=aisaac@american.edu
 Henri ISAAC=his@rouenbs.fr
 Marc ISABELLE=marc.isabelle@dauphine.fr
 Claudia Isac=isacclaudia@gmail.com
 Sergei Isaenko=sisaenko@jmsb.concordia.ca
 Isaic-Maniu=alexandru.isaic@csie.ase.ro
 Dusan Isakov=dusan.isakov@unifr.ch
 Ann-Sofie Isaksson=ann-sofie.isaksson@economics.gu.se
 George - Marian Isbasoiu=george.isbasoiu@email.com
 Talan B. Iscan=tiscan@dal.ca
 Emily Pas Isenberg=emily.p.isenberg@census.gov
 Ifa Isfandiarni=isfandiarni@yahoo.com
 Jonathan Isham=jisham@middlebury.edu
 Ariun Ishdorj=aishdorj@tamu.edu
 Masami Ishida=ishidam@ide.go.jp
 Hiroe Ishihara=hi223@cam.ac.uk
 Hirokazu Ishise=ishise@iser.osaka-u.ac.jp
 Gultekin Isiklar=gisiklar@gmail.com
 Sayim Isik=sayim@akdeniz.edu.tr
 Omer Iskenderoglu=oiskenderoglu@nigde.edu.tr
 Fedor Iskhakov=f.iskhakov@unsw.edu.au
 Nikolay Iskrev=niskrev@umich.edu
 Abdul Azim Islahi=aaislahi@hotmail.com
 Anisul M. Islam=islama@uhd.edu
 Asadul Islam=asadul.islam@monash.edu
 Faridul Islam=faridul.islam@morgan.edu
 Mevlud Islami=mevlud.islami@bundesbank.de
 Iyanatul Islam=islami@ilo.org
 Mohammad Tariqul Islam Khan=stepshantomy@yahoo.com
 Md. Rabiul Islam=rabi.islam@deakin.edu.au
 M. Kamrul Islam=kamrul.islam@uni.no
 Mohammed Shariful Islam=sharifurp02@gmail.com
 Nazmul Islam=nazmul0123@yahoo.com
 Nazrul Islam=nislam13@yahoo.com
 Nurul Islam=n.islam@cgiar.org
 Tanweer ul Islam=tanweer.ul.islam@gmail.com
 Mohanad ISMAEL=mohanad.ismael11@gmail.com
 Abdul Ghafar Ismail=agibab@ukm.my
 Illisriyani Ismail=illisriyani@gmail.com
 Normaz Wana Ismail=nwi@upm.edu.my
 Ramlee Ismail=iramlee@upsi.edu.my
 Alessia Isopi=alessia.isopi@manchester.ac.uk
 Marlène Isoré=marlene.isore@helsinki.fi
 Ana Ispas=ispasana@unitbv.ro
 Ingo E. Isphording=isphording@iza.org
 João Victor Issler=joao.issler@fgv.br
 Elena Manuela Istoc=manuelaistoc@yahoo.com
 Costel Istrate=istrate@uaic.ro
 Gabriel Istrate=gabriel.istrate@gmail.com
 Luminita Gabriela Istrate=istrate_luminita@yahoo.com
 Klodiana Istrefi=klodiana.istrefi@hof.uni-frankfurt.de
 Andrey Itkin=aitkin@poly.edu
 Juha Ville Antero Itkonen=juha.itkonen@helsinki.fi
 Banri Ito=ito-banri@isc.senshu-u.ac.jp
 Hiro Ito=ito@pdx.edu
 Keiko Ito=keiko-i@isc.senshu-u.ac.jp
 Koichiro Ito=ito@bu.edu
 Takatoshi Ito=itointokyo@gmail.com
 Peter T. Ittig=peter.ittig@umb.edu
 Inigo Iturbe-Ormaetxe=iturbe@ua.es
 Txomin Iturralde=txomin.iturralde@ehu.es
 Victor Iturra=viturra@ucn.cl
 Ionel Iuliana=iulianaionel@yahoo.com
 Marc IVALDI=marc.ivaldi@tse-fr.eu
 Vlad Ivanenko=ivanenko60@yahoo.com
 Iuliu Marin Ivănescu=ivanescu.iuliu@profesor.rau.ro
 Mona Maria Ivănescu=ivanescu.mona@profesor.rau.ro
 Maros Ivanic=mivanic@worldbank.org
 Kate Ivanova=ivanova.6@asc.ohio-state.edu
 Nadezhda Stanislavovna Ivanova=nsivanova@hse.ru
 Olga Ivanova=olga.ivanova@tno.nl
 Asen Ivanov=a.ivanov@qmul.ac.uk
 Radosveta Ivanova-Stenzel=ivanova-stenzel@tu-berlin.de
 Maxim Ivanov=mivanov@mcmaster.ca
 Stanislav Hristov Ivanov=stanislav.ivanov@vumk.eu
 Clementina Ivan-Ungureanu=iu_clem@yahoo.com
 Valeriu Ivan=valeriu.ivan@gmail.com
 Irina V. Ivashkovskaya=iivashkovskaja@hse.ru
 Eric J. Iversen=eric@nifu.no
 Tor Iversen=tor.iversen@medisin.uio.no
 Anna Grigorievna Ivolga=annya_iv@mail.ru
 Olena Ivus=oivus@business.queensu.ca
 Tatsuro Iwaisako=iwaisako@econ.osaka-u.ac.jp
 Małgorzata Iwanicz-Drozdowska=miwani@sgh.waw.pl
 Ichiro Iwasaki=iiwasaki@ier.hit-u.ac.jp
 Yasuharu Iwata=yasuharu.iwata@cao.go.jp
 Kentaro Iwatsubo=iwatsubo@econ.kobe-u.ac.jp
 Sunday Osaretin Iyare=soiyare@justice.com
 Sudarshan Iyengar=sudarshan54@gmail.com
 Karthik Iyer=iyerk0@gmail.com
 Sriya Iyer=sriya.iyer@econ.cam.ac.uk
 Murat F. Iyigun=murat.iyigun@colorado.edu
 Sergei Izmalkov=sizmalkov@gmail.com
 Alejandro Izquierdo=alejandroi@iadb.org
 Mario Izquierdo=mizquierdo@bde.es
 Segismundo Samuel Izquierdo=segis@eis.uva.es
 Christian Jaag=christian.jaag@swiss-economics.ch
 Olfa Jaballi=olfa.jaballi@univ-paris1.fr
 Jabir Ali=jabirali@iiml.ac.in
 Ivan Jaccard=ivan.jaccard@ecb.int
 David Tomás Jacho-Chávez=djachocha@emory.edu
 Christoph Jäckel=christoph.jaeckel@gmail.com
 Annette Jäckle=aejack@essex.ac.uk
 David S. Jacks=dsjacks@gmail.com
 Aaron L. Jackson=ajackson@bentley.edu
 C. Kirabo Jackson=kirabo-jackson@northwestern.edu
 Jonathan Jackson=j.p.jackson@lse.ac.uk
 Ken Jackson=kjackson@wlu.ca
 Matthew O. Jackson=jacksonm@stanford.edu
 Michael P. Jackson=mike-jackson@comcast.net
 Natalie Olivia Jackson=natalie.jackson@waikato.ac.nz
 Peter Mcleod Jackson=pmj1@le.ac.uk
 Sukhan Jackson=s.jackson@economics.uq.edu.au
 Thomas Jackson=tomjackson@real-analytics.com
 William A. Jackson=william.jackson@york.ac.uk
 Jens Jackwerth=jens.jackwerth@uni-konstanz.de
 Jojo Jacob=jojo.jacob@grenoble-em.com
 Anita Jacob-Puchalska=jacob-puchalska@ifo.de
 Punnoose Jacob=punnoose.jacob@rbnz.govt.nz
 Bas Jacobs=bjacobs@ese.eur.nl
 Hanns D. Jacobsen=hdjacobsen@studienforum-berlin.de
 Joyce Jacobsen=jjacobsen@wesleyan.edu
 Veronica Jacobsen=v.jacobsen@clear.net.nz
 Jan Jacobs=j.p.a.m.jacobs@rug.nl
 David S. Jacobson=david.jacobson@dcu.ie
 Sarah Jacobson=saj2@williams.edu
 Tor Jacobson=tor.jacobson@riksbank.se
 Adam Knut, Sture Jacobsson=aja@ne.su.se
 Wouter Jacobs=wouter.jacobs@ua.ac.be
 Nadia Jacoby=jacoby@univ-paris1.fr
 Luis I. Jácome=ljacome@imf.org
 Nicolas Jacquemet=nicolas.jacquemet@psemail.eu
 Florence Jacquet=florence.jacquet@supagro.inra.fr
 Laurence M. Jacquet=laurence.jacquet@u-cergy.fr
 Nicolas L. Jacquet=nljacquet@yahoo.com
 Antoine Jacquier=ajacquie@imperial.ac.uk
 Marc Jacquinet=mjacquinet@univ-ab.pt
 Joseph M Jadlow=jad1942@okstate.edu
 Evans Jadotte=ejadotte@hansung.ac.kr
 Robert Jaeckle=robert.jaeckle@th-nuernberg.de
 David Jaeger=djaeger@gc.cuny.edu
 Sara R. Jaeger=sara.jaeger@plantandfood.co.nz
 Manuel Jaén-García=mjaen@ual.es
 Saqib Jafarey=s.s.jafarey@city.ac.uk
 Adam Jaffe=adam.jaffe@motu.org.nz
 Bruce L. Jaffee=jaffee@indiana.edu
 Sonia Jaffe=sjaffe@fas.harvard.edu
 Rachel Catharina Cornelia Jafta=rccj@sun.ac.za
 Ulrike Jäger=jaeger@ifo.de
 Julapa A. Jagtiani=julapa.jagtiani@phil.frb.org
 Mohammad Reza Jahan-Parvar=mrjahan@gmail.com
 Antonio M. Jaime-Castillo=amjaime@uma.es
 Esteban Jaimovich=e.jaimovich@surrey.ac.uk
 Nir Jaimovich=njaimo@gmail.com
 Anmol Jain=jain_anmol@rediffmail.com
 Anshul Jain=jainanshul@gmail.com
 Neelam Jain=ta0nxj1@gmail.com
 Varinder Jain=vjain2007@gmail.com
 Anand Kumar Jaiswal=akjaiswal@iimahd.ernet.in
 Zoltán M. Jakab=jakabmz@gmail.com
 Audrone Jakaitiene=audrone.jakaitiene@gmail.com
 Andreja Jaklic=andreja.jaklic@fdv.uni-lj.si
 Anja P. Jakobi=a.p.jakobi@rhul.ac.uk
 Michael Jakob=jakob@pik-potsdam.de
 Kristofer Jakobsson=jakobsson.kristofer@gmail.com
 Niklas Jakobsson=nja@nova.no
 Petr Jakubík=petrjakubik@seznam.cz
 Maciej Jakubowski=mjakubowski@uw.edu.pl
 Ahmad Jalali-Naini=ahmad_jalali@hotmail.com
 Jukka Jalava=jukka.jalava@ec.europa.eu
 Moti Jaleta=m.jaleta@cgiar.org
 Hafiz Hanzla Jalil=hanzla@pide.org.pk
 M Anwar Jalil=majalilonline@yahoo.com
 Munir Jalil=majalilb@unal.edu.co
 Joao Tovar Jalles=jjalles@imf.org
 Haroon Jamal=haroonjamal@hotmail.com
 Tooraj Jamasb=tooraj.jamasb@durham.ac.uk
 Attila Jambor=attila.jambor@uni-corvinus.hu
 Gregory A. James=g.a.james@lboro.ac.uk
 Harvey James=hjames@missouri.edu
 Kenneth Jameson=jameson@economics.utah.edu
 Mario Jametti=mario.jametti@lu.unisi.ch
 Faisal Jamil=fsljml@hotmail.com
 Muhammad Jamil=jamil_pakeco@yahoo.com
 Mark Allen Jamison=jamisoma@ufl.edu
 Rania Jammazi=jamrania2@yahoo.fr
 Sebak Kumar Jana=sebakjana@yahoo.co.in
 Gholamreza Jandaghi=jandaghi@ut.ac.ir
 Karel Janda=karel-janda@seznam.cz
 Eckhard Janeba=janeba@uni-mannheim.de
 Jürgen Janger=juergen.janger@wifo.ac.at
 Ramesh Jangili=rameshjangili@yahoo.co.in
 Insong Jang=ijang@nabo.go.kr
 Batlome Janjgava=batlome.janjgava@cerge-ei.cz
 M. Yasin Y Janjua=yasin.janjua@gmail.com
 Zuzana Janko=zjanko@sfsu.edu
 John A. Janmaat=john.janmaat@ubc.ca
 Ben Jann=jann@soz.unibe.ch
 Eilev S. Jansen=eilev.jansen@ssb.no
 Marcel Jansen=marcel.jansen@uam.es
 W. Jos Jansen=w.j.jansen@dnb.nl
 Petr Janský=jansky.peta@gmail.com
 Simon Janssen=simon.janssen@isu.uzh.ch
 Wendy Janssens=wjanssens@feweb.vu.nl
 Ronald Janßen-Timmen=janssen@rwi-essen.de
 Michael Jansson=mjansson@econ.berkeley.edu
 Per Jansson=per.jansson@riksbank.se
 Thorsten Janus=tjanus@uwyo.edu
 Norbert Janz=janz@fh-aachen.de
 Tullio Jappelli=tullio.jappelli@unina.it
 Matija Japundžić=matija.japundzic@net.hr
 alberto jaramillo, Sr.=ajarami@eafit.edu.co
 Fernando Jaramillo=fernando.jaramillo@urosario.edu.co
 Christian R. Jaramillo H.=ch.jaramillo.econ@gmail.com
 Patricio A. Jaramillo Gutierrez=patricio.jaramillo.gutierrez@gmail.com
 Pedro Daniel Jara-Moroni=pedro.jara@usach.cl
 Caroline Jardet=caroline.jardet@banque-france.fr
 Matthew Steven Jaremski=mjaremski@colgate.edu
 Ron S. Jarmin=ron.s.jarmin@census.gov
 Mariusz Jarmuzek=mjarmuzek@imf.org
 Katharina E. Jaronicki=katharina.jaronicki@unisg.ch
 Bilel Jarraya=bilel.jarraya@gmail.com
 Robert Jarrow=raj15@cornell.edu
 Sebastian Jauch=sebastian.jauch@econ.lmu.de
 Melise Jaud=mjaud@worldbank.org
 Jordi Jaumandreu=jordij@bu.edu
 Florence Jaumotte=fjaumotte@imf.org
 Muhammad Nadeem Javaid=nadeemjavaid75@gmail.com
 Omer Javed=omerjaved7@gmail.com
 Sajid Amin Javed=sajidamin@pide.org.pk
 Attiya Yasmin Javid=attiyajavid@pide.org.pk
 Muhammad Javid=mjavead@yahoo.com
 Beata Smarzynska Javorcik=beata.javorcik@economics.ox.ac.uk
 Fredj JAWADI=fredj.jawadi@univ-evry.fr
 Nabila Jawadi=nabila.jawadi@ipag.fr
 Syed Tehseen Jawaid=stjawaid@hotmail.com
 Shekhar Jayanthi=shekhar.jayanti@gmail.com
 TIRU K. Jayaraman=jayaraman_tk@usp.ac.fj
 Milan Jayasinghe=milan.jayasinghe@psc-cfp.gc.ca
 Hubert Jayet=hubert.jayet@univ-lille1.fr
 Frederico Jayme Jr=gonzaga@cedeplar.ufmg.br
 Thomas S. Jayne=jayne@msu.edu
 Bostjan Jazbec=bostjan.jazbec@ef.uni-lj.si
 Frédo Jean-Baptiste=fredo.jean-baptiste@univ-lille3.fr
 Philippe Jeanfils=philippe.jeanfils@nbb.be
 François Jeanjean=francois.jeanjean@orange.com
 Thomas Jeanjean=jeanjean@essec.edu
 Olivier Jeanne=ojeanne@jhu.edu
 Philippe JEANNIN=philippe.jeannin@univ-tlse1.fr
 P. Wilner Jeanty=pwjosu@gmail.com
 Lars Jebjerg=mail@jebjerg.f2s.com
 Khaïreddine Jebsi=khairy.jebsi@topnet.tn
 Remi Jedwab=jedwab@gwu.edu
 Keith Jefferis=econsult.botswana@gmail.com
 Therese Jefferson=therese.jefferson@cbs.curtin.edu.au
 Christopher Jeffords=jeffords@iup.edu
 Philippe Jehiel=philippe.jehiel@parisschoolofeconomics.eu
 Thomas D. Jeitschko=jeitschk@msu.edu
 Meglena Jeleva=meglena.jeleva@u-paris10.fr
 Ivan Jeliazkov=ivan@uci.edu
 Mohamed Jellal=jellal2009@yahoo.fr
 Izabela Jelovac=jelovac@gate.cnrs.fr
 Luis Carlos Jemio=lcjemio@inesad.edu.bo
 Narendra Jena=narendrajena@gmail.com
 Pratap Ranjan Jena=jena@nipfp.org.in
 Erik Jenelius=jenelius@infra.kth.se
 Glenn Paul Jenkins=jenkins@econ.queensu.ca
 Tim Jenkinson=tim.jenkinson@sbs.ox.ac.uk
 Robin R. Jenkins=jenkins.robin@epa.gov
 Stephen Jenkins=s.jenkins@lse.ac.uk
 Colin Jennings=colin.jennings@kcl.ac.uk
 Sarah Jennings=sarah.jennings@utas.edu.au
 Camilla Jensen=camjen@sam.sdu.dk
 Carsten Lynge Jensen=clj@foi.ku.dk
 Christian Jensen=cjensen@alumni.cmu.edu
 Elizabeth J. Jensen=ejensen@hamilton.edu
 Frank Jensen=fje@foi.dk
 Helen H. Jensen=hhjensen@iastate.edu
 Henrik Jensen=henrik.jensen@econ.ku.dk
 J. Bradford Jensen=jbj24@georgetown.edu
 Jorgen Dejgaard Jensen=jorgen@ifro.ku.dk
 Mark J. Jensen=mark.jensen@atl.frb.org
 Martin Kaae Jensen=mj182@leicester.ac.uk
 Michael C. Jensen=mjensen@hbs.edu
 Nathaniel Duane Jensen=ndj6@cornell.edu
 Nathan M. Jensen=njensen@artsci.wustl.edu
 Paul H. Jensen=pjensen@unimelb.edu.au
 Peter Jensen=pje@asb.dk
 Peter Sandholt Jensen=psj@sam.sdu.dk
 Sissel Jensen=sissel.jensen@nhh.no
 Thomas Jensen=thomas.jensen@econ.ku.dk
 Thomas Christian Jensen=tcj@transport.dtu.dk
 Dirk Jenter=djenter@stanford.edu
 Bang Nam Jeon=jeonbana@gmail.com
 Doh-Shin Jeon=dohshin.jeon@gmail.com
 Hyeok Jeong=hyeokj@gmail.com
 Sangjun Jeong=vorwarts@naver.com
 Sung-Hee Jeon=shjeon@mcmaster.ca
 Christopher Jepsen=christopher.jepsen@ucd.ie
 Lisa K. Jepsen=lisa.jepsen@uni.edu
 Alberto R. Jerardo=ajerardo@ers.usda.gov
 Belén Jerez=mjerez@eco.uc3m.es
 Miguel Jerez=mjerez@ccee.ucm.es
 Michael Jerison=m.jerison@albany.edu
 Urban Joseph Jermann=jermann@wharton.upenn.edu
 Bruno Jérôme=bruno.jerome@gmail.com
 Morten Jerven=mjerven@sfu.ca
 Michal Jerzmanowski=mjerzma@clemson.edu
 Christoph Jeßberger=christoph.jessberger@bauhaus-luftfahrt.net
 David St John Jesson=dj2@york.ac.uk
 Bob Jessop=r.jessop@lancaster.ac.uk
 Anja Jetschke=jetschke@giga-hamburg.de
 Michael Jetter=mjetter7@gmail.com
 Shin Dong Jeung=jsdfss@fss.or.kr
 Chandan Kumar Jha=cjha1@lsu.edu
 Debajit Jha=jhadebajit@gmail.com
 Nikhil Jha=nikhil.jha@unimelb.edu.au
 Raghbendra Jha=r.jha@anu.edu.au
 Saumitra Jha=jha_saumitra@gsb.stanford.edu
 Nancy Ammon Jianakoplos=nancy.jianakoplos@colostate.edu
 Guohua Jiang=gjiang@gsm.pku.edu.cn
 Janet Hua Jiang=jjiang@bankofcanada.ca
 Zhao Jianglin=fbeijing@263.net
 Mingming Jiang=mjiangecon@gmail.com
 Nan Jiang=nan.jiang@aut.ac.nz
 Neng Jiang=n.jiang@sheffield.ac.uk
 Tao Jiang=jjtqqx@163.com
 Wei Jiang=jiangwei130@sina.com
 Wei Jiang=w.jiang@kent.ac.uk
 Yi Jiang=yjiang128@hotmail.com
 Lu Jiangyong=lujiangyong@gsm.pku.edu.cn
 Ionela Jianu (Dumitru)=ionela_jianu@yahoo.com
 Ye (George) Jia=yjia@upei.ca
 Yueqing Jia=yqjia2008@gmail.com
 Yuping Jia=y.jia@fs.de
 Zhiyang Jia=zhiyang.jia@ssb.no
 Ahmat Jidoud=ahmat.jidoud@univ-tlse1.fr
 Milan Jilek=jilek@ef.jcu.cz
 Juan Luis Jiménez=juanluis.jimenez@ulpgc.es
 Maribel Jiménez=jimenmar@gmail.com
 Antonio Jimenez-Martinez=antonio.jimenez@cide.edu
 Juan Angel Jimenez Martin=juanangel@ccee.ucm.es
 Sergi Jimenez-Martin=sergi.jimenez@upf.edu
 Mónica Jiménez=monicajimenez@conicet.gov.ar
 Natalia Jiménez=natjj@ugr.es
 Raul Jimenez=rjjimene@est-econ.uc3m.es
 Dolores Jiménez Rubio=dolores@ugr.es
 Renzo Jiménez Sotelo=rjimenez@pucp.edu.pe
 Juan F Jimeno=juan.jimeno@bde.es
 Paan Jindapon=pjindapo@cba.ua.edu
 Bjoern Jindra=bja@iwh-halle.de
 Irena Jindrichovska=irena.jindrichovska@seznam.cz
 Li Jing=lijingcw@hotmail.com
 Brian A. Jingwa=awungbrian@yahoo.com
 Hyun J. Jin=hyunjin@cau.ac.kr
 Jim Jin=jyj@st-andrews.ac.uk
 Naoto Jinji=jinji@econ.kyoto-u.ac.jp
 Keyu Jin=k.jin@lse.ac.uk
 Zhang Jinliang=zhangjinliang1213@163.com
 Ryo Jinnai=rjinnai@econmail.tamu.edu
 Tao Jin=tjin@fas.harvard.edu
 Xin Jin=jin.xin@mail.shufe.edu.cn
 Xisong Jin=xisong.jin@uni.lu
 Yi Jin=yi.jin@monash.edu
 Yu Jin=yjin.sufe@gmail.com
 Philip Inyeob Ji=philipji0422@gmail.com
 Komain Jiranyakul=komain_j@hotmail.com
 Thadavillil Jithendranathan=t9jithendran@stthomas.edu
 Boonlert Jitmaneeroj=boonlert_jit@utcc.ac.th
 Yongjie Ji=yongjiej@iastate.edu
 Yuemei Ji=yuemei.ji@econ.kuleuven.be
 Belmiro do Nascimento João=bjoao@pucsp.br
 Thomas Jobert=jobert@unice.fr
 Andreas A. Jobst=ajobst@bma.bm
 Beate Jochimsen=beate.jochimsen@hwr-berlin.de
 Markus Jochmann=markus.jochmann@ncl.ac.uk
 Juanna Schrøter Joensen=juanna.joensen@hhs.se
 Bernward Joerges=bjoerges@t-online.de
 Marc D. Joffe=marc@publicsectorcredit.org
 조갑제 (Gab-Je Jo)=gabjejo@kmu.ac.kr
 Magnus Johannesson=magnus.johannesson@hhs.se
 Adam Michael Johansen=a.m.johansen@warwick.ac.uk
 Kåre Johansen=kare.johansen@svt.ntnu.no
 Kathrin Johansen=kathrin.johansen@uni-rostock.de
 Soren Johansen=soren.johansen@econ.ku.dk
 Anders C. Johansson=anders.johansson@hhs.se
 Börje Johansson=jobo@ihh.hj.se
 Christer Johansson=christer.johansson@abdera.se
 Dan Johansson=dan.johansson@oru.se
 Edvard Johansson=maxedvard.johansson@me.com
 Fredrik Johansson=fredrik.johansson@finance.ministry.se
 Per Johansson=per.johansson@ifau.uu.se
 Robert Johansson=rjohansson@oce.usda.gov
 Olof Johansson-Stenman=olof.johansson@economics.gu.se
 Meliyanni Johar=meliyanni.johar@uts.edu.au
 Geraint Johnes=g.johnes@lancs.ac.uk
 Jill Johnes=j.johnes@lancaster.ac.uk
 Joice John=joicejohn@rbi.org.in
 Juergen John=john@helmholtz-muenchen.de
 Rijo M. John=rmjohn@gmail.com
 Julian Vedeler Johnsen=julian.johnsen@econ.uib.no
 Andreas Johnson=johnson_andreas@hotmail.com
 Bruce K. Johnson=bruce.johnson@centre.edu
 Christian Johnson=cjohnson@imf.org
 Daniel Johnson=djohnson@coloradocollege.edu
 David Johnson=djohnson@wlu.ca
 David Blake Johnson=johnsod@ucalgary.ca
 Joseph F. Johnson=chicuadro@gmail.com
 Noel D. Johnson=njohnsol@gmu.edu
 Paul Johnson=pajohnson@vassar.edu
 Paul Ronald Johnson=afprj@uaa.alaska.edu
 Richard W. Johnson=rjohnson@urban.org
 Robert Christopher Johnson=robert.c.johnson@dartmouth.edu
 Shane A. Johnson=shaneajohnson@tamu.edu
 Terence R. Johnson=tjohns20@nd.edu
 Richard C. B. Johnsson=richardcbjohnsson@spray.se
 David W. Johnston=david.johnston@monash.edu
 Nick Johnstone=nick.johnstone@oecd.org
 Jake Johnston=johnston@cepr.net
 Michael K. Johnston=mjohnston@bankofcanada.ca
 Robert J. Johnston=rjohnston@clarku.edu
 Alok Johri=johria@mcmaster.ca
 Esa Jokivuolle=esa.jokivuolle@bof.fi
 Robert Joliet=r.joliet@ieseg.fr
 Dean Jolliffe=jolliffe@alumni.princeton.edu
 Iragaël Joly=ijoly.research@gmail.com
 Cecilia Jona-Lasinio=jonalasi@istat.it
 Nicolas Jonard=nicolas.jonard@uni.lu
 Erik Jonasson=erik.jonasson@konj.se
 Eric Jondeau=eric.jondeau@unil.ch
 Andrew Michael Jones=andrew.jones@york.ac.uk
 Barry Edward Jones=bjones@binghamton.edu
 Brian Mervyn Jones=b.m.jones@bangor.ac.uk
 Charles I. Jones=chad.jones@stanford.edu
 Chris Jones=c.jones2@aston.ac.uk
 Christopher Jones=christopher.jones@marshall.usc.edu
 C. Kenneth Jones=kenjones@portfolionetworks.com
 Daniel Brady Jones=daniel.jones@moore.sc.edu
 Garett Jones=gjonesb@gmu.edu
 Glenn Jones=glenn.jones@uts.edu.au
 Janelle Jones=jones@cepr.net
 John Bailey Jones=jbjones@albany.edu
 John Colin Henry Jones=meredith@uvvm.uvic.ca
 Keithly G. Jones=kjones@ers.usda.gov
 Kelly M. Jones=k.jones@cgiar.org
 Kevin Dwayne Jones=kevin@kevindjones.net
 Marion Jones=marion.jones@uregina.ca
 Michael Jones=m3jones@bridgew.edu
 Michael John Jones=michaeljohn.jones@bristol.ac.uk
 Natalie A. Jones=n.jones3@uq.edu.au
 Peter W. Jones=liontraders@yahoo.com
 Randall J. Jones, Jr.=ranjones@uco.edu
 Robert Jones=rjones@swin.edu.au
 Stacey Marie Jones=sjones@seattleu.edu
 Stephen Clark Jones=sjones@atu.edu
 Stephen RG Jones=jonessrg@mcmaster.ca
 Richard Jong-A-Pin=richardjongapin@gmail.com
 Simcha Jong=s.jong@ucl.ac.uk
 Lars Jonung=lars@jonung.se
 Donghun Joo=ramiboo@hanyang.ac.kr
 Philip Joos=philjoos@uvt.nl
 Guillermo Jopen Sánchez=gjopen@pucp.pe
 Octavian-Dragomir JORA=octavian.jora@yahoo.com
 Jacob A. Jordaan=j.a.jordaan@uu.nl
 Henrik Jordahl=henrik.jordahl@ifn.se
 Bradford D. Jordan=bjordan@uky.edu
 Declan Jordan=d.jordan@ucc.ie
 Oscar Jorda=oscar.jorda@sf.frb.org
 Marcos Valli Jorge=marcos.valli@bcb.gov.br
 Jason B. Jorgensen=jasjorg@gmail.com
 Peter Løchte Jørgensen=plj@asb.dk
 Thomas Høgholm Jørgensen=thomas.h.jorgensen@econ.ku.dk
 Dale Jorgenson=djorgenson@harvard.edu
 Markus Jorra=markus.jorra@bundesbank.de
 Juan Mario Jorrat, Sr.=jjorrat@herrera.unt.edu.ar
 George Joseph=gjoseph@worldbank.org
 Gilles Joseph=gjoseph@martinique.univ-ag.fr
 Joy V Joseph=joy.joseph@business.uconn.edu
 K J Joseph=kjjoseph@cds.ac.in
 Jens Josephson=jens.josephson@ne.su.se
 Dushko Josheski=dushkojosheski@gmail.com
 Kirti Kusum Joshi=kirtikusum.joshi@gmail.com
 Pramod Kumar Joshi=p.joshi@cgiar.org
 Satish Joshi=satish@msu.edu
 Paul Joskow=pjoskow@mit.edu
 Jean-Michel Josselin=jean-michel.josselin@univ-rennes1.fr
 Sven P. Jost=sven.jost@ey.com
 Tae-Hee Jo=taeheejo@gmail.com
 Frank Jotzo=frank.jotzo@anu.edu.au
 Mustapha Jouili=mjouili@yahoo.fr
 Elyès Jouini=jouini@ceremade.dauphine.fr
 Fathi Jouini=fathi.jouini@fdseps.rnu.tn
 Jamel JOUINI=jamel.jouini@fsegn.rnu.tn
 David Joulfaian=david.joulfaian@treasury.gov
 Isabelle Joumard=isabelle.joumard@oecd.org
 Alain Jousten=ajousten@ulg.ac.be
 Fred Joutz=bmark@gwu.edu
 Boyan Jovanovic=bj2@nyu.edu
 Branimir Jovanovic=branimir.jovanovic@uniroma2.it
 Dragan Jovanovic=jovanovic@econ.uni-frankfurt.de
 Joseph P. Joyce=jjoyce@wellesley.edu
 Ted Joyce=theodore.joyce@baruch.cuny.edu
 James J. Jozefowicz=james.jozefowicz@iup.edu
 swaminathan J=jsavcce@gmail.com
 Isaac Leobardo Sánchez Juárez=isaac.sanchez@uacj.mx
 Laura Juarez=ljuarezg@banxico.org.mx
 Ruben Juarez=rubenj@hawaii.edu
 Biung-Ghi Ju=bgju@snu.ac.kr
 Kenneth L. Judd=kennethjudd@mac.com
 Cristina Jude=cristina.jude@univ-orleans.fr
 Eamonn Judge=e.judge@leedsmet.ac.uk
 George Judge=gjudge@berkeley.edu
 Guy Judge=guy.judge@port.ac.uk
 Dean Judson=dhjudson@comcast.net
 Dario Judzik=dariojudzik@gmail.com
 Hendrik Juerges=juerges@uni-wuppertal.de
 Falko Juessen=falko.juessen@uni-dortmund.de
 Chinhui Juhn=cjuhn@uh.edu
 Michel Juillard=michel.juillard@mjui.fr
 Dorin Jula=dorinjula@yahoo.fr
 Nicolae Marius Jula=mariusjula@yahoo.com
 Nicoleta Jula=nicoletajula@yahoo.com
 Benoit Julien=benoit.julien@unsw.edu.au
 Brandon Julio=bjulio@london.edu
 Juan Manuel Julio=jmjulioroman@gmail.com
 Paulo Fernando Rodrigues Lérias Júlio=pfjulio@bportugal.pt
 Christian Julliard=c.julliard@lse.ac.uk
 Bruno Jullien=bruno.jullien@tse-fr.eu
 Dorian Jullien=dorian.jullien@gredeg.cnrs.fr
 Nicolas Jullien=nicolas.jullien@telecom-bretagne.eu
 Adusei Jumah=adusei.jumah@univie.ac.at
 Charles Blessings Laurence Jumbe=charlesjumbe@yahoo.com
 P. (Raja) N. Junankar=raja.junankar@uws.edu.au
 Bogang Jun=bogang33@gmail.com
 Byoung Heon Jun=bhjun@korea.ac.kr
 Alexander C. Jung=alexander.jung@ecb.europa.eu
 Hanjoon Michael Jung=junghanjoon73@hanmail.net
 Juan Jung=juanjung@gmail.com
 Juergen Jung=jjung@towson.edu
 Philip Jung=phjung@uni-bonn.de
 Robert Jung=robert.jung@uni-hohenheim.de
 Seeun Jung=seeun.jung@psemail.eu
 Li Jun=lijunfortune126@126.com
 Sung Jae Jun=sjun@psu.edu
 Tackseung Jun=tj32k@daum.net
 Juha Pekka Junttila=juha-pekka.junttila@jyu.fi
 Mindaugas Juodis=mjuodis123@gmail.com
 Steffen Juranek=steffen.juranek@nhh.no
 Leszek Piotr JURDZIAK=leszek.jurdziak@pwr.wroc.pl
 Marius Jurgilas=jurgilas@jurgilas.net
 Patricia Justino=a.p.v.justino@sussex.ac.uk
 Johannes Paul Jütting=johannes.jutting@oecd.org
 Luciana Juvenal=luciana.juvenal@gmail.com
 Yuan Ju=yuan.ju@york.ac.uk
