 Mandar Oak=mandar.oak@adelaide.edu.au
 Bogdan Oancea=bogdan.oancea@ie.ase.ro
 Alka Obadić=aobadic@efzg.hr
 Ichiro Obara=iobara@econ.ucla.edu
 Ayako Obashi=obashi@wisc.edu
 Kwasi Camara Obeng=camaraobeng@yahoo.co.uk
 Iris Maria Oberauner=iris.oberauner@gmail.com
 Ezra Oberfield=ezraoberfield@gmail.com
 Andreas G. Oberheitmann=oberheitmann@tsinghua.edu.cn
 Harald Oberhofer=harald.oberhofer@sbg.ac.at
 Imoleayo Foyeke Obigbemi=ayosalako2004@yahoo.com
 Nonso Obikili=nonso.obikili@econrsa.org
 Francesc Obiols-Homs=francesc.obiols@uab.es
 Edward O'Boyle=edoboyle737@gmail.com
 Martin Obradovits=martin.obradovits@univie.ac.at
 Laura Obreja Brasoveanu=laura_obreja@yahoo.com
 Anthony Patrick O'Brien=ao01@lehigh.edu
 Christopher O'Brien=christopher.obrien@nottingham.ac.uk
 Martin D. O'Brien=martin.obrien@centralbank.ie
 Paul Sherlock O'brien=paul.obrien@oecd.org
 Maksym Obrizan=mobrizan@gmail.com
 Thomas Obst=ot32@gre.ac.uk
 Oğuz ÖCAL=ocaloguz@gmail.com
 Sergio Ocampo=ocamp020@umn.edu
 Filippo Occhino=filippo.occhino@clev.frb.org
 Wolfgang Ochel=ochel@ifo.de
 Justus Ochieng=jastopheli@yahoo.com
 Héctor Ochoa=hochoa@icesi.edu.co
 Juan Marcelo Ochoa=marcelo.ochoa@duke.edu
 Stephen D. O'Connell=soconnell@gc.cuny.edu
 Thomas G. O'Connor=thomas.g.oconnor@nuim.ie
 Eddie Oczkowski=eoczkowski@csu.edu.au
 Kazuhiko Odaki=odaki-kazuhiko@rieti.go.jp
 Giacomo Oddo=giacomo.oddo@bancaditalia.it
 Remy Jean Oddou=remy.oddou@voila.fr
 Maria Ana Odejar=mariaana@ksu.edu
 Martin Odening=m.odening@agrar.hu-berlin.de
 Gianluca Oderda=goderda@pictet.com
 Reto Odermatt=reto.odermatt@unibas.ch
 Nicholas M. Odhiambo=odhianm@unisa.ac.za
 Joe O'Doherty=joeodoherty@gmail.com
 Cathal O'donoghue=cathal.odonoghue@teagasc.ie
 Síle Pádraigín O'Dorchai=sile.odorchai@ulb.ac.be
 Ludovit Odor=odor@rrz.sk
 Gbadebo Olusegun Abidemi Odularu=godularu@live.com
 Pius Odunga=podunga@yahoo.com
 Dr. Jacob Oduor=j.oduor@afdb.org
 Manuel Oechslin=m.oechslin@uvt.nl
 Marc Oeffner=marc.oeffner@web.de
 Iulia Monica Oehler-Şincai=oehler.sincai@gmail.com
 Alwin G. Oerlemans=alwin.oerlemans@apg.nl
 Britta Oertel=b.oertel@izt.de
 Daniel Oesch=daniel.oesch@unil.ch
 Mikhail Victor Oet=mikhail.v.oet@clev.frb.org
 Alexander Oettl=alex.oettl@mgt.gatech.edu
 Avner Offer=avner.offer@all-souls.ox.ac.uk
 Lawrence H. Officer=lofficer@uic.edu
 Masao Ogaki=mogaki@econ.keio.ac.jp
 Kazuhito Ogawa=kz-ogawa@kansai-u.ac.jp
 Kazuo Ogawa=ogawa@iser.osaka-u.ac.jp
 Ryo Ogawa=rogawa@hiroshima-u.ac.jp
 Pelin Oge Guney=pelinoge@hacettepe.edu.tr
 Malgorzata Ogonowska=malgorzata.ogonowska@gredeg.cnrs.fr
 Cormac Ó Gráda=cormac.ograda@ucd.ie
 Claudia Ogrean=claudia.ogrean@ulbsibiu.ro
 Anders Ögren=anders.ogren@ekh.lu.se
 Fethi Ogunc=fethi.ogunc@tcmb.gov.tr
 Kolawole Ogundari=ogundarikolawole@daad-alumni.de
 Eric Kehinde Ogunleye=eric.oleye@yahoo.com
 Ayorinde Joshua Ogunyiola=ayoogunyiola@yahoo.com
 Laudo M. Ogura=ogural@gvsu.edu
 Yoshiaki Ogura=yogura@waseda.jp
 Ayla Ogus Binatli=ayla.ogus@ieu.edu.tr
 Umut Oguzoglu=oguzoglu@cc.umanitoba.ca
 Lee Edward Ohanian=ohanian@econ.ucla.edu
 Hiroshi Ohashi=ohashi@e.u-tokyo.ac.jp
 Ryoji Ohdoi=ohdoi@soc.titech.ac.jp
 Dong-hyun Oh=doriaba2@snu.ac.kr
 Asako Ohinata=ao160@le.ac.uk
 Inha Oh=inha.oh@gmail.com
 Keun-Yeob Oh=kyoh@cnu.ac.kr
 Hannes Öhler=hannes.oehler@awi.uni-heidelberg.de
 Jana Ohls=jana.ohls@bundesbank.de
 Henry Ohlsson=henry.ohlsson@nek.uu.se
 Jörg Ohnemus=ohnemus@zew.de
 Nina Öhrn=nina.ohrn@ifn.se
 Renate Ohr=renate.ohr@wiwi.uni-goettingen.de
 Richard Öhrvall=richard.ohrvall@gmail.com
 Fumio Ohtake=ohtake@iser.osaka-u.ac.jp
 Koki Oikawa=oikawa.koki@gmail.com
 Ioannis Oikonomou=i.oikonomou@icmacentre.ac.uk
 Vlasis Oikonomou=vlasis@jiqweb.org
 Kalu Ojah=kalu.ojah@wits.ac.za
 Paul Ojeaga=paul.ojeaga@covenantuniversity.edu.ng
 Jair N Ojeda=jojedajo@banrep.gov.co
 Gana Ojha=gpojha@gmail.com
 George Okey Oji=george_oji@yahoo.co.uk
 Yasuhisa Ojima=yojima@imf.org
 Misa Okabe=okabe@eco.wakayama-u.ac.jp
 Toshihiro Okada=toshihiro.okada@kwansei.ac.jp
 Masato Okamoto=pfc02714@nifty.com
 Eiji OKANO=eiji_okano@econ.nagoya-cu.ac.jp
 Anna Okatenko=a.okatenko@ucl.ac.uk
 Yohei Okawa=yo3t@email.virginia.edu
 Esin Okay=eokay@iticu.edu.tr
 Nesrin Okay=okay@boun.edu.tr
 Ryosuke Okazawa=okazawa@econ.osaka-cu.ac.jp
 Jose M. O'Kean=jmokean@jmokean.com
 Sue O'Keefe=s.okeefe@latrobe.edu.au
 Tatsuyoshi Okimoto=tatsuyoshi.okimoto@gmail.com
 Godwin Chigozie Okpara,PhD=chigoziegodwino@yahoo.com
 Abigail Mary Okrent=aokrent@ers.usda.gov
 Daniel Fernando Oks=doks@worldbank.org
 Toshihiro Okubo=okubo@econ.keio.ac.jp
 Ryo Okui=okui@kier.kyoto-u.ac.jp
 Adam Okulicz-Kozaryn=adam.okulicz.kozaryn@gmail.com
 Ibrahim M. Okumu=iokumu@fema.mak.ac.ug
 Albert A. Okunade=aokunade@memphis.edu
 Pavel Okunev=pavelokunev@hotmail.com
 Masahiro Okuno-Fujiwara=okuno.fujiwara@gmail.com
 Mahito Okura=okura@nagasaki-u.ac.jp
 Reza Oladi=reza.oladi@usu.edu
 Katrin Olafsdottir=katrino@ru.is
 Norma Olaizola=norma.olaizola@ehu.es
 Tosin Olajide-Alabi=olutosinscorpio@yahoo.com
 Edward Olale=edward.olale@gnb.ca
 Marcelo Olarreaga=marcelo.olarreaga@unige.ch
 Carlos Augusto Olarte Bacares=carlos.olarte-bacares@univ-paris1.fr
 Jon Olaf Olaussen=jon.o.olaussen@hist.no
 Juanita Olaya=juanitaolaya@alumni.ksg.harvard.edu
 Olaolu Richard Olayeni=rolayeni@oauife.edu.ng
 Alexandre Olbrecht=aolbrech@ramapo.edu
 Joanna Olbrys=j.olbrys@pb.edu.pl
 Gonzalo Olcina=gonzalo.olcina@uv.es
 Matt Olczak=m.olczak@aston.ac.uk
 Magdalena Olczyk=magdalena.olczyk@zie.pg.gda.pl
 Alicja Olejnik=olejnika@uni.lodz.pl
 Nilss Olekalns=nilss@unimelb.edu.au
 Nicholas Olenev=nolenev@yahoo.com
 Finn Olesen=finn@business.aau.dk
 Ulugbek Olimov=ulugbek.olimov@gmail.com
 Stephen D. Oliner=stephen.oliner@gmail.com
 Pedro Olinto=polinto@worldbank.org
 Neal H Olitsky=nolitsky@umassd.edu
 Juan Oliva=juan.olivamoreno@uclm.es
 Paulina Oliva=oliva@econ.ucsb.edu
 Maria Olivares=maria.olivares@disneyresearch.com
 Alessandro Vinícius Marques de Oliveira=a.v.m.oliveira@gmail.com
 Ana Oliveira=ahermeto@cedeplar.ufmg.br
 Blandina Oliveira=blandina@estg.ipleiria.pt
 Cristiano Aguiar de Oliveira=cristiano.oliveira@furg.br
 Cristóvão Roberto Lima Oliveira=cristovao.roberto.oliveira@gmail.com
 Fernando Oliveira=oliveira@essec.fr
 Joaquim Oliveira Martins=joaquim.oliveira@oecd.org
 Monica Duarte Oliveira=monica.oliveira@ist.utl.pt
 Tania Oliveira=to20@le.ac.uk
 Pau Olivella=pau.olivella@uab.es
 Michael James Olive=michael.olive@mq.edu.au
 Javier Olivera=javier.olivera@uni.lu
 Mauricio Olivera=moliverag@yahoo.com
 Ester Oliveras=ester.oliveras@upf.edu
 Maria Pia Olivero=maria.olivero@drexel.edu
 Xisco Oliver=xisco.oliver@uib.es
 Claudia Olivetti=olivetti@bu.edu
 Tommaso Oliviero=mroliviero@gmail.com
 Víctor Tiberio Olivo=velocity@cantv.net
 Hélène Ollivier=helene.ollivier@psemail.eu
 Jose Olmo=j.b.olmo@soton.ac.uk
 Lorena Olmos=lolmos@unizar.es
 Corinne McCue Olmsted=cmolmsted@gmail.com
 Olabode Philip Olofin=opolofin@oauife.edu.ng
 Karin Olofsdotter=karin.olofsdotter@nek.lu.se
 Sola Olorunfemi=solafem7@yahoo.co.uk
 Olatomide Waheed Olowa=olowa1@yahoo.com
 Alessandro Olper=alessandro.olper@unimi.it
 Roland Olschewski=roland.olschewski@wsl.ch
 Michaela Ölschläger=oelschlaeger@econ.uni-hamburg.de
 Edgar O. Olsen=eoo@virginia.edu
 Karsten Bjerring Olsen=kbo@gmx.net
 Richard Olsen=richardo@olsen.ch
 Trond E. Olsen=trond.olsen@nhh.no
 Wendy Kay Olsen=wendy.olsen@manchester.ac.uk
 Dennis Olson=dolson@tru.ca
 Lars Olson=lolson@arec.umd.edu
 Amy Rader Olsson=amy.olsson@infra.kth.se
 Martin Olsson=martin.olsson@ifn.se
 Mats Olsson=mats.olsson@ekh.lu.se
 Ola Olsson=ola.olsson@economics.gu.se
 Małgorzata Anna Olszak=molszak@wz.uw.edu.pl
 Krzysztof Olszewski=krzysztof.olszewski@nbp.pl
 Yan Olszewski=yolszewski@hotmail.com
 Dan Olteanu=danolteanu@ince.ro
 Jan-Peter Olters=jolters@worldbank.org
 Dr. Isaac Busayo Oluwatayo=iboluwatayounad@yahoo.com
 Charles P. Oman=charlespoman@gmail.com
 Anna Omarini=anna.omarini@unibocconi.it
 Toman Omar Mahmoud=toman.mahmoud@ifw-kiel.de
 Tolga Omay=omayt@cankaya.edu.tr
 Muhammad Omer=momer110@gmail.com
 Massimo Omiccioli=massimo.omiccioli@bancaditalia.it
 Babatunde Omilola=babatunde.omilola@undp.org
 Olusegun Akin Omisakin=brightolusegun@yahoo.com
 Yasuhiro Omori=omori@e.u-tokyo.ac.jp
 Abdelwahed Omri=abdelomri@gmail.com
 Anis OMRI=omrianis.fsegs@gmail.com
 Dirk-Jan Jacob Omtzigt=domtzigt@princeton.edu
 Pieter Omtzigt=pieter.omtzigt@tweedekamer.nl
 Olugbenga A. Onafowora=onafowor@susqu.edu
 Ozlem Onaran=ozlem.onaran@yahoo.co.uk
 Alexei Onatski=ao319@cam.ac.uk
 Ali Sina Onder=ali-sina.oender@uni-bayreuth.de
 A. Özlem Önder=ozlem.onder@ege.edu.tr
 Harun Onder=honder@worldbank.org
 Sander Onderstal=onderstal@uva.nl
 Janosch Ondraczek=janosch.ondraczek@zmaw.de
 Donal O'Neill=donal.oneill@nuim.ie
 June E O'Neill=june_oneill@baruch.cuny.edu
 Özge Öner=ozge.oner@jibs.hj.se
 Umut Ones=onesumut@yahoo.com
 Cheng Boon Ong=cheng.ong@maastrichtuniversity.nl
 David Ong=dvdng@ucdavis.edu
 Steven Ongena=steven.ongena@bf.uzh.ch
 Vincent Okoth Ongore=vincent.ongore@yahoo.com
 Rachel Ong=r.ong@curtin.edu.au
 Seow Eng Ong=rstongse@nus.edu.sg
 Ayotunde Olawande Oni=ayo.oni@covenantuniversity.edu.ng
 Fabrizio Onida=fabrizio.onida@unibocconi.it
 Kateryna Onishchenko=onishchenkok@cf.ac.uk
 Luisanna Onnis=l.onnis@lancaster.ac.uk
 Hiroshi Ono=hono@tamu.edu
 Masanori Ono=mono@econ.seikei.ac.jp
 Luca Onorante=onorante@yahoo.it
 Massimiliano Gaetano Onorato=massimiliano.onorato@imtlucca.it
 Onori Daria=daria.onori@uniroma1.it
 Tetsuo Ono=tono@econ.osaka-u.ac.jp
 Yukako Ono=yono@fbc.keio.ac.jp
 Tamotsu Onozaki=onozaki@ris.ac.jp
 Jorge Onrubia=jorge.onrubia@ccee.ucm.es
 Esen Onur=esenonur5a@gmail.com
 Erwin Ooghe=erwin.ooghe@econ.kuleuven.be
 Roel C.A. Oomen=roel.ca.oomen@gmail.com
 Nienke Oomes=noomes@imf.org
 Marius Ooms=ooms@econometriclinks.com
 Maarten R.C. van Oordt=m.r.c.van.oordt@dnb.nl
 Frank van Oort=f.vanoort@geo.uu.nl
 Hessel Oosterbeek=h.oosterbeek@uva.nl
 Kim OOSTERLINCK=koosterl@ulb.ac.be
 Adewale Olubukola Oparinde=aoo23@cam.ac.uk
 Matthias Opfinger=opfinger@uni-trier.de
 Timothy P. Opiela=topiela@depaul.edu
 Emmanuel Opoku=emmanuel.opoku@sdstate.edu
 Christian Carsten Opp=opp@wharton.upenn.edu
 Veruska Oppedisano=v.oppedisano@ucl.ac.uk
 Harmen Oppewal=harmen.oppewal@monash.edu
 Marcus M. Opp=mopp@haas.berkeley.edu
 Camelia Oprean=camelia.oprean@ulbsibiu.ro
 Tudor Oprisor=tudor.oprisor@econ.ubbcluj.ro
 Luca David Opromolla=luca.opromolla@nyu.edu
 Musa Orak=musa.orak@tcmb.gov.tr
 Ece Oral=ece.oral@tcmb.gov.tr
 Adil Oran=adiloran@metu.edu.tr
 Ramona (toma) Orastean=torasib@yahoo.com
 Peter Orazem=pfo@iastate.edu
 Hakan Orbay=horbay@sabanciuniv.edu
 Aniceto Orbeta=aorbeta@mail.pids.gov.ph
 Gabriele Orcalli=gabriele.orcalli@unipd.it
 Carlos Ordás Criado=carlos.ordas@ecn.ulaval.ca
 Juan Luis Ordaz Díaz=juan.ordaz@bbva.bancomer.com
 David Orden=d.orden@cgiar.org
 Patrizia Ordine=p.ordine@unical.it
 Keith Ord=ordk@georgetown.edu
 Guillem Ordóñez Calafí=g.ordonez-calafi@warwick.ac.uk
 Guillermo L. Ordonez=ordonez@econ.upenn.edu
 Javier Ordóñez=jmonfort@eco.uji.es
 Pablo Ordóñez=pabloj99@gmail.com
 Luis Orea=lorea@uniovi.es
 Gianluca Orefice=gianluca.orefice@cepii.fr
 Cecilia Oreiro=coreiro@iecon.ccee.edu.uy
 José Luís da Costa Oreiro=jlcoreiro@terra.com.br
 Philip Oreopoulos=oreo@economics.utoronto.ca
 Elsa Orgiazzi=elsaorgiazzi@gmail.com
 Ozgur Orhangazi=ozgur.orhangazi@khas.edu.tr
 Federica Origo=federica.origo@unibg.it
 Jose Carlos Orihuela=orihuela.jc@pucp.edu.pe
 Magali Orillard=magali.orillard@univ-amu.fr
 Anthony Orji=tonyorjiuss@yahoo.com
 Mariam Orkodashvili=morkoda@yahoo.com
 Andreas Orland=andreas.orland@rub.de
 Michael J. Orlando=mjorlando@tulanealumni.net
 Lucjan T. Orlowski=orlowskil@sacredheart.edu
 Cuneyt Orman=cuneytorman@gmail.com
 Wafa Hakim Orman=wafa.orman@uah.edu
 Chris Orme=chris.orme@manchester.ac.uk
 Paul Ormerod=pormerod@volterra.co.uk
 Mihály Ormos=ormos@finance.bme.hu
 Jose Renato Haas Ornelas=jrenato.ornelas@bcb.gov.br
 Filippo Oropallo=oropallo@istat.it
 Kevin Hjortshøj O'Rourke=kevin.orourke@all-souls.ox.ac.uk
 Luis Orozco=luis.orozco-noguera@univ-tlse1.fr
 Athanasios Orphanides=athanasios.orphanides@mit.edu
 Fabrizio Orrego=forregop@gmail.com
 Pia Orrenius=pia.orrenius@dal.frb.org
 Jaime Orrillo=orrillo@pos.ucb.br
 Caroline Orset=caroline.orset@agroparistech.fr
 Evren ORS=ors@hec.fr
 Luigi Orsi=luigi.orsi75@gmail.com
 Kristian Orsini=kristian.orsini@ec.europa.eu
 Raimondello Orsini=raimondello.orsini@unibo.it
 Renzo Orsi=renzo.orsi@unibo.it
 Francois Ortalo-Magne=fom@bus.wisc.edu
 Raquel Ortega-Argiles=r.ortega.argiles@rug.nl
 Bienvenido Ortega=ortega@uma.es
 David Leonardo Ortega=dlortega@msu.edu
 Jaime Ortega=jaime.ortega@uc3m.es
 José Antonio Ortega Osona=jaortega@usal.es
 Matilda Orth=matilda.orth@ifn.se
 Salvador Ortigueira=salvador.ortigueira@uc3m.es
 Luis C. Ortigueira=lcortsan@upo.es
 Pedro Ortín Ángel=pere.ortin@uab.cat
 Alberto Ortiz=ortiz@cemla.org
 Alfredo Sanchez Ortiz=als_so@yahoo.com.mx
 Edgar Ortiz=edgaro@servidor.unam.mx
 Eduardo Ortiz-Juarez=eduardo.ortiz@undp.org
 Marco Antonio Ortiz=marco.ortiz@bcrp.gob.pe
 Aurora Ortiz Nunez=a.ortiz-nunez@lancaster.ac.uk
 Ramon Arigoni Ortiz=ramon_ortiz@ig.com.br
 Alvaro Ortiz=alvaro.ortiz@bbva.com
 Andreas Ortmann=aortmann@yahoo.com
 Karl Michael Ortner=hildegardundkarl@live.com
 Guido Ortona=guido.ortona@sp.unipmn.it
 Vicente Ortun=vicente.ortun@upf.edu
 Vitaliy Oryshchenko=v.oryshchenko@cantab.net
 Gheorghe Orzan=orzang@ase.ro
 Mihai C. Orzan=mihai.orzan@ase.ro
 Sebastian Orzeł=sebastian.orzel@pwr.wroc.pl
 Henrik Orzen=henrik.orzen@uni-mannheim.de
 Witold Orzeszko=vit@umk.pl
 Zeynep Or=or@irdes.fr
 Evans Stephen Osabuohien=stephen.osabuohien@covenantuniversity.edu.ng
 Patrick N. Osakwe=patrick.osakwe@unctad.org
 Thomas Osang=tosang@mail.smu.edu
 Chiara Osbat=chiara.osbat@ecb.int
 Daniel Osberghaus=osberghaus@zew.de
 Lars Osberg=lars.osberg@dal.ca
 Denise Osborn=denise.osborn@manchester.ac.uk
 Martin J. Osborne=martin.osborne@utoronto.ca
 Michael J. Osborne=mo98@sussex.ac.uk
 Theresa Osborne=tosborne19@gmail.com
 Lopez-de-Foronda, Óscar=oscarl@ubu.es
 Kwame Osei-Assibey=kwame.oseiassibey@googlemail.com
 Gbemisola Oseni=goseni@worldbank.org
 Solveig Osborg Ose=solveig.ose@sintef.no
 Ощепков Алексей Юрьевич (Aleksey Oshchepkov)=aoshchepkov@hse.ru
 Magdalena Beata Osinska=emo@umk.pl
 Tokunbo Simbowale Osinubi=tokunbosinubi@yahoo.co.uk
 Ararat Osipian=araratos@yahoo.com
 Ekaterina Osipova=evosipova@hse.ru
 Marina Oskolkova=oskolkovama@gmail.com
 Carol Osler=cosler@brandeis.edu
 Dritan Osmani=dritan.osmani@zmaw.de
 Brian J. Osoba=osobabrj@ccsu.edu
 António Miguel Osório-Costa=superacosta@hotmail.com
 Carlos A. Osorio=carlos.osorio@uai.cl
 Israel Osorio Rodarte=osorio.israel@gmail.com
 M. Pilar Osorno Del Rosal=mosorno@ull.es
 Monica Patricia Ospina=mospina6@eafit.edu.co
 Carlos G. Ospino=cg.ospino20@uniandes.edu.co
 Stein Østbye=stein.ostbye@uit.no
 Emily Oster=emily.oster@chicagobooth.edu
 Charlotte Ostergaard=charlotte.ostergaard@bi.no
 Christian R. Østergaard=cro@business.aau.dk
 Pär Österholm=par.osterholm@konj.se
 Steffen Osterloh=steffen.osterloh@web.de
 Alexander Osterwalder=osterwalder@gmail.com
 Robert Östling=robert.ostling@iies.su.se
 Jonathan David Ostry=jostry@imf.org
 Niall M. O'Sullivan=niall.osullivan@ucc.ie
 Paul O'Sullivan=paul.osullivan@nuim.ie
 Vincent O' Sullivan=vincent.o-sullivan@tcd.ie
 Ruben Osuna=rosuna@cee.uned.es
 Victoria Osuna=vosupad@upo.es
 Ayokunle Anthony Osuntuyi=aosuntuyi@stud.unive.it
 Yvonne Oswald=yvonne.oswald@business.uzh.ch
 Tomáš Otáhal=tomik.otahal@gmail.com
 Masayuki Otaki=ohtaki@iss.u-tokyo.ac.jp
 Rui Ota=rui.ota@cku.ac.jp
 Eric Fosu Oteng-Abayie=efoteng-abayie.socs@knust.edu.gh
 Andrea Otero=aoteroco@live.unc.edu
 Jesus Otero=jesus.otero@urosario.edu.co
 Susana Álvarez Otero=saotero@uniovi.es
 Jamal Othman=jortman@ukm.my
 TENOVICI Cristina Otilia=cris2001vl@yahoo.com
 Inci Ötker-Robe=iotker@imf.org
 Conor M. O'Toole=conor.otoole@esri.ie
 Cristina Otovescu=otocris@yahoo.com
 Edoardo Otranto=eotranto@unime.it
 Christopher Otrok=otrokc@missouri.edu
 Hironori Otsubo=hiroecon@gmail.com
 Akihiro Otsuka=akihiro@criepi.denken.or.jp
 Keijiro Otsuka=otsuka@grips.ac.jp
 Keisuke Otsu=k.otsu@kent.ac.uk
 Tsunehiro Otsuki=otsuki@osipp.osaka-u.ac.jp
 Marco Ottaviani=marco.ottaviani@unibocconi.it
 Gianmarco I.P. Ottaviano=g.i.ottaviano@lse.ac.uk
 Jordan Otten=jotten@rsm.nl
 Sebastian Otten=sebastian.otten@rwi-essen.de
 Steffen Otterbach=steffen.otterbach@uni-hohenheim.de
 Katarina Ott=kott@ijf.hr
 Lesli S. Ott=lesli.ott@yale.edu
 Adrian Ottnad=kontakt@ottnad-consult.de
 Anne Otto=anne.otto@iab.de
 Stefania Ottone=stefania.ottone@unimib.it
 Rachid Ouafi=rachid_ouafi@hotmail.com
 Bazoumana Ouattara=osman.ouattara-2@manchester.ac.uk
 Amine Ouazad=amine.ouazad@insead.edu
 Yasunori Ouchida=ouchida@hiroshima-u.ac.jp
 Joel OUDINET=joel.oudinet@univ-paris13.fr
 Dongshu Ou=dongshu@cuhk.edu.hk
 Salmata OUEDRAOGO=salmata.ouedraogo@uqac.ca
 Pierre Ouellette=ouellette.pierre@uqam.ca
 Walid Oueslati=walid.oueslati@agrocampus-ouest.fr
 Christine Oughton=co12@soas.ac.uk
 Pepita Ould Ahmed=pepita.ould@gmail.com
 Jacques Ould Aoudia=jacques.ould-aoudia@dbmail.com
 Nassim Oulmane=oulmane@un.org
 Nicholas Oulton=n.oulton@lse.ac.uk
 Sothea Oum=sothea.oum@eria.org
 Guzmán Ourens=guzman@decon.edu.uy
 Awatef Ourir=ourirawatef@yahoo.fr
 Ingo Outes-Leon=ingo.outes-leon@economics.ox.ac.uk
 歐陽遠芬 (Alice Y. Ouyang)=alice.ouyang@gmail.com
 Min Ouyang=ouyangm@sem.tsinghua.edu.cn
 Zhengjie Ouyang=ouyangzhengjie@126.com
 Rachida Ouysse=rouysse@unsw.edu.au
 Zhirong Ou=zhirong_ou@hotmail.com
 A. Mead Over=mover@cgdev.org
 Per Baltzer Overgaard=povergaard@econ.au.dk
 Jody Robert Overland=jody.overland@gmail.com
 Henry G. Overman=h.g.overman@lse.ac.uk
 Juan Daniel Oviedo=juan.oviedo@urosario.edu.co
 P. Marcelo Oviedo=marcelo@oviedos.net
 Arnstein Ovrum=arnsteinovrum@gmail.com
 Alexei V. Ovtchinnikov=ovtchinnikov@hec.fr
 Marcin Owczarczuk=mo23628@sgh.waw.pl
 Ann L. Owen=aowen@hamilton.edu
 Bruce M. Owen=bmowen@stanford.edu
 Dorian Owen=dowen@business.otago.ac.nz
 David M. Owens=dowens@haverford.edu
 Emily Greene Owens=ego5@cornell.edu
 Trudy Owens=trudy.owens@nottingham.ac.uk
 Anthony Adekunle Owojori=tonygay_1@yahoo.com
 Yaw Owusu-Ansah=yao2103@columbia.edu
 Emmanuel Owusu-Sekyere=eowususekyere67@gmail.com
 Michael T. Owyang=michael.t.owyang@stls.frb.org
 Joanne E. Oxley=oxley@rotman.utoronto.ca
 Les Oxley=lesoxley@gmail.com
 Robert J. Oxoby=oxoby@ucalgary.ca
 Daisuke Oyama=oyama@e.u-tokyo.ac.jp
 Rasheed Oyaromade=rasheedoya@yahoo.com
 Abayomi Samuel Oyekale=asoyekale@yahoo.com
 Oyebanji Oyelaran-Oyeyinka=oyeyinka@intech.unu.edu
 Paul Oyer=pauloyer@stanford.edu
 Mutiu Abimbola Oyinlola=mutiu_oyinlola@yahoo.com
 Ömer Özak=ozak@smu.edu
 Fatih Ozatay=fatih.ozatay@etu.edu.tr
 Erkut Y. Ozbay=ozbay@umd.edu
 Pınar Özbay Özlü=pinar.ozbay@tcmb.gov.tr
 Hüseyin Murat Özbilgin=murat.ozbilgin@tcmb.gov.tr
 Fatih Cemil Ozbugday=fcbugday@gmail.com
 Nil OZCAGLAR-TOULOUSE=nil.toulouse@univ-lille2.fr
 Berkay Özcan=b.ozcan@lse.ac.uk
 Gul Berna Ozcan=g.ozcan@rhul.ac.uk
 Gulserim Ozcan=gulserim@bilkent.edu.tr
 Durmus ozdemir=dozdemir@bilgi.edu.tr
 Ozlem Ozdemir=yozlem@metu.edu.tr
 Emre Ozdenoren=eozdenoren@london.edu
 Gökhan özer=ozer@gyte.edu.tr
 Gokhan Ozertan=ozertan@boun.edu.tr
 Onur Ozgur=onur.ozgur@mbs.edu
 Ipek Ozkal-Sanver=isanver@bilgi.edu.tr
 Serdar Ozkan=ozkan@alumni.upenn.edu
 Ata Ozkaya=ataozk@yahoo.com
 Umit Ozlale=umit.ozlale@tepav.org.tr
 Berk Özler=berk.ozler@otago.ac.nz
 Müge Ozman=muge.ozman@it-sudparis.eu
 Utku Ozmen=utkuozmen@gmail.com
 Suleyman Ozmucur=ozmucur@ssc.upenn.edu
 Đurđana Ozretić Došen=dozretic@efzg.hr
 Han Nazmi Ozsoylev=han.ozsoylev@sbs.ox.ac.uk
 Mehmet Fatih Öztek=oztek@metu.edu.tr
 Ilhan Ozturk=ilhanozturk@yahoo.com
 Harun Ozturkler=ozturkler@aku.edu.tr
 Orgul Demet Ozturk=odozturk@moore.sc.edu
 Alper Ozun=alper.ozun@isbank.com.tr
 Evren Ozus=evrenozus@gmail.com
 Ataman Ozyildirim=ataman.ozyildirim@conference-board.org
 Selcuk Ozyurt=ozyurt@sabanciuniv.edu
