 Ada Ma=pec187@gmail.com
 Nadia Mâagli=maagli.nadia@gmail.com
 Thomas Maag=thomas.maag@snb.ch
 Paul Maarek=paul.maarek@u-cergy.fr
 Emiel Maasland=emaasland@ese.eur.nl
 Esfandiar Maasoumi=esfandiar.maasoumi@emory.edu
 Niku Määttänen=niku.maattanen@etla.fi
 Edwin Darrell Maberly=rmaberly@yahoo.com.au
 Athur Mabiso=a.mabiso@cgiar.org
 Mohamed BenRida Mabrouk=m_b_r_mabrouk@yahoo.fr
 Ramzi Mabsout=rm95@aub.edu.lb
 Molly K. Macauley=macauley@rff.org
 Corrado Macchiarelli=c.macchiarelli@lse.ac.uk
 Rocco Macchiavello=r.macchiavello@warwick.ac.uk
 Patricia Macchi=pmacchi@nathaninc.com
 Louis John Maccini=maccini@jhu.edu
 Glenn MacDonald=macdonald@olin.wustl.edu
 Robert D. Macdonald=rdmac@unimelb.edu.au
 Ronald MacDonald=ronald.macdonald@gla.ac.uk
 Ryan Macdonald=ryan.macdonald@statcan.gc.ca
 Sean Patrice MacDonald=smacdonald@citytech.cuny.edu
 Joseph MacDougald=jjmacdou@usf.edu
 Daniel Maceira=danielmaceira@cedes.org
 Megan MacGarvie=mmacgarv@bu.edu
 James MacGee=jmacgee@uwo.ca
 Ana Flávia Machado=afmachad@cedeplar.ufmg.br
 Joël Machado Carneiro=joel.machado@uclouvain.be
 Danielle Carusi Machado=dani_carusi@hotmail.com
 Fernando Sobral Machado=fmachado@clsbe.lisboa.ucp.pt
 Matilde P. Machado=matilde.machado@uc3m.es
 Chia-Ying Ma=cyma@scu.edu.tw
 Carlos Gustavo Machicado Salas=cmachicado@inesad.edu.bo
 Alejandra Machín=alejandramachin@hotmail.com
 Mark Machina=mmachina@ucsd.edu
 Ching-to Albert Ma=ma@bu.edu
 Stephen Machin=s.machin@ucl.ac.uk
 Ines Macho-Stadler=ines.macho@uab.es
 Zuzana Machova=zuzana.machova@vsb.cz
 Moshé Machover=moshe.machover@kcl.ac.uk
 Chunbo Ma=chunbo.ma@uwa.edu.au
 Liliana Alicia Macian de Barbieri=lbarbieri@face.unt.edu.ar
 Marta Macias=marta.macias@uc3m.es
 Katarzyna Maciejowska=katarzyna.maciejowska@pwr.wroc.pl
 Alison Macintyre=alison.macintyre@qut.edu.au
 Mario Macis=mmacis@jhu.edu
 Bret Mackay=bretm@afconnect.com
 Daniel Mackay=dmackay@richmond.edu
 Andrew Kenneth Mackenzie=andrew.k.mackenzie@gmail.com
 George Alexander (Sandy) Mackenzie=sandymackenzie50@gmail.com
 Ian A. MacKenzie=i.mackenzie@uq.edu.au
 Michal Mackiewicz=mackiewicz@poczta.fm
 James MacKinnon=jgm@econ.queensu.ca
 Bartosz Maćkowiak=bartosz.mackowiak@ecb.int
 Piotr Maćkowiak=p.mackowiak@ue.poznan.pl
 Donald MacLaren=d.maclaren@unimelb.edu.au
 Lindsey A. Macmillan=l.macmillan@ioe.ac.uk
 Ross Macmillan=ross.macmillan@unibocconi.it
 William David MacMillan=wmacmill@umich.edu
 David A. Macpherson=david.macpherson@trinity.edu
 C. Duncan MacRae=cduncanm@gmail.com
 Elizabeth Chase MacRae=ecmacrae@alum.mit.edu
 Joseph Macri=jmacri@efs.mq.edu.au
 Diane J. Macunovich=diane_macunovich@redlands.edu
 Zurini Madalina=madalina.zurini@gmail.com
 Regina Madalozzo=reginam@insper.edu.br
 Fabio A. Madau=famadau@uniss.it
 Angela Maddaloni=angela.maddaloni@ecb.europa.eu
 David Madden=david.madden@ucd.ie
 John Robert Madden=john.madden@vu.edu.au
 David James Maddison=d.j.maddison@bham.ac.uk
 Joao Madeira=joao.madeira@york.ac.uk
 Andreas Madestam=andreas.madestam@ne.su.se
 Subramaniam Madheswaran=madhes.hina@gmail.com
 Zagros Madjd-Sadjadi=sadjadizm@wssu.edu
 Reinhard Madlener=rmadlener@eonerc.rwth-aachen.de
 Yahya M. Madra=ymadra@boun.edu.tr
 Cristina Madrid=cristina.madrid.lopez@gmail.com
 Jakob B. Madsen=jakob.madsen@monash.edu
 Per Kongshøj Madsen=pkm@epa.aau.dk
 Leonardo Madureira=llm17@case.edu
 Wolfgang Maennig=wolfgang.maennig@wiso.uni-hamburg.de
 Konstantijn Maes=stan.maes@ec.europa.eu
 Ottar Mæstad=ottar.mestad@cmi.no
 Feng Ma=mafeng575@gmail.com
 Marco Maffezzoli=marco.maffezzoli@unibocconi.it
 Anna Maffioletti=anna.maffioletti@unito.it
 Alessandro Maffioli=alessandrom@iadb.org
 Elham Mafi-Kreft=emafikre@indiana.edu
 Taiwo Ejiola Mafimisebi=temafis@yahoo.com
 Stefano Magagnoli=stefano.magagnoli@unipr.it
 Felipe Nunes Coelho Magalhães=felmagalhaes@yahoo.com.br
 Manuela Magalhães=mane.magalhaes@gmail.com
 Marcelo Marques de Magalhães=marcelo.marques.magalhaes@gmail.com
 Matheus Albergaria de Magalhães=matheus.ijsn@gmail.com
 Laura Magazzini=laura.magazzini@univr.it
 Cosimo Magazzino=cosimo.magazzino@uniroma3.it
 Iga Magda=iga.magda@sgh.waw.pl
 Brice Magdalou=brice.magdalou@univ-montp1.fr
 Marcin Magdziarz=marcin.magdziarz@pwr.wroc.pl
 Gary Bryan Magee=gary.magee@monash.edu
 Lonnie Magee=magee@mcmaster.ca
 Arvind Nathan Magesan=arvindmagesan@gmail.com
 Elena Maggi=elena.maggi@uninsubria.it
 Daniela Maggioni=d.maggioni@univpm.it
 Mario A. Maggioni=mario.maggioni@unicatt.it
 Alessandro Magi=a.magi@unibo.it
 Antonio Magliulo=antonio.magliulo@luspio.it
 Thierry Magnac=thierry.magnac@tse-fr.eu
 Michel Magnan=michel.magnan@concordia.ca
 Nicholas Magnan=nmagnan@uga.edu
 Carlo Alberto Magni=magni@unimo.it
 Alessandro Magnoli Bocchi=alessandro.magnoli.bocchi@gmail.com
 Jan R. Magnus=magnus@uvt.nl
 Leandro Maschietto Magnusson=leandro.magnusson@uwa.edu.au
 Emiliano Magrini=emiliano.magrini@ec.europa.eu
 Marie-Benoit MAGRINI=mbmagrini@toulouse.inra.fr
 Stefano Magrini=smagrini@unive.it
 Silvia Magri=silvia.magri@bancaditalia.it
 Edurne Magro=edurne.magro@orkestra.deusto.es
 Jeremy R. Magruder=jmagruder@berkeley.edu
 Kelly Brown Maguire=maguire.kelly@epa.gov
 Gyula Magyarkuti=magyarkuti@uni-corvinus.hu
 Jugal Mahabir=jugal.mahabir@me.com
 Renuka Mahadevan=r.mahadevan@uq.edu.au
 Putu Anom Mahadwartha=anomania@gmail.com
 Prashanth Mahagaonkar=mahagaonkaroffice@gmail.com
 Vidya Mahambare=vmahambare@crisil.com
 Ismael MAHAMOUD=ismael.mahamoud@gmail.com
 Elizabeth Ann Maharaj=ann.maharaj@monash.edu
 Keshav Lall Maharjan=mkeshav@hiroshima-u.ac.jp
 Philippe Mahenc=philippe.mahenc@univ-montp1.fr
 Hengyun Ma=h.y.ma@163.com
 John M. Maheu=maheujm@mcmaster.ca
 Benedictus Raksaka Mahi=mahi@indo.net.id
 Jai Mah=mahsong@hotmail.com
 Bernhard Mahlberg=bernhard.mahlberg@wu.ac.at
 Jörg C. Mahlich=joerg.mahlich@gmail.com
 Kornel Mahlstein=kornel.mahlstein@gmail.com
 Ali Hussein Mahmood Al-Obaidi=ali.alobaidi81@yahoo.com
 Asif Mahmood=asif.1210@gmail.com
 Haider Mahmood=haidermahmood@hotmail.com
 Haroon Mahmood=haroonmahmood29@gmail.com
 Tariq Mahmood=tariqpide@yahoo.com
 Wan Mansor Mahmood=dwanmans@tganu.uitm.edu.my
 Zafar Mahmood=zafarmah@gmail.com
 Ashraf Abd Elaal Mahmoud=abd.el.aal@economia.uniroma2.it
 Babak Mahmoudi=babak.mahmoudi@nu.edu.kz
 Hassan Mahmud=madakihassan@yahoo.co.uk
 Minhaj Mahmud=minhajmahmud@gmail.com
 Muhammad Mahmud=alhussain_43@yahoo.com
 Hong Ma=mahong@sem.tsinghua.edu.cn
 Stephane Mahuteau=stephane.mahuteau@flinders.edu.au
 Moogdho Mim Mahzab=moogdho@bids.org.bd
 Maria João Maia=mj.maia@campus.fct.unl.pt
 Florin G. Maican=florin.maican@economics.gu.se
 Gunther Maier=gunther.maier@wu-wien.ac.at
 Mark H. Maier=mmaier@glendale.edu
 Philipp Maier=pmaier@yahoo.com
 Frank P. Maier-Rigaud=maier-rigaud@microeconomics.de
 Rolf Maier=rolf.maier@olbes.eu
 Ornella Wanda Maietta=maietta@unina.it
 Joseph Mai=jkonmak1208@gmail.com
 George J. Mailath=gmailath@econ.upenn.edu
 Stephen Mailu=sshierom@hotmail.com
 Yasheng Maimaiti=yasheng96@hotmail.com
 Claire Mainguy=claire.mainguy@unistra.fr
 Andrew Mair=dramair@yahoo.com
 Jacques MAIRESSE=mairesse@ensae.fr
 Dibyendu Maiti=mdibyendu@yahoo.com
 Biswajit Maitra=b_moitra@yahoo.com
 Pushkar Maitra=pushkar.maitra@buseco.monash.edu.au
 Sudeshna Maitra=smaitra@econ.yorku.ca
 Elodie Maitre D'Hotel=elodie.maitredhotel@cirad.fr
 J. Carles Maixé-Altés=maixe@udc.es
 Yinhua Hua Mai=yinhua.mai@buseco.monash.edu.au
 Boris Majcen=majcenb@ier.si
 Muhammad Tariq Majeed=mtmqau@hotmail.com
 Ingrid Majerová=majerova@opf.slu.cz
 Jie Ma=pkujiema@gmail.com
 Jinpeng Ma=jinpeng@crab.rutgers.edu
 Antonio Majocchi=antonio.majocchi@unipv.it
 Raju Majumdar=rajumdar@gmail.com
 Sumit K Majumdar=majumdar@utdallas.edu
 Md. Alauddin Majumder=aldn786@yahoo.com
 Rajarshi Majumder=meriju@rediffmail.com
 A. H. Makame=ahasnuu@hotmail.com
 Svetlana Makarova=makarova@eu.spb.ru
 Dmitry Makarov=dmakarov@nes.ru
 Krzysztof Makarski=kmakar@sgh.waw.pl
 Paul Makdissi=paul.makdissi@uottawa.ca
 Henry Mak=makh@iupui.edu
 Farid Makhlouf=farid.makhlouf@esc-pau.fr
 Taneli Mäkinen=taneli.makinen@esterni.bancaditalia.it
 István Mák=maki@mnb.hu
 Donald Makoka=donmakoka@yahoo.co.uk
 Michael Douglas Makowsky=mikemakowsky@gmail.com
 Kossi Makpayo=makpayo@beaconhill.org
 Yuri Maksimenko=yumax@nm.ru
 Svitlana V. Maksymenko=maks@pitt.edu
 Olukayode Emmanuel Maku=kaymarks73@yahoo.co.uk
 Sergey Malakhov=smalahov@df.ru
 Semyon Malamud=semyon.malamud@epfl.ch
 Anup Malani=amalani@uchicago.edu
 Paul H. Malatesta=phmalat@u.washington.edu
 Nikolaj Malchow-Møller=nmm@sam.sdu.dk
 James Malcomson=james.malcomson@economics.ox.ac.uk
 Darío Maldonado=dario.maldonado@urosario.edu.co
 Jorge Higinio Maldonado=jmaldona@uniandes.edu.co
 Norman Maldonado=normanmva@gmail.com
 Wilfredo Leiva Maldonado=wilfredo@pos.ucb.br
 Peter Malec=malecpet@hu-berlin.de
 Franco Malerba=franco.malerba@unibocconi.it
 Hector E. Maletta=hmaletta@fibertel.com.ar
 Jean Jacques MALFAIT=jean-jacques.malfait@u-bordeaux4.fr
 Marco Malgarini=marco.malgarini@anvur.org
 Frédéric Malherbe=fmalherbe@london.edu
 Franck MALHERBET=franck.malherbet@ensae.fr
 Nisha Malhotra=nishamalhot@gmail.com
 Christopher Malikane=christopher.malikane@wits.ac.za
 Hamza Ali Malik=hamza.malik@sbp.org.pk
 Muhammad Jahanzeb Malik=jazee_malik@yahoo.co.in
 Muhammad Nasir Malik=mnmalik@gmail.com
 Emir Malikov=emalikov@binghamton.edu
 Saif Ullah Malik=saifullah_142@yahoo.com
 Wasim Shahid Malik=wmalik11@yahoo.com
 Robert Malina=robert.malina@wiwi.uni-muenster.de
 Benjamin Andrew Malin=benjamin.malin@mpls.frb.org
 Tuomas Malinen=tuomas.malinen@helsinki.fi
 Eric Malin=eric.malin@univ-rennes1.fr
 Katya Malinova=katya.malinova@utoronto.ca
 Mika Maliranta=mika.maliranta@etla.fi
 Julien Malizard=julien.malizard@univ-montp1.fr
 Elli Malki=malki@netmedia.net.il
 Graham Mallard=gm@marlboroughcollege.org
 Thilak Mallawaarachchi=t.mallawaarachchi@uq.edu.au
 Jim Malley=jim.malley@glasgow.ac.uk
 Juliette Malley=j.n.malley@lse.ac.uk
 Anastasios G. Malliaris=tmallia@luc.edu
 Dimitrios Malliaropulos=dmalliaropulos@bankofgreece.gr
 Debdulal Mallick=dmallic@deakin.edu.au
 Iftekhar Mallick=research.if@gmail.com
 Indrajit Mallick=imallick5@gmail.com
 Sushanta K. Mallick=s.k.mallick@qmul.ac.uk
 Vootla Mallikarjuna=v.mallik@yahoo.com
 Mindy Lyn Mallory=mallorym@illinois.edu
 Christopher James Malloy=cmalloy@hbs.edu
 Enrico Mallucci=e.mallucci@lse.ac.uk
 Ulrike Malmendier=ulrike@econ.berkeley.edu
 Miguel A. Malo=malo@usal.es
 William F. Maloney=wmaloney@worldbank.org
 Claudio Malpede=cmalpede@tiscali.it
 Stephen Malpezzi=smalpezzi@bus.wisc.edu
 John A. Maluccio=john.maluccio@middlebury.edu
 David A. Malueg=david.malueg@ucr.edu
 Ricardo Paes Mamede=ricardo.mamede@iscte.pt
 Arseny Mamedov=mamedov@iet.ru
 Jeyhun Mammadov=jmammadov@hotmail.de
 Rufat Mammadov=rmammadov@qu.edu.az
 Mikhail Mamonov=mmamonov@forecast.ru
 Dawood Mamoon=dmamoon@gmail.com
 Theofanis P. Mamuneas=mamuneas@ucy.ac.cy
 Marco Manacorda=m.manacorda@qmul.ac.uk
 Matthieu Manant=matthieu.manant@u-psud.fr
 Francesco Manaresi=manaresi@gmail.com
 Constantine Manasakis=manasakis@uoc.gr
 Arnaud Manas=arnaud.manas@banque-france.fr
 Paolo Manasse=paolo.manasse@unibo.it
 María Jesús Mancebón-Torrubia=mjmance@unizar.es
 Tomás Mancha-Navarro=tomas.mancha@uah.es
 Miriam Manchin=m.manchin@ucl.ac.uk
 Susanna Mancinelli=susanna.mancinelli@unife.it
 Anna Laura Mancini=annalaura.mancini@gmail.com
 Massimo Mancini=mmancini@istat.it
 Lisa Mancino=lmancino@ers.usda.gov
 Maria Luisa Mancusi=marialuisa.mancusi@unicatt.it
 Paolo Mancuso=paolo.mancuso@uniroma2.it
 Subhasis Mandal=subhasis2006@gmail.com
 Antoine Mandel=antoine.mandel@univ-paris1.fr
 Benjamin R. Mandel=benjamin.mandel@citi.com
 Gershon Mandelker=mandelke@katz.pitt.edu
 Lewis Mandell=lewmandell@yahoo.com
 Svante Mandell=svante.mandell@vti.se
 Federico S. Mandelman=federico.mandelman@atl.frb.org
 Philipp Mandel=mandel@wifa.uni-leipzig.de
 Adrian Paul Mander=adrian.mander@mrc-bsu.cam.ac.uk
 Edward John Manderson=edward.manderson@manchester.ac.uk
 Alex (Alexandros) Mandilaras=a.mandilaras@surrey.ac.uk
 Martin Mandler=martin.mandler@bundesbank.de
 Michael Mandler=m.mandler@rhul.ac.uk
 Giovanni Mandras=gmandras@uniss.it
 Ferran Mane=ferran.mane@urv.cat
 Fabio Maria Manenti=fabio.manenti@unipd.it
 Matteo Manera=matteo.manera@unimib.it
 Cristiana Manescu=cristiana.manescu@ecb.int
 Simone Manganelli=simone.manganelli@ecb.int
 Andrea Mangani=mangani@sp.unipi.it
 John Mangan=j.mangan@economics.uq.edu.au
 Ivan Mangatchev=mangatchev@gmail.com
 Constantin Mang=mang@ifo.de
 Esa Mangeloja=eman@econ.jyu.fi
 Stefan Mangelsdorf=stefan.mangelsdorf@googlemail.com
 Vincent N. Mangematin=vincent.mangematin@grenoble-em.com
 Christian Manger=mail@christian-manger.de
 Lucia Mangiavacchi=lucia.mangiavacchi@uib.es
 Sephorah Mangin=sephorah.mangin@monash.edu
 Peter Maniloff=maniloff@mines.edu
 Ning Ma=nma@jhu.edu
 Francois Paul Maniquet=francois.maniquet@uclouvain.be
 Sunil Mani=mani@cds.ac.in
 Ganesh Manjhi=ganeshtrx@gmail.com
 Miguel Manjon Antolin=miguel.manjon@urv.cat
 Selim Mankaï=selimmankai@yahoo.fr
 Jochen Mankart=jochen.mankart@unisg.ch
 N. Gregory Mankiw=ngmankiw@harvard.edu
 James Gerald Manley=jamesmanley32@gmail.com
 Ester Manna=ester.manna1@gmail.com
 Catherine L. Mann=clmann@brandeis.edu
 Philip Henry Manners=pmanners@thecie.com.au
 Daniel Fabio Mannfeld=mannfeld@ifo.de
 Alan Manning=a.manning@lse.ac.uk
 Elizabeth Sophie Mary Manning=elizabem@deakin.edu.au
 Julian R A Manning=julian.r.a.manning@gmail.com
 Richard Manning=richardmanning1943@gmail.com
 Willard G. Manning=w-manning@uchicago.edu
 Stefan Mann=stefan.mann@art.admin.ch
 Steven C. Mann=s.mann@tcu.edu
 Alexandru Manole=alexandru.manole@gmail.com
 Dayanand Manoli=dsmanoli@austin.utexas.edu
 Basil Manos=manosb@agro.auth.gr
 Michael Manove=manove@bu.edu
 Iourii Manovskii=manovski@econ.upenn.edu
 Yukichi MANO=yukichi.mano@gmail.com
 Somprawin Manprasert=somprawin.m@chula.ac.th
 Justo Manrique=manriquej@uhd.edu
 Charles Manski=cfmanski@northwestern.edu
 Abdalla Mansour=abmansour@yahoo.com
 Hani Mansour=hani.mansour@ucdenver.edu
 Mario Mansour=mmansour@imf.org
 Wael Mansour=wmansour@worldbank.org
 Kristofer Månsson=kristofer.mansson@jibs.hj.se
 Erin T. Mansur=erin.mansur@dartmouth.edu
 Ghazala Mansuri=gmansuri@worldbank.org
 Kasim Mansur=kmansur@ums.edu.my
 Panagiotis Mantalos=mantalos04@yahoo.se
 Brian Mantel=brian.mantel@chi.frb.org
 Cesar Mantilla=cesar.mantilla@iast.fr
 Francesco Mantino=mantino@inea.it
 Andrea Mantovani=a.mantovani@unibo.it
 Marco Mantovani=marco.mantovani@unimib.it
 Noemi Mantovan=n.mantovan@bangor.ac.uk
 Andrea Mantovi=andrea.mantovi@unipr.it
 Baltasar Manzano=bmanzano@uvigo.es
 Giancarlo Manzi=giancarlo.manzi@unimi.it
 Paola Manzini=paola.manzini@st-andrews.ac.uk
 Massimo Manzin=massimo.manzin@fm-kp.si
 Anna Manzoni=anna.manzoni@gmail.com
 François Maon=f.maon@ieseg.fr
 Yishay David Maoz=yishayma@openu.ac.il
 Dennis Sioson Mapa=csmapa@up.edu.ph
 Carlos Patricio Maquieira=cmaquieira@mqa.cl
 Eugenia Ramona Mara (Nandra)=ramonanandra@yahoo.com
 Valeriy Marakulin=marakulv@gmail.com
 Gastón Marando=gaston.marando@gmail.com
 Francesco Marangon=marangon@uniud.it
 John Marangos=marangosjohn@gmail.com
 Iavor Marangozov=i.marangozov@gmail.com
 Marani Ugo=marani@unina.it
 Antonio Marasco=amara05@yahoo.com
 Luigi Marattin=luigi.marattin@unibo.it
 Agustin Maravall=maravall@bde.es
 Alessandro Maravalle=alessandro.maravalle@eui.eu
 Carlos Maravall Rodriguez=cmaravall@ie.edu
 Emerson Fernandes Marçal=efmarcal@gmail.com
 Luis Teodoro Marcano=lmarcano@iadb.org
 Stefania Marcassa=stefania.marcassa@u-cergy.fr
 Gianluca Marcato=g.marcato@reading.ac.uk
 Nicolas Marceau=marceau.nicolas@uqam.ca
 Mario Marcel=mario.marcel@oecd.org
 Darwin Marcelo=hesmanibus@yahoo.com
 Oscar Marcenaro Gutierrez=odmarcenaro@uma.es
 Joseph Marchand=jmarchan@ualberta.ca
 Nadège Marchand=marchand@gate.cnrs.fr
 Sébastien Marchand=sebastien.marchand@udamail.fr
 Thierry Marchant=thierry.marchant@ugent.be
 Carla Marchese=carla.marchese@sp.unipmn.it
 Alessandro Marchesiani=marchesiani@gmail.com
 Silvia Marchesi=silvia.marchesi@unimib.it
 Enrico Marchetti=enrico.marchetti@uniparthenope.it
 Andrea Marchini=andrea.marchini@unipg.it
 Francesco Marchionne=francesco.marchionne@ntu.ac.uk
 Luca Marchiori=luca.marchiori@bcl.lu
 Richard March=rmarch2@netzero.net
 Daniel Marcin=dmarcin@umich.edu
 John George Marcis=jmarcis@coastal.edu
 Alan C. Marco=alan.marco@uspto.gov
 Luc MARCO=luc.marco@univ-paris13.fr
 Giuseppe Marcon=giumar@unive.it
 Daniela Marconi=daniela.marconi@bancaditalia.it
 Gabriele Marconi=g.marconi@maastrichtuniversity.nl
 Nelson Marconi=nelson.marconi@fgv.br
 Francisco Marco-Serrano=fmarco@kproductivity.com
 Francisco Marcos=francisco.marcos@ie.edu
 Miguel Ángel Marcos Calvo=miguel.marcos@urjc.es
 Dave E. Marcotte=marcotte@umbc.edu
 David William Marcouiller=dwmarcou@wisc.edu
 Philippe Marcoul=marcoul@ualberta.ca
 Edoardo Marcucci=edoardo.marcucci@tlc.uniroma3.it
 Juri Marcucci=juri.marcucci@gmail.com
 Carmen Marcuello=cmarcue@unizar.es
 Jan Marcus=jmarcus@diw.de
 Maria Cristina Marcuzzo=cristina.marcuzzo@uniroma1.it
 Martyna Marczak=marczak@uni-hohenheim.de
 Cristian Mardones Poblete=crismardones@udec.cl
 Jian Mardukhi=jmardukh@interchange.ubc.ca
 Kevin Maréchal=kevin.marechal@ulb.ac.be
 Michel André Maréchal=michel.marechal@econ.uzh.ch
 David Christopher Maré=dave.mare@motu.org.nz
 Philipp Marek=philipp.marek@iwh-halle.de
 Luigi Marengo=luigi.marengo@sssup.it
 Bertrand Mareschal=bmaresc@ulb.ac.be
 Andrea Marescotti=andrea.marescotti@unifi.it
 Stéphan Marette=stephan.marette@agroparistech.fr
 Philip S. Marey=philip.marey@rabobank.com
 Laurence Marfaing=marfaing@giga-hamburg.de
 Roberto Marfè=roberto.marfe@unil.ch
 Marfouk=a.marfouk@skynet.be
 Patrizia Margani=pmargani@istat.it
 Radu Mărginean=marginean.radu23@yahoo.com
 Silvia Cristina Marginean=silvia_marginean@yahoo.com
 Francisco Marhuenda=marhuend@eco.uc3m.es
 José R. Maria=jfrmaria@bportugal.pt
 Yohannes Mariam=ymariam@opc-dc.gov
 Fabio Mariani=fabio.mariani@uclouvain.be
 Marco Mariani=marco.mariani@irpet.it
 Nastase Marian=cnesmc@yahoo.com
 Roberto S. Mariano=mariano@econ.upenn.edu
 Olivier Marie=o.marie@maastrichtuniversity.nl
 Sivakumar Marimuthu=sivakumarmarimuthu@yahoo.co.in
 Marius Corneliu Marinas,=marinasmarius@yahoo.fr
 Dalia Marin=dalia.marin@lrz.uni-muenchen.de
 Nicoletta Marinelli=nicoletta.marinelli@unimc.it
 Ioana Elena Marinescu=ioana.marinescu@gmail.com
 Nicolae Marinescu=nicu.marinescu@gmail.com
 Giovanni Marin=g.marin@ceris.cnr.it
 Carlos Fonseca Marinheiro=marinheiro@fe.uc.pt
 Annalisa Marini=marinia@sas.upenn.edu
 Mario Mariniello=mario.mariniello@bruegel.org
 Giancarlo Marini=marini@uniroma2.it
 Giorgia Marini=giorgia.marini@uniroma1.it
 Marco Marini=marini@dis.uniroma1.it
 Jose M. Marin=josemaria.marin@uc3m.es
 Anthony M Marino=amarino@usc.edu
 Marianna Marino=marianna.marino@epfl.ch
 Eduard Vasilev Marinov=eddie.marinov@gmail.com
 Georgi Marinov=georgi.marinov@gmail.com
 Rosen Marinov=rosen.marinov@graduateinstitute.ch
 Jaqueline Marins=jaqueline.terra@bcb.gov.br
 Solange Regina Marin=solmarin@gmail.com
 Marco Marinucci=marco.marinucci@bancaditalia.it
 Massimiliano Marinucci=max.marinucci@gmail.com
 Theodore Mariolis=mariolis@hotmail.gr
 Justin Marion=marion@ucsc.edu
 Nancy P. Marion=nancy.p.marion@dartmouth.edu
 Ilaria Mariotti=ilaria.mariotti@polimi.it
 Martine Mariotti=martine.mariotti@anu.edu.au
 Andreea Maris=andreea.maris@yahoo.com
 Rodrigo Mariscal=rmariscal@iadb.org
 Georgios Maris=ge_maris@hotmail.com
 Coman Dan Marius=cmnmarius@yahoo.com
 Franco Mariuzzo=f.mariuzzo@uea.ac.uk
 Wim Marivoet=wim.marivoet@ua.ac.be
 Raphael Nicholas Markellos=r.markellos@uea.ac.uk
 Andrei Markevich=amarkevich@nes.ru
 Agnieszka Markiewicz=markiewicz@ese.eur.nl
 Maxim Markin=mmarkin@hse.ru
 Nelson Mark=nmark@nd.edu
 Vitaliya Markova=markova_vm@mail.ru
 Jerko Markovina=jmarkovina@agr.hr
 Sara Markowitz=sara.markowitz@emory.edu
 Mindy S. Marks=mmarks@ucr.edu
 Tyler Berkley Mark=tyler.mark@uky.edu
 James R. Markusen=james.markusen@colorado.edu
 Simen Markussen=simen.markussen@frisch.uio.no
 Thomas Markussen=thomas.markussen@econ.ku.dk
 Gerardo Ettore Marletto=gerardomarletto@yahoo.it
 Vadim Marmer=vadim.marmer@ubc.ca
 Thomas Marois=tm47@soas.ac.uk
 Federico Marongiu=fmarongiu@intramed.net.ar
 Maja Lamza Maronić=maja@efos.hr
 Leila Maron=lmaron@ulb.ac.be
 Reyes Maroto-Illera=mmarotoillera@gmail.com
 Daniela Marotta=dmarotta@worldbank.org
 Giuseppe Marotta=giuseppe.marotta@unimore.it
 Florencia Marotta-Wurgler=wurglerf@exchange.law.nyu.edu
 Mohamed Ali Marouani=marouani@univ-paris1.fr
 Doris Marquardt=doris.marquardt@eurac.edu
 André M. Marques=andremmarques@yahoo.com.br
 António Marques=amarques@ubi.pt
 Carla Susana Marques=smarques@utad.pt
 Carlos Robalo Marques=cmrmarques@bportugal.pt
 Pedro Miguel Ferreira Marques=marques@geographie.uni-kiel.de
 Rui Cunha Marques=rui.marques@ist.utl.pt
 Jose Manuel Marqués Sevillano=manuel-m@bde.es
 Adalmir Marquetti=aam@pucrs.br
 Laura Márquez-Ramos=lmarquez@eco.uji.es
 Mita Marra=mita.marra@issm.cnr.it
 Alexander W. Marré=amarre@ers.usda.gov
 Cristina Galamba Marreiros=cristina@uevora.pt
 Gustavo A. Marrero=gmarrero@ull.es
 Charles van Marrewijk=j.g.m.vanmarrewijk@uu.nl
 Emanuela Marrocu=emarrocu@unica.it
 Walid Marrouch=walid.marrouch@cirano.qc.ca
 Aleš Maršál=ales.marsal@seznam.cz
 Gerald Roger Marschke, Jr.=gerald.marschke@gmail.com
 David W. Marsden=d.marsden@lse.ac.uk
 Cara Marie Marshall=cara.marshall@qc.cuny.edu
 Elizabeth Marshall=emarshall@ers.usda.gov
 Dan Marsh=dmarsh@waikato.ac.nz
 Ian Marsh=i.marsh@city.ac.uk
 Simone Marsiglio=simone.marsiglio@jcu.edu.au
 Clément Marsilli=clement.marsilli@gmail.com
 Kadim Martana=kadimmartana@yahoo.com
 Stefano Marta=stefano.marta@unicatt.it
 Leticia Junqueira Marteleto=marteleto@prc.utexas.edu
 Jocelyn Martel=martel@essec.fr
 Dino Martellato, Sr.=marteld@unive.it
 Bianca Maria Martelli=bmartelli@istat.it
 Lionel Martellini=lionel.martellini@edhec.edu
 Federico Martellosio=f.martellosio@surrey.ac.uk
 Bertin Martens=bertin.martens@ec.europa.eu
 Daniel Marti=dmarti@ers.usda.gov
 Josep Marti=arnauj@uji.es
 Minna Martikainen=minna.martikainen@hanken.fi
 David MARTIMORT=david.martimort@parisschoolofeconomics.eu
 Antoine Martin=antoine.martin@ny.frb.org
 Ben R. Martin=b.martin@sussex.ac.uk
 Ana M. Martín Caraballo=ammarcar@upo.es
 Carmela Martín=carmelamartin@telefonica.net
 Christopher Martin=c.i.martin@bath.ac.uk
 Daniel Martin=daniel@martinonline.org
 Nicolas-Guillaume Martineau=nicolas-guillaume.martineau@usherbrooke.ca
 Arianna Martinelli=a.martinelli@sssup.it
 Cesar Martinelli=martinel@itam.mx
 Pablo Martinelli=pabmarti@clio.uc3m.es
 Felice Martinello=fmartinello@brocku.ca
 Claudia Martínez A.=cmartineza@econ.uchile.cl
 Andrew B. Martinez=amartine@gwmail.gwu.edu
 Arturo Martinez, Jr.=a.martinez2@uq.edu.au
 Blanca Martinez=blmartin@ccee.ucm.es
 Monica Martinez-Blasco=monica.martinez@iqs.edu
 Monica Martinez-Bravo=mmb@cemfi.es
 José Miguel Martínez-Carrión=jcarrion@um.es
 Alberto Martínez C.=amartine@usb.ve
 Catalina Martínez=catalina.martinez@csic.es
 Cintia Martinez=cintiam34@yahoo.com
 Juan Carlos Martinez Coll=coll@uma.es
 Constanza Martínez Ventura=amartive@banrep.gov.co
 Jimmy Martínez-Correa=jima.eco@cbs.dk
 Sara Martinez-de-Morentin=sara.martinezdemorentin@unavarra.es
 Diego Martínez=dmarlop1@upo.es
 Roberto Martinez-Espineira=rmartinezesp@mun.ca
 André Carlos Martínez Fritscher=amartinez@banxico.org.mx
 Gabriel Martinez=gabriel0317@gmail.com
 Gabriel Martinez=gmartinez@avemaria.edu
 Julio Martinez-Galarraga=julio.martinez-galarraga@uv.es
 Enrique Martínez García=enrique.martinez-garcia@dal.frb.org
 Esther Martinez-Garcia=esther.martinez@udg.edu
 María Pilar Martínez-García=pilarmg@um.es
 Xavier Martinez-Giralt=xavier.martinez.giralt@uab.cat
 Maite Martinez-Granado=maite.mtzgranado@ehu.es
 Catalina Martínez-Gutiérrez=catamg@gmail.com
 Isabel Martínez=isabel.martinez@unisg.ch
 Javier Martinez=jmartinm@uach.mx
 Juan Francisco Martínez=juanframart@oba.co.uk
 Juan Enrique Martinez-Legaz=juanenrique.martinez.legaz@uab.cat
 María consuelo pucheta martínez=pucheta@cofin.uji.es
 María Teresa Sánchez Martínez=tsanchez@ugr.es
 Ismael Martínez-Martínez=ismael@imartinez.eu
 Jaime Martinez-Martin=jaime.martinezmartin@ub.edu
 Francisco Martínez-Mora=fmm14@le.ac.uk
 Oscar Martinez=martinez.oskar@gmail.com
 Juan Carlos Martínez-Ovando=juan.martinez@banxico.org.mx
 Jose Miguel Martinez Paz=jmpaz@um.es
 J.ramón Martinez-Resano=martinez@bde.es
 Ricardo Martinez=ricardo.martinez@unileon.es
 Susana Martinez-Rodriguez=susanamartinezr@um.es
 Ester Martínez-Ros=emros@emp.uc3m.es
 María Pilar Martínez-Ruiz=mariapilar.martinez@uclm.es
 Francisco Martínez-Sánchez=fms@um.es
 Miguel Angel Martinez Sedano=jepmasem@bs.ehu.es
 Ángel Pascual Martinez Soto=apascual@um.es
 Jorge Martinez-Vazquez=jorgemartinez@gsu.edu
 Fernando M. Martin=fernando.m.martin@stls.frb.org
 Florin Martin=florin.martin@ulbsibiu.ro
 Vítor João Pereira Domingues Martinho=vdmartinho@esav.ipv.pt
 Alberto Martini=amartini@prova.org
 Ian Martin=i.w.martin@lse.ac.uk
 Gianmaria Martini=gianmaria.martini@unibg.it
 Iván Martín=ivanmartinmartin@telefonica.net
 Jean-Christophe MARTIN=martin_jeanchristophe@yahoo.fr
 Julien Martin=martin.julien@uqam.ca
 Ludivine Martin=ludivine.martin@ceps.lu
 Marc-Jean Martin=marc-jean.martin@vd.ch
 Ana Martín-Marcos=amartin@cee.uned.es
 Michela Martinoia=michela.martinoia@gmail.com
 Alfredo Martin-Oliver=alfredo.martin@uib.es
 Philippe Martin=philippe.martin@sciencespo.fr
 Ralf Martin=r.martin@imperial.ac.uk
 Reiner Martin=reiner.martin@ecb.int
 Richard Patrick Martin=rich.p.martin@gmail.com
 Robert F. Martin=robert.f.martin@frb.gov
 Rodney Lennard Martin=rodney.martin@monash.edu
 Roman Martin=roman.martin@circle.lu.se
 Ángel Luis Martín-Román=angellm@eco.uva.es
 Victor Martin-Sanchez=victor.martin.sanchez@uab.cat
 Bruno Martins=bruno.martins@bcb.gov.br
 Carlos Eduardo Maria Martins=badmartins@gmail.com
 V. Filipe Martins-da-Rocha=filipe.econ@gmail.com
 Fernando Manuel Monteiro Martins=fmartins@bportugal.pt
 Guilherme Nunes Martins=guilherme.martins@oi.com.br
 José Albuquerque Martins=jalbmartins@iol.pt
 Luis F. Martins=luis.martins@iscte.pt
 Manuel M. F. Martins=mmfmartins@fep.up.pt
 Maria de Belém Costa Freitas Martins=mbmartins@ualg.pt
 Maria Lurdes Castro Martins=lmartins@eeg.uminho.pt
 Susana Martins Moretto=s.moretto@campus.fct.unl.pt
 Patrícia Martins=smartins@utad.pt
 Stephen Martin=smartin@purdue.edu
 Vitor Dias Martins=vdiasmartins@yahoo.com.br
 Wade E. Martin=wmartin@csulb.edu
 Will J Martin=wmartin1@worldbank.org
 James Marton=marton@gsu.edu
 Marco Ferdinando Martorana=marco.martorana@unict.it
 Joan-Carles Martori=martori@uvic.cat
 Frédéric Marty=frederic.marty@gredeg.cnrs.fr
 Natalya Martyshenko=natalya.martyshenko@vvsu.ru
 Cristina Marullo=c.marullo@sssup.it
 Antonello Maruotti=antonello.maruotti@uniroma3.it
 Akiko Maruyama=akiko_maruyama@red.umds.ac.jp
 Shiko Maruyama=shikomaruyama@gmail.com
 Jordan Marvakov=jmarvakov@clarku.edu
 Magali Marx=magali.marx@sciences-po.org
 Sébastien Mary=sebastien.mary@ec.europa.eu
 Stefano Marzioni=smarzioni@luiss.it
 Massimiliano Marzo=massimiliano.marzo@unibo.it
 Azizan Marzuki=azizan.marzuki@flinders.edu.au
 Yusufcan Masatlioglu=yusufcan@umich.edu
 Oscar Mascarilla- Miró=omascarilla@ub.edu
 Michael K. Maschek=michael.maschek@ufv.ca
 Donato Masciandaro=donato.masciandaro@unibocconi.it
 Sergio Masciantonio=sergio.masciantonio@bancaditalia.it
 Masclet=david.masclet@univ-rennes1.fr
 Robbert Maseland=r.k.j.maseland@rug.nl
 Paolo Masella=pm295@sussex.ac.uk
 Federico Masera=fmasera@eco.uc3m.es
 Richard Mash=richard.mash@economics.ox.ac.uk
 Neal A. Masia=neal.masia@pfizer.com
 Lorenzo Masiero=lorenzo.masiero@polyu.edu.hk
 Rumi Masih=rumi.masih@gmail.com
 Gustavo Santos Masili=gustavo.masili@mme.gov.br
 Pietro P. Masina=pmasina@unior.it
 Serena Masino=serena.masino@manchester.ac.uk
 Nephil Matangi Maskay=nmmaskay@nrb.org.np
 Keith E. Maskus=keith.maskus@colorado.edu
 Masha Maslianskaïa-Pautrel=masha.pautrel@gmail.com
 Alexander Maslov=alexander_maslov@carleton.ca
 Matilde Mas=matilde.mas@uv.es
 Jaume Masoliver=jaume.masoliver@ub.edu
 Charles F. Mason=bambuzlr@uwyo.edu
 Patrick Leon Mason=pmason@fsu.edu
 Paul M. Mason=pmason@unf.edu
 Najeb Masoud, Dr.=najeb2000@gmail.com
 Tajul Ariffin Masron=tams@usm.my
 Daniele Massacci=dm355@cantab.net
 Isabella Massa=i.massa@odi.org.uk
 Nadine Massard=nadine.massard@univ-st-etienne.fr
 Antonio Massarutto=antonio.massarutto@uniud.it
 Baptiste Massenot=massenot@safe.uni-frankfurt.de
 Jérôme Massiani=j.massiani@unive.it
 Carla Massidda=massidda@unica.it
 Philipp Massier=massier@zew.de
 Silvia Massini=silvia.massini@mbs.ac.uk
 Jaan Masso=jaan.masso@mtk.ut.ee
 André Masson=masson@pse.ens.fr
 José Luis Massón-Guerra=joseluis.masson@uab.cat
 Sébastien Massoni=sebastien.massoni@gmail.com
 Paul Robert Masson=paul.masson@rotman.utoronto.ca
 Nada Massoud=nada_massoud@yahoo.com
 Israel Jacob Massuanganhe=jacob.massuanganhe@gmail.com
 Scott E Masten=semasten@umich.edu
 Adrian M. Masters=amasters@albany.edu
 Thomas Neal Masterson=masterso@levy.org
 William A. Masters=william.masters@tufts.edu
 Giovanni Mastrobuoni=gmastrob@essex.ac.uk
 Giovanni Mastroleo=giovanni.mastroleo@unisalento.it
 Camilla Mastromarco=camilla.mastromarco@unisalento.it
 Leonardo Javier Mastronardi=lmastronardi@uade.edu.ar
 Miguel Angel Mastroscello=mmastroscello@gmail.com
 Junya Masuda=masuda@econometrics.jp
 Mohammad Masud Alam=masudnb@gmail.com
 José Mata=jmata@fe.unl.pt
 Hernando Matallana Laverde=hmatalla@uniandes.edu.co
 Mohd Zahari bin Mat Amin=zaharey@gmail.com
 Alessia Matano=alexis.rtd@gmail.com
 Awad Mataria=matariaa@emro.who.int
 Tiago Mata=tiago.mata@gmail.com
 Miodrag Matavulj=m.matavulj@aced.ba
 María de los Llanos Matea Rosa=matea@bde.es
 Carlos Maté=cmate@upcomillas.es
 Ani Matei=amatei@snspa.ro
 Lucica Matei=lmatei@snspa.ro
 Mirela Matei=mirematei@yahoo.com
 Jakub Matějů=j.mateju@email.cz
 Mercedes Mateo Diaz=mercedesma@iadb.org
 Ana Isabel Mateos-Ansotegui=amateos@uch.ceu.es
 Xavier Mateos-Planas=x.mateos-planas@qmul.ac.uk
 Valentina Cristiana Materia=v.c.materia@univpm.it
 Marina Vladimirovna Matetskaya=marima@yandex.ru
 Simona Mateut=simona.mateut@nottingham.ac.uk
 Thomas Mathä=thomas.mathae@bcl.lu
 David L. Mather=matherda@msu.edu
 Julien Matheron=julien.matheron@banque-france.fr
 Jesse Matheson=jm464@le.ac.uk
 Troy D. Matheson=troy.matheson@gmail.com
 Victor Matheson=vmatheso@holycross.edu
 John Mathews=john.mathews@mq.edu.au
 Kenneth Harry Mathews, Jr.=kmathews@ers.usda.gov
 Timothy Mathews=tmmathews@gmail.com
 Charles Mathias=charles.mathias@ulb.ac.be
 Catherine Mathieu=catherine.mathieu@ofce.sciences-po.fr
 Claude Mathieu=mathieu@univ-paris12.fr
 Erik Mathijs=erik.mathijs@ees.kuleuven.be
 Alexandre MATHIS=alexandre.mathis@ep.europa.eu
 Jérôme Mathis=jerome.mathis@tse-fr.eu
 Jacky Mathonnat=jackymathonnat@yahoo.com
 Aparna Mathur=amathur@aei.org
 Gabriel P. Mathy=gpmathy@ucdavis.edu
 Sandrine Mathy=mathy@centre-cired.fr
 Wenzel Matiaske=matiaske@hsu-hh.de
 Miguel Neves Matias=miguel.matias@estg.ipleiria.pt
 Chris Matier=matiec@parl.gc.ca
 Tuomas Matikka=tuomas.matikka@vatt.fi
 Roman B. Matkovskyy=roman.matkovskyy@gmail.com
 Janusz Matkowski=j.matkowski@wmie.uz.zgora.pl
 Cristina Maria Soeiro Matos=crism@eeg.uminho.pt
 Catherine Anne Matraves=catherine.matraves@fcc.gov
 Manfred Jürgen Matschke=matschke@uni-greifswald.de
 Xenia Matschke=matschke@uni-trier.de
 Egil Matsen=egil.matsen@svt.ntnu.no
 Yoichi Matsubayashi=myoichi@econ.kobe-u.ac.jp
 Akimi Matsuda=akimi.matsuda@nyu.edu
 Toshinobu Matsuda=matsudat@muses.tottori-u.ac.jp
 Norimichi Matsueda=nmatsued@kwansei.ac.jp
 Akihiko Matsui=amatsui@e.u-tokyo.ac.jp
 Takashi Matsuki=matsuki@ogu.ac.jp
 Mutsumi Matsumoto=mmt06834@ec.ritsumei.ac.jp
 Tadashi Matsumoto=tadashi.matsumoto@oecd.org
 Tomoya Matsumoto=tmatsumo@grips.ac.jp
 松村 敏弘 (Toshihiro Matsumura)=matsumur@iss.u-tokyo.ac.jp
 Tarishi Matsuoka=tarishi727@gmail.com
 John G. Matsusaka=matsusak@usc.edu
 Yukitoshi Matsushita=matsushita@dpipe.tsukuba.ac.jp
 Toshiyuki Matsuura=matsuura@sanken.keio.ac.jp
 Kiminori Matsuyama=k-matsuyama@northwestern.edu
 Paolo Mattana=mattana@unica.it
 Rafael Matta=matta@uva.nl
 Gianluca Mattarocci=gianluca.mattarocci@uniroma2.it
 Stefano Matta=smatta@unica.it
 Anselm Mattes=amattes@diw-econ.de
 Fabrizio Mattesini=mattesini@economia.uniroma2.it
 Christian Matthes=christian.matthes@rich.frb.org
 Alan Matthews=alan.matthews@tcd.ie
 Kent Gerard Matthews=matthewsk@cardiff.ac.uk
 Peter Hans Matthews=peter.h.matthews@middlebury.edu
 Steven A. Matthews=stevenma@econ.upenn.edu
 Astrid Matthey=matthey@econ.mpg.de
 Þórólfur Matthíasson=totimatt@hi.is
 Ely José de Mattos=ely.mattos@pucrs.br
 Enlinson Mattos=enlinson.mattos@fgv.br
 Laura Valladão de Mattos=laura.mattos@pesquisador.cnpq.br
 Andrea Mattozzi=andrea.mattozzi@eui.eu
 Ryan Scott Mattson=mattsonr@rhodes.edu
 Lars-Göran Mattsson=lars-goran.mattsson@abe.kth.se
 Aleksandra Matuszewska-Janica=aleksandra_matuszewska@sggw.pl
 Steven J. Matusz=matusz@msu.edu
 Владимир Матвеенко (Vladimir Matveenko)=matveenko@emi.nw.ru
 Anna Matysiak=anna.matysiak@oeaw.ac.at
 Julia Anna Matz=matzj@tcd.ie
 Nathan Mauck=mauckna@umkc.edu
 Joaquin Maudos=joaquin.maudos@ivie.es
 Novella Maugeri=novella.maugeri@eui.eu
 Brendan Geoffrey Maughan-Brown=brendan.maughanbrown@gmail.com
 Achmad Maulana=achmad.maulana@fe.unpad.ac.id
 Ana Mauleon=ana.mauleon@usaintlouis.be
 Ignacio Mauleón=ignacio.mauleon@urjc.es
 Christine Mauracher=maurache@unive.it
 Arnaud Maurel=apm16@duke.edu
 Christine Maurel=christine.maurel@tse-fr.eu
 Maurel=maurelm@univ-paris1.fr
 Margaret Maurer-Fazio=mmaurer@bates.edu
 Raimond Maurer=investment@wiwi.uni-frankfurt.de
 Arnaldo Mauri=arnaldo.mauri@unimi.it
 Aurelio Giovanni Mauri=aurelio.mauri@iulm.it
 Jonathan Maurice=jonathan.maurice@ens-cachan.org
 Marc Maurice=marc.maurice@9online.fr
 Eric Maurin=eric.maurin@ens.fr
 Johannes Mauritzen=johannes.mauritzen@ifn.se
 Roxana Maurizio=roxanadmaurizio@gmail.com
 Luciano Mauro=luciano.mauro.ts@gmail.com
 Paolo Mauro=pmauro@imf.org
 Raul Mauro=raulmauro@gmail.com
 Rakesh Kumar Maurya=srakeshkm@gmail.com
 Tristan-Pierre Maury=tristan.maury@edhec.edu
 Eileen Mauskopf=emauskopf@gmail.com
 Alfred Maussner=alfred.maussner@wiwi.uni-augsburg.de
 Samuel Maveyraud=samuel.maveyraud@u-bordeaux4.fr
 Astghik Mavisakalyan=astghik.mavisakalyan@curtin.edu.au
 Dimitris Mavridis=mavridis.dimitris@gmail.com
 Christos Mavrodimitrakis=xmaurod@econ.uoa.gr
 Konstantinos (Kostas) Mavromatis=k.mavromatis@uva.nl
 Stavros Mavroudeas=smavro@uom.gr
 Koffi Wisdom Mawudeku=koffimawudeku@gmail.com
 Xingliang Ma=xingliang.ma@cgiar.org
 John W. Maxwell=jwmax@indiana.edu
 Abubaker Bujaasi Mayanja=abm@abl.co.ug
 Anna Maria Mayda=amm223@georgetown.edu
 Alberto Maydeu=alberto.maydeu@ie.edu
 Adalbert Mayer=amayer2@washcoll.edu
 Christopher Mayer=cm310@columbia.edu
 Colin Mayer=colin.mayer@sbs.ox.ac.uk
 Eric Mayer=eric.mayer@uni-wuerzburg.de
 Inge Mayeres=inge.mayeres@vito.be
 David Mayer-Foulkes=david.mayer@cide.edu
 Francine Mayer=mayer.francine@uqam.ca
 Peter Mayerhofer=peter.mayerhofer@wifo.ac.at
 Ricardo Mayer=ricardo.mayer@udp.cl
 Thierry Mayer=thierry.mayer@sciences-po.fr
 Thomas Mayer=tommayer@lmi.net
 David G. Mayes=d.mayes@auckland.ac.nz
 Justin May=jbmay@wm.edu
 Florian Mayneris=florian.mayneris@uclouvain.be
 Sergio Mayordomo=smayordomo@unav.es
 Karen Mayor=mayork@tcd.ie
 Matías Mayor=mmayorf@uniovi.es
 Guy Mayraz=guy.mayraz@unimelb.edu.au
 Johannes Mayr=johannes-mayr@gmx.de
 Karin Mayr=karin.mayr@univie.ac.at
 Jean-François Maystadt=j.f.maystadt@cgiar.org
 David Mayston=dm3@york.ac.uk
 Yue Ma 马跃 (Yue Ma)=yue.ma@cityu.edu.hk
 Kozo Mayumi=mayumi@ias.tokushima-u.ac.jp
 Manas Mayur=manasmayur@yahoo.com
 Adolfo Maza=mazaaj@unican.es
 Ummad Mazhar=umadmazhar@gmail.com
 Arman Mazhikeyev=a.mazhikeyev@lboro.ac.uk
 Murat Mazibaş=murat.mazibas@borsaistanbul.com
 Mirela Elena Mazilu=mirelamazilu2004@yahoo.com
 Samah Mazraani=smazraani@imf.org
 Mohammad Mazraati=mo_mazraati@yahoo.com
 Dipak Mazumdar=d_mazumdar@hotmail.com
 Krishna Mazumdar=krishnamazumdar@ymail.com
 Surajit Mazumdar=surajit.mazumdar@gmail.com
 M. Imtiaz Mazumder=mazumderimtiaz@sau.edu
 Miruna Mazurencu Marinescu=miruna@ase.ro
 Jacopo Mazza=jacopo.mazza@manchester.ac.uk
 Giovanni Maria Mazzanti=g.mazzanti@unibo.it
 Massimiliano Mazzanti=mzzmsm@unife.it
 Paolo Mazza=paolo.mazza@uclouvain.be
 Mario Mazzocchi=m.mazzocchi@unibo.it
 Ronny Mazzocchi=ronny.mazzocchi@unitn.it
 Maurizio Mazzocco=mmazzocc@econ.ucla.edu
 Fabrizio Mazzonna=fabrizio.mazzonna@usi.ch
 Stefano Mazzotta=smazzott@kennesaw.edu
 Mariana Mazzucato=m.mazzucato@sussex.ac.uk
 Michael Mbate=mbatem@uneca.org
 Linguère Mously Mbaye=mbaye@iza.org
 Samba MBAYE=samba.mbaye@udamail.fr
 Vincent de Paul Mboutchouang=mb.vincentdepaul@outlook.com
 David McAdams=david.mcadams@duke.edu
 Randolph Preston Mcafee=preston@mcafee.cc
 Ryan Robert Jeff McAllister=ryan.mcallister@csiro.au
 Patrick McAlvanah=pmcalvanah@ftc.gov
 James Joseph McAndrews=jamie.mcandrews@ny.frb.org
 Carol McAusland=carol.mcausland@ubc.ca
 Mark E. McBride=mcbridme@muohio.edu
 Michael McBride=mcbride@uci.edu
 William D. McBride=wmcbride@ers.usda.gov
 Kevin McCabe=kmccabe@gmu.edu
 Brian McCaig=bmccaig@wlu.ca
 Thomas S. McCaleb=tmccaleb@mailer.fsu.edu
 Brian Mccall=bpmccall@umich.edu
 Andrew McCallum=econandy@umich.edu
 Bennett McCallum=bmccallum@cmu.edu
 Fergal McCann=fergal.mccann@centralbank.ie
 Bryan C. McCannon=bmccannon@sbu.edu
 Philip McCann=p.mccann@rug.nl
 Matthew W. McCarter=mccarter@chapman.edu
 Cornelia H. McCarthy=cm125@nyu.edu
 Ian McCarthy=ianmccarthy.econ@gmail.com
 Jonathan McCarthy=jonathan.mccarthy@ny.frb.org
 Yvonne McCarthy=yvonne.mccarthy@centralbank.ie
 Joseph L. McCauley=jmccauley@uh.edu
 Robert Neil Mccauley=robert.mccauley@bis.org
 William Mccausland=william.j.mccausland@umontreal.ca
 Adam McCloskey=adam_mccloskey@brown.edu
 Nadine McCloud=nadine.mccloud02@uwimona.edu.jm
 Pat (Patrick) McCloughan=pat@pmca.ie
 Jill J. McCluskey=mccluskey@wsu.edu
 Kenneth Mcconnell=kmcconnell@arec.umd.edu
 Virginia McConnell=mcconnell@rff.org
 Anna Gabriele McCord=anna.mccord@icloud.com
 Ken McCormick=kenneth.mccormick@uni.edu
 Robert Exley Mccormick=sixmile@clemson.edu
 Daire McCoy=daire.mccoy@esri.ie
 Michael McCracken=michael.w.mccracken@stls.frb.org
 Scott McCracken=s.mccracken@hull.ac.uk
 Kristin McCue=kristin.mccue@census.gov
 Neil McCulloch=neil.mcculloch@ausaid.gov.au
 Rachel McCulloch=mcculloch@brandeis.edu
 B D McCullough=bdmccullough@drexel.edu
 Christine McDaniel=christine.mcdaniel@pc.gov.au
 Christopher John McDermott=john.mcdermott@rbnz.govt.nz
 John B. McDermott=jmcdermott@fairfield.edu
 Thomas K.J. McDermott=mcdermot@tcd.ie
 Ian McDevitt=amcdevitt@att.net
 Ian Martin McDonald=i.mcdonald@unimelb.edu.au
 James McDonald=james_mcdonald@byu.edu
 James Ted McDonald=tedmcdon@unb.ca
 Scott McDonald=smcdonald@brookes.ac.uk
 Stuart McDonald=s.mcdonald@uq.edu.au
 Tony McDonald=tony.mcdonald@pbo.gov.au
 Topher L. McDougal=tlm@sandiego.edu
 William A. McEachern=william.mceachern@uconn.edu
 Tucker Sprague McElroy=tucker.s.mcelroy@census.gov
 Erika L. McEntarfer=erika.mcentarfer@census.gov
 Seamus Anthony McErlean=samcerlean@gmail.com
 David M. McEvoy=mcevoydm@appstate.edu
 Albert Mark McGartland=mcgartland.al@epa.gov
 Kerry Anne McGeary=kmcgeary@bsu.edu
 Andrew D. McGee=andrew_mcgee@sfu.ca
 Robert W. McGee=bob414@hotmail.com
 Bruce McGough=bmcgough@uoregon.edu
 Danny McGowan=d.mcgowan@bangor.ac.uk
 David A. McGranahan=dmcg@ers.usda.gov
 Peter McGregor=p.mcgregor@strath.ac.uk
 Anne McGuinness=anne.mcguinness@centralbank.ie
 Seamus Mcguinness=seamus.mcguinness@esri.ie
 Martin C. McGuire=mcmcguir@uci.edu
 Eoin McGuirk=mcguirke@tcd.ie
 Helen McGuirk=helen.mcguirk@ul.ie
 John McHale=john.mchale@nuigalway.ie
 Jolian Peter McHardy=j.mchardy@sheffield.ac.uk
 Peter McHenry=pmchenry@wm.edu
 Timothy Mchugh=tmchugh@williamblair.com
 Thomas H. McInish=tmcinish@memphis.edu
 Melayne Morgan McInnes=mcinnes@moore.sc.edu
 Marvin McInnis=mcinnism@qed.econ.queensu.ca
 James McIntosh=jamesm@vax2.concordia.ca
 Steven McIntosh=s.mcintosh@sheffield.ac.uk
 Stuart McIntyre=s.mcintyre@strath.ac.uk
 Alisdair McKay=amckay@bu.edu
 David Mckenzie=dmckenzie@worldbank.org
 Jordi Mckenzie=jordi.mckenzie@mq.edu.au
 Kenneth J. McKenzie=kjmckenz@ucalgary.ca
 Margaret McKenzie=mckenzie@deakin.edu.au
 Rex A. McKenzie=rex.mckenzie@wits.ac.za
 Warwick Mckibbin=warwick.mckibbin@anu.edu.au
 Ross R. McKitrick=rmckitri@uoguelph.ca
 Stephen McKnight=mcknight@colmex.mx
 Keith Robert McLaren=keith.mclaren@monash.edu
 Patrick A. McLaughlin=econpatrick@gmail.com
 Ralph Boone McLaughlin=ralph.mclaughlin@sjsu.edu
 Ian W. McLean=ian.mclean@adelaide.edu.au
 Stuart McLeay=stuart.mcleay@sydney.edu.au
 Nathan McLellan=nathan.i.c.mclellan@gmail.com
 Andrew McLennan=a.mclennan@economics.uq.edu.au
 Darryl McLeod=mcleod@fordham.edu
 Logan McLeod=lmcleod@wlu.ca
 Ross H. McLeod=ross.mcleod@anu.edu.au
 Cameron McLoughlin=cameron.mcloughlin@gmail.com
 Charles E. Mclure, Jr.=cmclure@stanford.edu
 Michael Francis McMahon=m.mcmahon@warwick.ac.uk
 Walter S McManus=walter@mcmanusanalytics.com
 Margaret Mcmillan=margaret.mcmillan@tufts.edu
 Melville McMillan=melville.mcmillan@ualberta.ca
 Daniel McMillen=mcmillen@illinois.edu
 Stanley McMillen=stanley.mcmillen@uconn.edu
 W. Douglas McMillin=eodoug@lsu.edu
 Steven C. McMullen=mcmullen@calvin.edu
 Joseph C. McMurray=joseph.mcmurray@byu.edu
 Robert M. McNab=rmmcnab@nps.edu
 Justine McNamara=justine_mcnamara@hotmail.com
 Paul McNelis=mcnelis@fordham.edu
 Lihong Lu McPhail=mcphaill@fca.gov
 Ronald W. McQuaid=r.w.mcquaid@stir.ac.uk
 Ben McQuillin=b.mcquillin@uea.ac.uk
 Kieran McQuinn=kieran.mcquinn@esri.ie
 Alexander Fraser McQuoid=alexander.mcquoid@fiu.edu
 Shaun David McRae=sdmcrae@umich.edu
 Patrick Eugene McSharry=patrick@mcsharry.net
 Brendan McSweeney=brendan.mcsweeney@rhul.ac.uk
 Duncan McVicar=d.mcvicar@qub.ac.uk
 Stephanie Faye McWhinnie=stephanie.mcwhinnie@adelaide.edu.au
 Abagail McWilliams=abby@uic.edu
 Rajib Md. Salah Uddin=rajibais71@gmail.com
 Ferdinando Meacci=ferdinando.meacci@unipd.it
 Birgit Meade=bmeade@ers.usda.gov
 Ellen E. Meade=ellen.meade@frb.gov
 Neil Meads=neil.meads@bankofengland.co.uk
 Gerald Anthony Meagher=tony.meagher@vu.edu.au
 Fabrizia Mealli=mealli@ds.unifi.it
 Romuald Méango=meango@ifo.de
 Jack Meaning=jm583@kent.ac.uk
 Stephen Meardon=smeardon@bowdoin.edu
 Andrew Mearman=andrew.mearman@uwe.ac.uk
 Ronald Richard Mears=rmears@uj.ac.za
 Nicola Meccheri=nicola.meccheri@unipi.it
 Zohra Bouamra Mechemache=zohra.bouamra@toulouse.inra.fr
 Stéphane Mechoulan=s.mechoulan@dal.ca
 Mario Mechtel=mechtel@iaaeu.de
 Lydia Mechtenberg=lydia.mechtenberg@wiso.uni-hamburg.de
 Jürgen Meckl=juergen.meckl@wirtschaft.uni-giessen.de
 Giuseppe Medda=gmedda@yahoo.it
 Marcelo Medeiros=marcelo.medeiros.cs@gmail.com
 Marcelo C. Medeiros=mcm@econ.puc-rio.br
 Carlos A. Medel=cnmedel@gmail.com
 Andreas Meder=andreas.meder@tmwta.thueringen.de
 Haileselassie Medhin=haileselassie.medhin@economics.gu.se
 Diego Medici=medicid@usi.ch
 Florencia Medici=florencia.medici@gmail.com
 Carlos Medina=cmedindu@banrep.gov.co
 Juan Pablo Medina=jmedina@imf.org
 Leandro Medina=leandrom@gwu.edu
 Paúl Medina=pmedinavz@gmail.com
 Alfredo Medio=alfredomedio@gmail.com
 Ivan Medovikov=imedovikov@brocku.ca
 Luis F. Medrano E.=luisfermedrano@gmail.com
 Andrei Medvedev=andrei.medvedev@fca.org.uk
 Geoff Meen=g.p.meen@reading.ac.uk
 Syed Imran Ali Meerza=syedimranali.meerza@sdstate.edu
 Richard A. Meese=richard.meese@sbcglobal.net
 Costas Meghir=c.meghir@yale.edu
 Mamta Mehar=m.kain@cgiar.org
 Muhammad Ayub Khan Mehar=ayubmehar@yahoo.com
 Cesaire Meh=cmeh@bankofcanada.ca
 Tahsin Mehdi=tmehdi@uoguelph.ca
 Mehedintu, Anca=ancamehedintu@yahoo.com
 Arnaud Jérôme Mehl=arnaud.mehl@ecb.int
 Andreas Mehler=mehler@giga-hamburg.de
 Halvor Mehlum=halvor.mehlum@econ.uio.no
 Sultan Mehmood=s.mehmood@cpb.nl
 Meeta Keswani Mehra=meetakm@mail.jnu.ac.in
 Hamid Mehran=hamid.mehran@ny.frb.org
 Rajnish Mehra=rajnish.mehra@asu.edu
 Judith Rose Mehta=j.mehta@uea.ac.uk
 Rajesh Mehta=drmehtarajesh@gmail.com
 Salil Mehta=mehta@post.harvard.edu
 Swati Mehta=swatieco@gmail.com
 Andre Meier=andre.meier@eui.eu
 Claudia Meier=claudia.meier@wiwi.uni-halle.de
 Stephan Meier=sm3087@columbia.edu
 Volker Meier=meier@ifo.de
 Joris Meijaard=joris@meijaard.com
 Lex Meijdam=a.c.meijdam@uvt.nl
 Erik Meijer=meijer@rand.org
 Gerdien W. Meijerink=gerdien.meijerink@wur.nl
 Hans van Meijl=hans.vanmeijl@wur.nl
 Juergen Meinecke=juergen.meinecke@anu.edu.au
 Nicolas Meisel=meiseln@afd.fr
 Craig Meisner=cmeisner@worldbank.org
 Christopher M. Meissner=cmmeissner@ucdavis.edu
 Mika Meitz=mika.meitz@helsinki.fi
 Isabelle Méjean=isabelle.mejean@polytechnique.edu
 Malwina Mejer=mmejer@ulb.ac.be
 Javier Mejía Cubillos=javiermejiacubillos8a@yahoo.com
 Daniel Mejia=daniel.mejia.londono@gmail.com
 Juan Felipe Mejía=jfmejia@eafit.edu.co
 Michal Mejstrik=eeipmejs@iol.cz
 Konstantinos A. Melachroinos=k.melachroinos@qmul.ac.uk
 Giulio Mela=giulio.mela@crefis.it
 Ola Melander=ola.melander@riksbank.se
 Mark Melatos=mark.melatos@sydney.edu.au
 Hans Olav Melberg=hans.melberg@gmail.com
 James R. Meldrum=james.meldrum@colorado.edu
 Angelo Mele=angelo.mele@jhu.edu
 Antonio Mele=antonio.mele@usi.ch
 Antonio Mele=meleantonio@gmail.com
 Aleš Melecký=ales.melecky@vsb.cz
 Martin Melecky=m.melecky@gmail.com
 Bertrand Melenberg=b.melenberg@uvt.nl
 Marcela Meléndez=marcela.melendez@econestudio.com
 Vicenc Melendez-Plumed=vicenc.melendez@yahoo.es
 Linda Meleo=lmeleo@luiss.it
 Francois Melese=fmelese@nps.edu
 Karl Melgarejo Castillo=karl.melgarejo@gmail.com
 Angel Melguizo=amelguizo0102@gmail.com
 Elena Meliá=emeliam@esp.upv.es
 Valentina Meliciani=vmeliciani@unite.it
 Will Melick=melickw@kenyon.edu
 Giovanni Melina=giovanni.melina.1@city.ac.uk
 Paolo Melindi Ghidi=paolo.melindi@uclouvain.be
 Angelo Melino=angelo.melino@utoronto.ca
 Maria Melkersson=maria.melkersson@trafa.se
 Mickaël Melki=mickael.melki@univ-paris1.fr
 Giovanni Mellace=giome@sam.sdu.dk
 Cristhian Mellado=cmellado@ucsc.cl
 Charlotta Mellander=charlotta.mellander@ihh.hj.se
 Ali Mellati=alimellaty@gmail.com
 Marcelo Albuquerque Mello=mmello@ibmecrj.br
 Jennifer M. Mellor=jmmell@wm.edu
 Blaise Melly=blaise.melly@vwi.unibe.ch
 Mikhail Ion Melnik=mmelnik@bellsouth.net
 Валентин Николаевич Мельник=valek@mail.ru
 Andrew Melnyk=andrewmelnyk@acli.com
 Ligia Melo=lmelobec@banrep.gov.co
 Luis Melo=lmelovel@banrep.gov.co
 Osvaldo Meloni=omeloni@herrera.unt.edu.ar
 Oscar Melo=omelo@uc.cl
 Patricia C. Melo=patricia.melo@hutton.ac.uk
 Leonardo Melosi=lmelosi@frbchi.org
 Eric Melse=eric.melse@planet.nl
 Daniel Melser=danielmelser@gmail.com
 Richard Thomas Melstrom=rtmelstrom@salisbury.edu
 Allan H. Meltzer=am05@andrew.cmu.edu
 James R. Melvin=jrmelvin@hurontel.on.ca
 Michael Melvin=michael.melvin@blackrock.com
 Olga Memedovic=o.memedovic@unido.org
 Christoph Memmel=christoph.memmel@bundesbank.de
 Manzoor H. Memon=manzoorhmemon@yahoo.com
 Georges Menahem=georges.menahem@gmail.com
 Claude Menard=menard@univ-paris1.fr
 Joze Mencinger=joze.mencinger@eipf.si
 Andrea Kutinova Menclova=andrea.menclova@canterbury.ac.nz
 Teodora Adriana Menda=teodora.menda@yahoo.com
 Alexander Mende=alexander.mende@rpm.se
 Roman Mendelevitch=rmendelevitch@diw.de
 Américo Mendes=amendes@porto.ucp.pt
 Wesley Mendes-Da-Silva=mr.mendesdasilva@gmail.com
 Isabel Mendes=midm@iseg.utl.pt
 Luis António Fonseca Mendes=lmendes.ubi@gmail.com
 Rhys Mendes=rmendes@bankofcanada.ca
 Rui Vilela Mendes=vilela@cii.fc.ul.pt
 Victor Mendes=victormendes@cmvm.pt
 Paula Luciana Méndez Errico=paulaluciana.mendez@uab.cat
 Fabio Mendez=fmendez1@loyola.edu
 Caterina Mendicino=caterina.mendicino@gmail.com
 Pablo Mendieta=pmendiet@gmail.com
 Daria Mendola=daria.mendola@unipa.it
 Mariapia Mendola=mariapia.mendola@unimib.it
 Silvia Mendolia=smendoli@uow.edu.au
 Concetta Barbara Mendolicchio=concetta.mendolicchio@iab.de
 Diogo de Prince Mendonça=dioted@gmail.com
 Joana Mendonça=joana.mendonca@ist.utl.pt
 Enrique G. Mendoza=egme@sas.upenn.edu
 juan Carlos Mendoza=jmendogu@banrep.gov.co
 Ronald U. Mendoza=ronmendoza@post.harvard.edu
 Alfonso Mendoza-Velázquez=amv101@yahoo.com
 Rodrigo Mendoza Yllanes, Sr.=rodrigo.mendozay@gmail.com
 Ewa Mendys-Kamphorst=emendys@gmail.com
 Francisco Juan Meneses, Sr.=fjmenese@gmail.com
 António Menezes=menezesa@uac.pt
 Naercio Menezes-Filho=naercioamf@insper.edu.br
 Flavio Menezes=f.menezes@uq.edu.au
 Jose H. V. Menezes=j.menezes@ids.ac.uk
 Rui Menezes=rui.menezes@iscte.pt
 Channarith Meng=channarithmeng@yahoo.com
 Taye Mengistae=tmengistae@worldbank.org
 Juanjuan Meng=jumeng@gsm.pku.edu.cn
 Xiangyi Meng=danielxymeng@gmail.com
 Xin Meng=xin.meng@anu.edu.au
 Xin Meng=mengxin@swufe.edu.cn
 Yan Meng=munyanmeng@yahoo.com
 Anna Maria C. Menichini=amenichi@unisa.it
 Yann Ménière=yann.meniere@mines-paristech.fr
 Sisay Menji Bekena=shewalem@gmail.com
 Lukas Menkhoff=menkhoff@gif.uni-hannover.de
 Albert J. Menkveld=albertjmenkveld@gmail.com
 Faek Menla Ali=faek.menlaali@brunel.ac.uk
 Antonella Mennella=mennella.antonella@gmail.com
 Martin Menner=mmenner@ua.es
 Roman Mennicken=roman.mennicken@rwi-essen.de
 Giulia Mennillo=giulia.mennillo@unisg.ch
 Carlo Menon=carlomenon@gmail.com
 Francesco Menoncin=menoncin@eco.unibs.it
 Jayant Menon=jmenon@adb.org
 Nidhiya Menon=nmenon@brandeis.edu
 Sudha Venu Menon=sudhavmenon@yahoo.co.in
 Anna Menozzi=anna.menozzi@eco.unipmn.it
 Justice Tei Mensah=myjumens@gmail.com
 Paul Mensink=pgcmensink@yahoo.com
 Emmanouil Mentzakis=e.mentzakis@soton.ac.uk
 Sławomir Mentzen=smentzen@doktorant.umk.pl
 Jose M. Menudo=jmmenpac@upo.es
 Max-Peter Menzel=menzel@geowiss.uni-hamburg.de
 Fredric Menz=menzf@clarkson.edu
 Guido Menzio=gmenzio@sas.upenn.edu
 Jan-Oliver Menz=jan-oliver.menz@wiso.uni-hamburg.de
 Tobias Menz=tobias.menz@uni-oldenburg.de
 Pierre-Guillaume Méon=pgmeon@ulb.ac.be
 Silvia Mera=sjmera@davivienda.com
 Xavier Méra=xavier.mera@etud.univ-angers.fr
 Magda Mercader-Prats=magda.mercader@uab.es
 Augusto Carlos Mercadier=amercadier@econo.unlp.edu.ar
 Carmelo Mercado Idoeta=carmelo.mercado@urjc.es
 Ruben G. Mercado=benrumercado@gmail.com
 Jean Mercenier=jean.mercenier@u-paris2.fr
 Benoit Mercereau=benoit.mercereau@aya.yale.edu
 John Mercer=jj_mercer@msn.com
 Nicola Merche=nicolamerche@tiscali.it
 Aurelie MERCIER=aurelie.mercier@let.ish-lyon.cnrs.fr
 Samuel MERCIER=samuel.mercier@u-bourgogne.fr
 Jacek W. Mercik=jacek.mercik@pwr.wroc.pl
 Jean-Francois Mercure=jm801@cam.ac.uk
 Lorenzo Mercuri=lorenzo.mercuri@unimib.it
 Fabio Mercurio=fabiomerc@gmail.com
 Vincenzo Merella=merella@unica.it
 Pierre Mérel=pmerel@ethz.ch
 Sascha Mergner=mergner.info@gmx.de
 Thanos Mergoupis=a.mergoupis@bath.ac.uk
 José M. Merigó=jmerigo@ub.edu
 Laura Meriluoto=laura.meriluoto@canterbury.ac.nz
 Christian P. Merkl=christian.merkl@wiso.uni-erlangen.de
 Olaf Merk=olaf.merk@oecd.org
 Silvia Merler=silvia.merler@bruegel.org
 Bruno Merlevede=bruno.merlevede@ugent.be
 Vincent R. Merlin=vincent.merlin@unicaen.fr
 Antonio Merlo=merloa@econ.upenn.edu
 Valeria Merlo=valeria.merlo@uni-tuebingen.de
 Elena Claudia Meroni=elena.meroni@jrc.ec.europa.eu
 Danielle Merrett=daniellemerrett@hotmail.com
 Philip Merrigan=merrigan.philip@uqam.ca
 Ouarda Merrouche=ouarda.merrouche@eui.eu
 Scott Merryman=scott.merryman@gmail.com
 Roy Mersland=roy@microfinance.no
 Elmar Mertens=elmar.mertens@frb.gov
 Jean-François Mertens=jfm@core.ucl.ac.be
 Karel Mertens=km426@cornell.edu
 Vanessa Mertins=mertins@iaaeu.de
 Merter MERT=mertermert@gazi.edu.tr
 Robert C. Merton=rmerton@mit.edu
 Andrea Mervar=mervar@eizg.hr
 Rafael Mery=rafael.mery@udp.cl
 Sergey Merzlyakov=smerzlyakov@hse.ru
 Monika Merz=monika.merz@univie.ac.at
 Guido Stefano Merzoni=guido.merzoni@unicatt.it
 Ramón Javier Mesa Callejas, Sr.=rjmesa@economicas.udea.edu.co
 Diana Carolina Mesa=diana.mesate@urosario.edu.co
 Fernando Mesa=fmesaparra@gmail.com
 Camilo Andrés Mesa Salamanca=cmesas@ucentral.edu.co
 Elena Meschi=elena.meschi@unive.it
 Wouter Mesker=woutermesker@hotmail.com
 France Meslé=mesle@ined.fr
 Celine Meslier Crouzille=celine.meslier@unilim.fr
 Jean-Stéphane Mésonnier=jean-stephane.mesonnier@banque-france.fr
 Sandrine Mesplé-Somps=mesple@dial.prd.fr
 Alexandre Messa=alexandre.silva@ipea.gov.br
 Ahlem Selma Messai=asm_j@hotmail.fr
 Kent D. Messer=messer@udel.edu
 Patrick Messerlin=patrick.messerlin@free.fr
 George Messinis=george.messinis@vu.edu.au
 Matthias Messner=matthias.messner@unibocconi.it
 Stuart Mestelman=mestelma@mcmaster.ca
 Roland Mestel=roland.mestel@uni-graz.at
 Ioana Teodora Mester=imester@uoradea.ro
 Mike Mesterton-Gibbons=mesterto@math.fsu.edu
 Ricardo Mestre=ricardo.mestre@ecb.int
 Theodore Metaxas=metaxas@econ.uth.gr
 Christopher John Metcalf=cmetcalf@ftc.gov
 Renuka Metcalfe=rm18203@yahoo.co.uk
 Gilbert Metcalf=gmetcalf@tufts.edu
 Katarzyna Metelska-Szaniawska=kmetelska@wne.uw.edu.pl
 Jens Metge=jensmetge@gmx.de
 Kivilcim Metin Özcan=kivilcim.metin@gmail.com
 Norbert Metiu=norbert.metiu@bundesbank.de
 Andrew Metrick=metrick@yale.edu
 Tõnis Mets=tonis.mets@ut.ee
 Paul Metzemakers=p.a.j.metzemakers@dnb.nl
 André Meunié=meunie@u-bordeaux4.fr
 Guy MEUNIER=guy.meunier@m4x.org
 Valerie Meunier=vmeunier@compasslexecon.com
 Bénédicte Meurisse=benedicte.meurisse@chaireeconomieduclimat.org
 Dominique Meurs=dominique.meurs@ined.fr
 Dirk Mevis=d.mevis@esm.europa.eu
 Brent Hedlund Meyer=meyerb72@gmail.com
 Camille Roger Meyer=cmeyer@ulb.ac.be
 Christian Johannes Meyer=cmeyer@cgdev.org
 Jürgen Meyerhoff=juergen.meyerhoff@tu-berlin.de
 Ina Meyer=ina.meyer@wifo.ac.at
 Jack Meyer=jmeyer@msu.edu
 Jochen Meyer=mail@jochenmeyer.de
 Margaret Meyer=margaret.meyer@nuffield.ox.ac.uk
 Martin Stephan Meyer=m.s.meyer@sussex.ac.uk
 Moritz Meyer-ter-Vehn=mtv@econ.ucla.edu
 Wiebke Meyer=meyer@iamo.de
 Aidan Meyler=ameyler@eircom.net
 Sérgio Fornazier Meyrelles Filho=fornazier@face.ufg.br
 Felipe Meza=felipe.meza@itam.mx
 Pamphile MEZUI MBENG=mezui@mail.univ-lorraine.fr
 Hatem MHENNI=hatem.mhenni@topnet.tn
 Hugo Marc Mialon=hmialon@emory.edu
 Sue H. Mialon=smialon@emory.edu
 Adil Khan Miankhel=adilmiankhel@hotmail.com
 Jianjun Miao=miaoj@bu.edu
 Yanliang Miao=ymiao@imf.org
 Alejandro Micco=amicco@fen.uchile.cl
 Grzegorz Micek=g.micek@uj.edu.pl
 Maria-Augusta Miceli=augusta.miceli@uniroma1.it
 Thomas Miceli=thomas.miceli@uconn.edu
 Professor Bryane Michael=bryane.michael@eueconomics.org
 Marios Michaelides=mariosm@ucy.ac.cy
 Panayotis G. Michaelides=pmichael@central.ntua.gr
 Katharina Michaelowa=katja.michaelowa@pw.uzh.ch
 Maren M. Michaelsen=maren.michaelsen@rub.de
 Timothy Brian Michael=michael@uhcl.edu
 Julija Michailova=julija_michailova@yahoo.com
 Dimitra Michala=dimitra.michala@uni.lu
 Jan Michalek=michalek@wne.uw.edu.pl
 Karine MICHALON=k_michalon@yahoo.fr
 Charles Michalopoulos=charles.michalopoulos@mdrc.org
 Stelios Michalopoulos=smichalo@brown.edu
 Grzegorz Marek Michalski=grzegorz.michalski@gmail.com
 Sebastian Michalski=smicha@sgh.waw.pl
 Tomasz Kamil Michalski=michalski@hec.fr
 Pierre-Carl Michaud=michaud.pierre_carl@uqam.ca
 David Michayluk=david.michayluk@uts.edu.au
 Claudio Michelacci=c.michelacci@cemfi.es
 Andres Michel=lic.andresmichel@gmail.com
 Alessandra Michelangeli=alessandra.michelangeli@unimib.it
 Valentina Michelangeli=valentina.michelangeli@gmail.com
 Pal Michelberger, Jr.=michelberger.pal@kgk.uni-obuda.hu
 Martin Micheli=martin.micheli@rwi-essen.de
 Silvia Micheli=silviamicheli@unipg.it
 Leo Michelis=michelis@ryerson.ca
 Julie Michel=julie.michel@pue.admin.ch
 Erwann Michel-Kerjan=erwannmk@wharton.upenn.edu
 Jo Michell=jo.michell@uwe.ac.uk
 Carl Christian Michelsen=cmichelsen@eonerc.rwth-aachen.de
 Hope C. Michelson=hopecm@illinois.edu
 Fabio Michelucci=fabiomichelucci@gmail.com
 Elisabetta Michetti=michetti@unimc.it
 Melania Michetti=melania.michetti@feem.it
 Sahra Khaleel Mickaiel=sahra_atta@hotmail.com
 John Micklewright=j.micklewright@ioe.ac.uk
 Paul Gabriel Miclaus=pmiclaus@gmail.com
 Alessandra Micozzi=a.micozzi@univpm.it
 Menno Middeldorp=menno.middeldorp@bankofengland.co.uk
 Paul Middleditch=paul.middleditch@manchester.ac.uk
 Virgiliu Midrigan=virgiliu.midrigan@nyu.edu
 Simon Miegielsen=simon.miegielsen@gmail.com
 Jochen O. Mierau=j.o.mierau@rug.nl
 Fernando Mierzejewski=femierze@lycos.com
 Verónica Mies=vmies@uc.cl
 Topi Miettinen=topi.miettinen@hhs.se
 Giuseppe Migali=g.migali@lancaster.ac.uk
 Matteo Migheli=matteo.migheli@unito.it
 Zouheir Mighri=zmighri@gmail.com
 Petros Migiakis=pmigiakis@bankofgreece.gr
 Carlo Migliardo=cmigliardo@unime.it
 Giuseppina Migliore=giuseppina.migliore@unipa.it
 Anton Miglo=amiglo@bridgeport.edu
 Michel Mignolet=michel.mignolet@fundp.ac.be
 Valérie Mignon=valerie.mignon@u-paris10.fr
 Dimitri Migrow=d.migrow@warwick.ac.uk
 Edward Andrew Miguel=emiguel@econ.berkeley.edu
 Ernest Miguelez=ernest.miguelez@u-bordeaux.fr
 Albici Mihaela=mturmacu@yahoo.com
 Diana Mihaescu=diana.mihaescu@yahoo.com
 Liviu Nicolae MIHAESCU=liviu.mihaescu@ulbsibiu.ro
 Nicolaie Mihaiescu=mihaiescun@yahoo.com
 Marius Iulian Mihailescu=mihmariusiulian@gmail.com
 Alexander Mihailov=a.mihailov@reading.ac.uk
 Mihnea-Stefan Mihai=mihneamihai@web.de
 Sonya Mihaleva=sonya_mihaleva@brown.edu
 Dubravko Mihaljek=dubravko.mihaljek@bis.org
 Peter Mihalyi=peter@mihalyi.com
 Hakan MIHCI=hakan@hacettepe.edu.tr
 Roxana Mihet=roxana.mihet@economics.ox.ac.uk
 Gerda Mihhailova=gerda.mihhailova@ut.ee
 Jiří Mihola=jiri.mihola@quick.cz
 Ilian Mihov=ilian.mihov@insead.edu
 Vassil Mihov=v.mihov@tcu.edu
 Peter Mikek=mikekp@wabash.edu
 O. Mikhail=osmikhail@gmail.com
 Tatiana Mikhailova=tmikhail@gmail.com
 Mia Mikic=mikic@un.org
 Jeanine Miklós-Thal=jeaninethal@gmail.com
 Mikhail Miklyaev=mikhail.miklyaev@gmail.com
 Carlo Milana=carlo.milana@iol.it
 Julien Milanesi=julienmilanesi@yahoo.fr
 Carlo Milani=c.milani@centroeuroparicerche.it
 Fabio Milani=fmilani@uci.edu
 Adelina Prodanova Milanova=nalidea@yahoo.com
 Branko Milanovic=branko_mi@yahoo.com
 Gary John Milante=milante@sipri.org
 Costas Milas=costas.milas@liverpool.ac.uk
 Santo Milasi=santo.milasi@uniroma2.it
 Carine Milcent=milcent@pse.ens.fr
 Stanimira Milcheva=s.milcheva@reading.ac.uk
 Christian Milelli=christian.milelli@u-paris10.fr
 David Kenneth Miles=david.miles@bankofengland.co.uk
 Ian Douglas Miles=ian.miles.manchester@gmail.com
 Gian Maria Milesi-Ferretti=gmilesiferretti@imf.org
 Elitza Mileva=elitza.mileva@gmail.com
 Juliette Milgram=jmilgram@ugr.es
 Paul Milgrom=paul@milgrom.net
 Andreas Milidonis=andreas.milidonis@ucy.ac.cy
 Dragan Miljkovic=dragan.miljkovic@ndsu.edu
 Katherine L. Milkman=kmilkman@wharton.upenn.edu
 Joniada Milla=joniada.milla@uclouvain.be
 Jose Maria Millan=jose.millan@dege.uhu.es
 Patricio Millan Smitmans=patricio_millan@yahoo.com
 Stephen Millard=stephen.millard@bankofengland.co.uk
 Michelle Miller-Adams=miller-adams@upjohn.org
 Alan D. Miller=admiller@econ.haifa.ac.il
 Amalia Rebecca Miller=armiller@virginia.edu
 Ana Corina Miller=millerac@tcd.ie
 Douglas Lee Miller=dlmiller@ucdavis.edu
 Jeffrey B. Miller=millerjf@udel.edu
 J. Isaac Miller=millerjisaac@missouri.edu
 Luis M. Miller=luis.m.miller@gmail.com
 Marcus Miller=marcus.miller@warwick.ac.uk
 Phil Miller=phillip.miller@mnsu.edu
 Riel Miller=rielm@yahoo.com
 Ross Miller=millerrisk@earthlink.net
 Stephen M. Miller=stephen.miller@unlv.edu
 Victoria Miller=miller.victoria@uqam.ca
 Kevin Milligan=kevin.milligan@ubc.ca
 Daniel L. Millimet=millimet@mail.smu.edu
 Chrysovalantou Milliou=cmilliou@aueb.gr
 Edward Lee Millner=emillner@vcu.edu
 Katrin Eleonora Millock=millock@univ-paris1.fr
 Giovanni Millo=giovanni_millo@generali.com
 Albert Millogo=albertmillogo@yahoo.fr
 Pietro Millossovich=pietro.millossovich@econ.units.it
 David C. Mills, Jr.=david.c.mills@frb.gov
 David E. Mills=mills@virginia.edu
 Gordon Mills=gordon.mills@sydney.edu.au
 W. Raymond Mills=mills.7@osu.edu
 Alistair Milne=a.k.l.milne@lboro.ac.uk
 Frank Milne=milnef@qed.econ.queensu.ca
 Robin G. Milne=r.milne@lbss.gla.ac.uk
 Dimitris Milonakis=milonakis@econ.soc.uoc.gr
 Lucia Milone=lmilone@luiss.it
 Jean Milon=jean.milon@orange.fr
 Marius Cristian Milos=mariuscmilos@yahoo.com
 George Milunovich=gmilunov@efs.mq.edu.au
 Yasin Mimir=yasin.mimir@tcmb.gov.tr
 Luisa Maria Mimmi=luisamimmi@gmail.com
 Christian Mina=cdgmina@gmail.com
 Pavol Minarik=pavol.minarik@ujep.cz
 Garabed Minassian=minasian@mail.techno-link.com
 Wasseem Mina=wmina@uaeu.ac.ae
 Minda=alexandre.minda@univ-tlse1.fr
 Alexandru Minea=alexandru.minea@udamail.fr
 André Minella=andre.minella@bcb.gov.br
 Gaetano Alfredo Minerva=ga.minerva@unibo.it
 Heechul Min=minheechul@hotmail.com
 Hong-Ghi Min=hmin@kaist.ac.kr
 Hu Zhi Min=hzmhit@163.com
 Raffaele Miniaci=miniaci@eco.unibs.it
 Elisé Wend-Lassida Miningou=elise.wend-lassida.miningou@usherbrooke.ca
 Lanse Minkler=alanson.minkler@uconn.edu
 Geoffrey Minne=gminne@ulb.ac.be
 Francesco Minnetti=f.minnetti@eco.unicas.it
 Gulnara Minnigaleeva=gminnigaleeva@hse.ru
 Antonio Minniti=antonio.minniti@unibo.it
 Camelia Minoiu=cm2036@columbia.edu
 Kazuo Mino=mino@kier.kyoto-u.ac.jp
 Cristina Beatriz Minolli=cpcbm@cema.edu.ar
 Asier Minondo=aminondo@deusto.es
 Nicholas William Minot=n.minot@cgiar.org
 Simona Caterina Minotti=simona.minotti@unimib.it
 Marco Minozzo=marco.minozzo@univr.it
 Vesselin Mintchev=v.mintchev@abv.bg
 Bart Minten=b.minten@cgiar.org
 Steffen Minter=steffen.minter@vwl.uni-freiburg.de
 Giordano Mion=g.mion@surrey.ac.uk
 Egidio Luis Miotti=miotti.luis@orange.fr
 Marcela Miozzo=marcela.miozzo@mbs.ac.uk
 José Martin Miquel Cabeças=jmm-cabecas@fct.unl.pt
 Josepa Miquel-Florensa=pepita.miquel@tse-fr.eu
 McDonald P. Mirabile=macmirabile@yahoo.com
 Abbas Mirakhor=alhcmirakhor@gmail.com
 Marisa Miraldo=m.miraldo@imperial.ac.uk
 Jose Luis Miralles Marcelo=jlmiralles@unex.es
 Jose Luis Miralles Quiros=miralles@unex.es
 Mar Miralles Quiros=marmiralles@unex.es
 Alfonso Miranda=alfonso.miranda@cide.edu
 José Antonio Miranda=miranda@ua.es
 Mario Javier Miranda=miranda.4@osu.edu
 Mauro Costa Miranda=mauro.miranda@bcb.gov.br
 Jorge Miranda Pinto=jm4bh@virginia.edu
 Rodrigo Cesar de Castro Miranda=rodrigo.miranda@bcb.gov.br
 Jesús Mirás Araujo=jmiras@udc.es
 Eugenio J. Miravete=miravete@eco.utexas.edu
 Mohammad Mirbagherijam=mohammad.mirbagherijam@gmail.com
 Rajmund Mirdala=rajmund.mirdala@tuke.sk
 Seyed Mostafa Mirhedayatian=seyed.mirhedayatian@nhh.no
 Emilian MIRICESCU=miriemil@yahoo.com
 Nikola Mirkov=nikola.mirkov@snb.ch
 Jeffrey A Miron=miron@fas.harvard.edu
 Sebastien Miroudot=sebastien.miroudot@oecd.org
 Hossein Mirshojaeian Hosseini=mirshojaeian@ut.ac.ir
 Donka M. Mirtcheva=mirtchev@tcnj.edu
 Jean Mirucki=jean.mirucki@neuf.fr
 Bilal Mirza=mirza@merit.unu.edu
 Daniel Mirza=daniel.mirza@univ-tours.fr
 Ali Mirzaei=ali.mirzaei@brunel.ac.uk
 Farhad Mirzaei=farmir2005@gmail.com
 Ida Aghdas Mirzaie=mirzaie.1@osu.edu
 Muhammad Shahzad Mirza=m.shahzad.mirza@gmail.com
 Nawazish Mirza=nawazishmirza@gmail.com
 Tokhir Mirzoev=tmirzoev@imf.org
 Nicola Misani=nicola.misani@unibocconi.it
 Florian Misch=misch@zew.de
 Frederic Mishkin=fsm3@columbia.edu
 Anil V. Mishra=a.mishra@uws.edu.au
 Ashok K. Mishra=amishra@lsu.edu
 A.K. Mishra=mishra@iiml.ac.in
 Bhawani Prasad Mishra=bhmishra@gmail.com
 Bikash Ranjan Mishra=bikashranjan.mishra@gmail.com
 Biswambhara Mishra=bmishra_nehu@hotmail.com
 Debasis Mishra=dmishra@isid.ac.in
 Deepak Kumar Mishra=deepak19mishra@gmail.com
 Dev Mishra=mishra@commerce.usask.ca
 Ritesh Kumar Mishra=ritesh.mishradu@gmail.com
 Saurabh Mishra=saurabh.mishra@mcgill.ca
 Sudhanshu Kumar Mishra=mishrasknehu@yahoo.com
 Tapas Mishra=t.k.mishra@swansea.ac.uk
 Vinod Mishra=vinod.mishra@monash.edu
 Miroslav Misina=miroslav.misina@bmo.com
 Biswa Swarup Misra=biswa@ximb.ac.in
 Jaydev Misra=jaydevmisra@gmail.com
 Alessandro Missale=alessandro.missale@unimi.it
 Paul Missios=pmissios@ryerson.ca
 Paolo Emilio Mistrulli=paoloemilio.mistrulli@bancaditalia.it
 Federica Misturelli=federica_misturelli@yahoo.it
 Cristina Mitaritonna=cristina.mitaritonna@cepii.fr
 James Mitchell=james.mitchell@wbs.ac.uk
 Matthew Mitchell=matthew.mitchell@rotman.utoronto.ca
 Paul D. Mitchell=pdmitchell@wisc.edu
 Mitea-Popia Crina-Carmen=pccmitea.mfc@spiruharet.ro
 Yuliyan Mitkov=ymitkov@econ.rutgers.edu
 Barry M. Mitnick=mitnick@pitt.edu
 Oscar A. Mitnik=oscar@mitnik.net
 Anirban Mitra=anirban.mitra@econ.uio.no
 Devashish Mitra=dmitra@maxwell.syr.edu
 Kaushik Mitra=km91@st-andrews.ac.uk
 Theo Mitrakos=tmitrakos@bankofgreece.gr
 Manipushpak Mitra=mmitra@isical.ac.in
 Shalini Mitra=shalini.mitra@liv.ac.uk
 Siddhartha Mitra=mitsid@yahoo.com
 Sophie Mitra=mitra@fordham.edu
 Cristian Mitreanu=cmitreanu@redefiningstrategy.com
 Eugen Mitrica=eugen_mitrica@yahoo.com
 Andreea Mitroi=amitroi@yahoo.com
 Evangelos Mitrokostas=evangelos.mitrokostas@port.ac.uk
 Andreea Mitrut=andreea.mitrut@economics.gu.se
 Constantin Mitrut=cmitrut@ase.ro
 Nikolas Mittag=mittag@uchicago.edu
 Surabhi Mittal=surabhimittal@gmail.com
 Ron Mittelhammer=mittelha@wsu.edu
 Thomas Mittendorf=tm@ivbl.uni-hannover.de
 Narcis Eduard Mitu=mitunarcis@yahoo.com
 Timo Mitze=tmitze@sam.sdu.dk
 Hirotaka Miura=hirotaka.miura@gmail.com
 Yoshiro Miwa=miwa@e.u-tokyo.ac.jp
 Phillip A. Mixon=pamixon@troy.edu
 Kaname Miyagishima=kaname1128@gmail.com
 Kaz Miyagiwa=kmiyagiwa@gmail.com
 Koichi Miyazaki=kmiyazaki@ntu.edu.tw
 Takashi Miyazaki=most_likelihood@yahoo.co.jp
 Kazutoshi Miyazawa=kazu@mail.doshisha.ac.jp
 Kensuke Miyazawa=kensuke.miyazawa@gmail.com
 Alejandra Mizala=amizala@dii.uchile.cl
 Paul Mizen=paul.mizen@nottingham.ac.uk
 Cezary Andrzej Mizia=xcezar@seznam.cz
 Bruce Mizrach=mizrach@econ.rutgers.edu
 Nobuhiro Mizuno=nobu.mizuno8@gmail.com
 Tomomichi Mizuno=mizuno@econ.kobe-u.ac.jp
 Atsue Mizushima=mizushima@res.otaru-uc.ac.jp
 Chipo Mlambo=mlambo@aiffa.org.za
 Lubomir Mlcoch=mlcoch@fsv.cuni.cz
 Hakob Mnatsakanyan=hmnats@gmail.com
 Sam Lovy Mndzebele=samuel.mndzebele@ul.ac.za
 Philippe MOATI=moati@univ-paris-diderot.fr
 Filippo Moauro=moaurof@gmail.com
 Omer Moav=o.moav@warwick.ac.uk
 Ahmed Mushfiq Mobarak=ahmed.mobarak@yale.edu
 Markus Michael Mobius=markusmobius@gmail.com
 Luca Mocarelli=luca.mocarelli@unimib.it
 Diego Nicolas Moccero=diego.moccero@ecb.int
 Sauro Mocetti=sauro.mocetti@bancaditalia.it
 Milkana Atanasova Mochurova=m.mochurova@iki.bas.bg
 Audra I. Mockaitis=audra.mockaitis@monash.edu
 Grigol Modebadze=grigol.modebadze@gmail.com
 Francesca Modena=francesca.modena@bancaditalia.it
 Leonor Modesto=lrm@ucp.pt
 Salvatore Modica=modica@unipa.it
 Juan Ignacio Modroño=juan.modrono@ehu.es
 Michele Modugno=mmodugno@ulb.ac.be
 Klaus Moeltner=moeltner@vt.edu
 Emanuel Moench=emanuel.moench@ny.frb.org
 Karl Ove Moene=k.o.moene@econ.uio.no
 Jarle Møen=jarle.moen@nhh.no
 Jon Roger Moen=jmoen@olemiss.edu
 Nigel Moes=nmoes@feweb.vu.nl
 Philippe Moës=philippe.moes@nbb.be
 Marc-Daniel Moessinger=moessinger@zew.de
 Thorvald Grung Moe=thorvald.moe@norges-bank.no
 John Moffat=john.moffat@durham.ac.uk
 Peter Grant Moffatt=p.moffatt@uea.ac.uk
 Robert Moffitt=moffitt@jhu.edu
 Liliana Mihaela Moga=liliana.moga@gmail.com
 Matteo Mogliani=matteo.mogliani@banque-france.fr
 Magne Mogstad=magne.mogstad@gmail.com
 Philippe Moguérou=philippe.moguerou@univ-rouen.fr
 Tewodaj Mogues=t.mogues@cgiar.org
 Kamiar Mohaddes=km418@cam.ac.uk
 Mohamad Akbar Noor Bin Mohamad Noor=mohamadakbarnoor@yahoo.co.uk
 بروفيسور عصام عبد الوهاب محمد (Issam A. W. Mohamed)=issamawmohamed@hotmail.com
 Norashidah Mohamed Nor=norashidah@putra.upm.edu.my
 Ben Ali Mohamed Sami=benali_med_sami@yahoo.com
 Ali Mohammadi=ali.mohammadi@indek.kth.se
 Soleiman Mohammadi Limaei=limaei@guilan.ac.ir
 Irfan Mohammad=m@irfans.org
 Shapour Mohammadi=shmohammadi@gmail.com
 Aliyu Dahiru Mohammed=alitahir797@yahoo.com
 Ramesh Mohan=rmohan@bryant.edu
 Sushil Mohan=s.mohan@brighton.ac.uk
 Itismita Mohanty=itismita.mohanty@natsem.canberra.edu.au
 Madhusudan Mohanty=madhusudan.mohanty@bis.org
 Ruzita Mohd. Amin=ruzita@iium.edu.my
 Lukas Mohelsky=lukasmohis@yahoo.com
 Ghulam Mohey-ud-din=economist.pk@gmail.com
 Muhammad Mohiuddin=muhammad.mohiuddin.1@ulaval.ca
 Erik Mohlin=erik.mohlin@nuffield.ox.ac.uk
 Philipp Mohl=philipp.mohl@ec.europa.eu
 Pierre Mohnen=mohnen@merit.unu.edu
 Klaus Mohn=klaus.mohn@uis.no
 Jens Mohrenweiser=mohrenweiser@zew.de
 Matthias Mohr=matthias.mohr@ecb.int
 Peter N.C. Mohr=peter.mohr@decision-neuroscience.eu
 Hasan Muhammad Mohsin=hasanmuhammadmohsin@gmail.com
 Mohammed Mohsin=mmohsin@utk.edu
 Hamid Mohtadi=mohtadi@uwm.edu
 Simon Mohun=s.mohun@qmul.ac.uk
 Bogdan-Gabriel Moinescu=bogdan.moinescu@fin.ase.ro
 Daniel Moise=moisedaniel@gmail.com
 Mihaela Moise=mihaela_moise@yahoo.com
 Florentina Moisescu=florym2003@yahoo.com
 Ovidiu Ioan MOISESCU=ovidiu.moisescu@gmail.com
 Fabien MOIZEAU=fabien.moizeau@univ-rennes1.fr
 Benoit Mojon=benoit.mojon@gmail.com
 Nikica Mojsoska-Blazevski=nikica@uacs.edu.mk
 Vahid Mojtahed=v.mojtahed@unive.it
 Patricia Lyon Mokhtarian=patmokh@gatech.edu
 Manouchehr Mokhtari=mokhtari@umd.edu
 Thai-Yoong Penny Mok=penny.mok@treasury.govt.nz
 Wallace K C Mok=wallacemok@cuhk.edu.hk
 Simona Mola=molayosts@sec.gov
 Ioana R. Moldovan=ioana.moldovan@glasgow.ac.uk
 Benny Moldovanu=mold@uni-bonn.de
 Juan Carlos Molero=jcmolero@unav.es
 Miguel Molico=mmolico@bankofcanada.ca
 Angel Luis Molina, Jr.=angel_l_molina_jr@pols.tamu.edu
 Carlos A. Molina=carlos.molina@iesa.edu.ve
 Danielken Molina=danielkenm@iadb.org
 Ezequiel Molina=ezequiel.molina@gmail.com
 Teresa Molina Millan=teresamolin@gmail.com
 Andrea Molinari=molinari@econ.uba.ar
 Benedetto Molinari=molinari@upo.es
 Massimo Molinari=massimo.molinari@uniroma1.it
 Luis Molina Sánchez=lmolina@bde.es
 Oscar Jorge Molina Tejerina=oscarmolina@lp.upb.edu
 Vasco Molini=vmolini@worldbank.org
 Elena Molis=emolis@ugr.es
 Joachim Möller=joachim.moeller@wiwi.uni-regensburg.de
 Marc Möller=marc.moeller@vwi.unibe.ch
 Niels Framroze Møller=nfmo@dtu.dk
 Stig Vinther Møller=svm@asb.dk
 Peter Møllgaard=hpm.eco@cbs.dk
 Andre Varella Mollick=amollick@utpa.edu
 Maria de Lourdes Rollemberg Mollo=mlmollo@unb.br
 Molnár, József=jomol72@yahoo.com
 Margit Molnar=mrgtmolnar@gmail.com
 Maria Molnar=mariamolnar2004@gmail.com
 Mariya Molodchik=mmolodchik@hse.ru
 Kim Moloney=contact@neilkim.com
 Ernest Lytia Molua=emolua@gmx.net
 Lynette Molyneaux=l.molyneaux@uq.edu.au
 Philip Molyneux=p.molyneux@bangor.ac.uk
 Robert E. Molzon=molzon@ms.uky.edu
 Daphne Momferatou=daphne.momferatou@ecb.europa.eu
 Takeshi Momi=tmomi@mail.doshisha.ac.jp
 Vladimir Momot=vmomot@mail.ru
 Tommaso Monacelli=tommaso.monacelli@unibocconi.it
 Kristen Monaco=kmonaco@csulb.edu
 Ton Monasso=ton@tonmonasso.nl
 Vassilis Monastiriotis=v.monastiriotis@lse.ac.uk
 Pietro Moncada-Paternò-Castello=pietro.moncada-paterno-castello@ec.europa.eu
 Pedro Esteban Moncarz=pedro.moncarz@gmail.com
 Daniel Charles Monchuk=dmonchuk@gmail.com
 Barbara Monda=barbara.monda@polimi.it
 Debasis Mondal=debasis.mondal.1978@gmail.com
 Jordi Mondria=jordi.mondria@utoronto.ca
 Alessio Moneta=amoneta@sssup.it
 Chiara Monfardini=chiara.monfardini@unibo.it
 Alain Monfort=monfort@ensae.fr
 Frank Anthony Monforte=frank.monforte@itron.com
 Saint-Martin MONGAN AGBESHIE=stmartin.mongan@gmail.com
 Juan Carlos Mongan, Sr.=carlosmongan@hotmail.com
 Joannes Mongardini=jmongardini@imf.org
 Jorge Mongay=jorge.mongay@esic.edu
 Francesco Paolo Mongelli=francesco.mongelli@ecb.europa.eu
 Steeve Mongrain=mongrain@sfu.ca
 Samuel Mongrut Montalván=smongrut@itesm.mx
 Sylvette Monier-Dilhan=sylvette.monier@toulouse.inra.fr
 António Brandão Moniz=antonio.moniz@kit.edu
 Bernard Monjardet=bernard.monjardet@univ-paris1.fr
 Diogo Monjardino de Souza Monteiro=d.m.souza-monteiro@kent.ac.uk
 Stéphanie Monjon=stephanie.monjon@dauphine.fr
 Benjamin Monnery=monnery@gate.cnrs.fr
 Cyril Monnet=cyril.monnet@gmail.com
 Eric Monnet=monnet@pse.ens.fr
 Salvatore Monni=salvatore.monni@uniroma3.it
 Elisa Monnot=elisa.monnot@u-cergy.fr
 George Monokroussos=monokroussos@gmail.com
 Zoltán Monostori=monostori.z@gmail.com
 Fabio Monsalve=fabio.monsalve@uclm.es
 Erik Monsen=erik.monsen@strath.ac.uk
 Solita Collas Monsod=solita_monsod@yahoo.com
 Toby Melissa C. Monsod=tcmonsod@up.edu.ph
 Sandro Eduardo Monsueto=sandro.monsueto@gmail.com
 Josef Montag=josef.montag@gmail.com
 Alberto Montagnoli=a.montagnoli@sheffield.ac.uk
 Pierluigi Montalbano=pierluigi.montalbano@uniroma1.it
 Pedro Montalvo=pmontalv@andinanet.net
 Giovanni Montana=g.montana@imperial.ac.uk
 Lisa Montanari=lisa.montanari@unibo.it
 Antonio Montañés=amontane@unizar.es
 Jean-Marc Montaud=jean-marc.montaud@univ-pau.fr
 Daniel Monte=daniel.monte@fgv.br
 Libero Monteforte=libero.monteforte@bancaditalia.it
 Goncalo Monteiro=gm43@buffalo.edu
 Henrique Pedro Currais Monteiro=henrique.monteiro@iscte.pt
 Jose-Antonio Monteiro=jose-antonio.monteiro@unine.ch
 Natalia Pimenta Monteiro=n.monteiro@eeg.uminho.pt
 Rui Monteiro=rsm@fe.unl.pt
 Sérgio Marley Modesto Monteiro=sergio.monteiro@ufrgs.br
 Wagner Oliveira Monteiro=wagnerom@hotmail.com
 Roberto Luís de Melo Monte-Mór=montemor@cedeplar.ufmg.br
 Roberto Montero-Granados=montero@ugr.es
 José-María Montero=jose.mlorenzo@uclm.es
 Casto Martin Montero Kuscevic=km42@aub.edu.lb
 Paola L. Montero Ledezma=paola.montero@ne.su.se
 Maria Montero=maria.montero@nottingham.ac.uk
 Miquel Montero=miquel.montero@ub.edu
 Ricardo Montero=ricmonpie@gmail.com
 Rodrigo Montero=rodrigo.montero@udp.cl
 Roque Esteban Montero=rmontero@econ.rutgers.edu
 Javier Monterrey=jmonterrey@yahoo.com
 Ana Montes=anmontes@um.es
 Aldo Montesano=aldo.montesano@unibocconi.it
 Gabriel Montes Rojas=gabriel.montes-rojas.1@city.ac.uk
 Christian Montet=christian.montet@upf.pf
 Joao Montez=jmontez@london.edu
 Francesca Monti=francesca.monti@bankofengland.co.uk
 Natalia Montinari=natalia.montinari@nek.lu.se
 Anna Montini=anna.montini@unibo.it
 Paola Monti=paola.monti@unibocconi.it
 Raymond Michel Montizaan=r.montizaan@maastrichtuniversity.nl
 Claude Montmarquette=montmarc@cirano.qc.ca
 Fabio Montobbio=fabio.montobbio@unibocconi.it
 Daniel Montolio=montolio@ub.edu
 Judit Montoriol Garriga=montoriol@gmail.com
 Carlos Montoro=carlos.montoro@bis.org
 Jaime Alberto Montoya Arbeláez=montoyajaime@live.com
 Miguel Angel Montoya=mmontoya@itesm.mx
 Ricardo Montoya=rm2183@columbia.edu
 Victor M. Montuenga Gomez=victor.montuenga@unizar.es
 Alejandro Montufar Helu Jiménez=ale_helu@hotmail.com
 Luisa Montuschi=lm@cema.edu.ar
 Ignacio Monzon=ignacio@carloalberto.org
 Dilip Mookherjee=dilipm@bu.edu
 Pahlaj Moolio=pahlajmoolio@gmail.com
 Catherine Tyler Mooney=ctmooney@ou.edu
 Hyungsik Roger Moon=moonr@usc.edu
 Ellen Moons=ellen.moons@econ.kuleuven.ac.be
 Seongman Moon=smoon@eco.uc3m.es
 Kyle Thomas Moore=k.t.moore@lse.ac.uk
 Michael John Moore=m.moore2811@btinternet.com
 Robert E. Moore=rmoore@gsu.edu
 Simon C. Moore=mooresc2@cardiff.ac.uk
 Winston Ricardo Moore=winston.moore@cavehill.uwi.edu
 Jorge Mora-Alfaro=jorpili@ice.co.cr
 Alexander Moradi=a.moradi@sussex.ac.uk
 Andre Steffens Moraes=andre.moraes@embrapa.br
 Roberto Camps Moraes=bobcamps@portoweb.com.br
 Jose Luis Moraga-Gonzalez=j.l.moraga.gonzalez@rug.nl
 Juan Mora=juan@merlin.fae.ua.es
 Enrique Moral-Benito=enrique.moral@gmail.com
 Alfonso Moral de Blas=amoral@eco.uva.es
 Adriana Paola Morales Acevedo=amoralac@gmail.com
 Antonio J Morales=amorales@uma.es
 L. Emilio Morales=emilio.morales@une.edu.au
 Leonardo Fabio Morales=zurito75@gmail.com
 Marco Morales=marco.morales@udp.cl
 Jorge Morales Meoqui=jorgemorales3@gmail.com
 Miguel Ángel Morales Mosquera=mmoralmo@banrep.gov.co
 Carlos Morales-Torrado=moralec@gmail.com
 María José Moral=mjmoral@cee.uned.es
 Claudio Morana=claudio.morana@unimib.it
 Nada Mora=nada.mora@kc.frb.org
 Alan Moran=amoran@ipa.org.au
 Felipe Morandé=fmorande@fen.uchile.cl
 Olivier Morand=olivier.morand@uconn.edu
 Pierre-Henri Morand=pierre-henri.morand@univ-avignon.fr
 Kevin Moran=kmoran@ecn.ulaval.ca
 Peter Moran=pmoran@lbs.ac.uk
 Theodore Harvey Moran=morant@georgetown.edu
 Cristina Morar Triandafil=cristina_triandafil@yahoo.com
 Teodor Adrian Morar Triandafil=consultantbancar@yahoo.com
 Toni Mora=tmora@uic.es
 Franck Moraux=franck.moraux@univ-rennes1.fr
 Ricardo Mora Villarrubia=ricmora@eco.uc3m.es
 Leszek Morawski=lmorawski@wne.uw.edu.pl
 Marcello Morciano=m.morciano@uea.ac.uk
 Randall Morck=randall.morck@ualberta.ca
 Gabriela Mordecki=gabriela@iecon.ccee.edu.uy
 Jonathan Morduch=jonathan.morduch@nyu.edu
 G. Brant Morefield=brant_morefield@abtassoc.com
 Ajax R. B. Moreira=ajaxmoreira@gmail.com
 Guilherme Guimarães Moreira=ggmcipo@gmail.com
 Humberto Luiz Ataide Moreira=humberto@fgv.br
 Marcelo J. Moreira=moreira.marcelo.j@gmail.com
 Maria do Rosário Moreira=mrosario@fep.up.pt
 Mauricio Mesquita Moreira=mauriciomm@iadb.org
 Paulo Jorge Pires Moreira=ppmoreira@live.com.pt
 Sandrina Berthault Moreira=sandrina.moreira@esce.ips.pt
 Tito Belchior Silva Moreira=tito@pos.ucb.br
 Salvatore Morelli=salvatore.morelli@gmail.com
 Alejandro Tatsuo Moreno=atatsuo@hotmail.com
 Antonio Moreno=antmoreno@unav.es
 Bernardo Moreno=bernardo@uma.es
 Juan Carlos Moreno-Brid=juancarlos.moreno@cepal.org
 Juan B. Moreno-Cruz=morenocruz@gatech.edu
 David Moreno, Sr.=jdmoreno@emp.uc3m.es
 Ines Moreno de Barreda=ines.morenodebarreda@economics.ox.ac.uk
 Diego Moreno=diego.moreno@uc3m.es
 Frede Moreno=ederfonorem@yahoo.com
 Luis José Moreno Garrido, Sr.=luisjoseblas@gmail.com
 José Fernando Moreno Gutiérrez=jmorengu@banrep.gov.co
 Lourdes Moreno=lmoreno@ccee.ucm.es
 Manuel Moreno=manuel.moreno@uclm.es
 Rosina Moreno=rmoreno@ub.edu
 Rocio del Pilar Moreno-Sanchez=rociomoreno@yahoo.com
 Juan D. Moreno-Ternero=jdmoreno@upo.es
 Hernán Alejandro Morero=hernanmorero@eco.uncor.edu
 Andrea Morescalchi=andrea.morescalchi@gmail.com
 Barbara Moreschi=barbara.mo@libero.it
 Anna Moretti=anna.moretti@unive.it
 Laura Moretti=moretti@ifk-cfs.de
 Enrico Moretto=enrico.moretto@uninsubria.it
 Edward R. Morey=edward.morey@colorado.edu
 Angela G. Morgan=am@clemson.edu
 Ash Morgan=morganoa@appstate.edu
 Matteo Morgandi=mmorgandi@worldbank.org
 Donald P. Morgan=don.morgan@ny.frb.org
 Horatio M. Morgan=horatio.morgan@ryerson.ca
 Jacqueline Morgan=morgan@unina.it
 Julian Morgan=julianbmorgan@netscape.net
 Kimberly Ludwig Morgan=klmorgan@vt.edu
 Stephen L. Morgan=s.morgan@nottingham.ac.uk
 Edgar Morgenroth=edgar.morgenroth@esri.ie
 Richard D. Morgenstern=morgenstern@rff.org
 Allexandro Emmanuel Mori Coelho=allexandro_coelho@yahoo.com.br
 Chiaki Moriguchi=chiaki@ier.hit-u.ac.jp
 Antonio Morillas=morillas@uma.es
 Masaki Mori=rstmm@nus.edu.sg
 Takayki Morimoto=morimot@kwansei.ac.jp
 François Morin=morin@univ-tlse1.fr
 Louis-Philippe Morin=lmorin@uottawa.ca
 Jacques Morisset=jmorisset@worldbank.org
 Hodaka Morita=h.morita@unsw.edu.au
 Tatsuo Mori=mori@cc.hirosaki-u.ac.jp
 Tomoya Mori=mori@kier.kyoto-u.ac.jp
 Michael Moritz=michael.moritz@iab.de
 Morten Raun Mørkbak=mrm@sam.sdu.dk
 Eva Mörk=eva.mork@nek.uu.se
 Bruce Morley=bm232@bath.ac.uk
 James Morley=james.morley@unsw.edu.au
 Isabella Morlini=isabella.morlini@unimore.it
 Pauline Mornet=mornet@lameta.univ-montp1.fr
 Andrea Moro=andrea@andreamoro.net
 Beniamino Moro=moro@unica.it
 Ana Isabel Moro-Egido=aimoro@ugr.es
 Mirko Moro=mirko.moro@stir.ac.uk
 Andrea Morone=a.morone@gmail.com
 Eduardo Moron=emoron@up.edu.pe
 Piergiuseppe Morone=piergiuseppe.morone@uniroma1.it
 Lucia Morosan-Danila=luciadanila@gmail.com
 Alina Moroşanu=alynamorosanu@yahoo.com
 Sérgio Moro=scmoro@gmail.com
 Ottorino Morresi=ottorino.morresi@uniroma3.it
 Michael A. Morrisey=morrisey@uab.edu
 Alan Morrison=alan.morrison@sbs.ox.ac.uk
 Andrea Morrison=a.morrison@uu.nl
 Clarence Clapp Morrison=morrison@indiana.edu
 William Morrison=wmorrison@wlu.ca
 Sebastian Morris=morris@iimahd.ernet.in
 Stephen Morris=smorris@princeton.edu
 Stephen Morris=steve.morris@ucl.ac.uk
 John Miles Morrow=morrow1@hushmail.com
 Peter M. Morrow=peter.morrow@utoronto.ca
 Joel N. Morse=jmorse@ubalt.edu
 Olivier Mortehan=omorteha@ulb.ac.be
 Julie Holland Mortimer=julie.mortimer.2@bc.edu
 Leena M Morttinen=leena.morttinen@nordea.com
 Martin Moryson=mmoryson@web.de
 Maricica Moscalu=mari.moscalu@yahoo.com
 Manuela Mosca=manuela.mosca@unisalento.it
 Michele Mosca=michele.mosca@unina.it
 Giuseppe Moscarini=giuseppe.moscarini@yale.edu
 Ivan Moscati=ivan.moscati@unibocconi.it
 Luigi Moschera=moschera@uniparthenope.it
 GianCarlo Moschini=moschini@iastate.edu
 Julius Moschitz=julius@moschitz.at
 Robert Mosch=robertmosch@hotmail.com
 Francesco Moscone=francesco.moscone@brunel.ac.uk
 Rocco Mosconi=rocco.mosconi@polimi.it
 Paul Moser-Boehm=paul.moser-boehm@bis.org
 James T. Moser=moser@american.edu
 Mathias Moser=matmoser@wu.ac.at
 Petra Moser=pmoser@stanford.edu
 Michael Moses=mmoses@stern.nyu.edu
 Saeed Moshiri=saeedmoshiri@hotmail.com
 Ramaele Moshoeshoe=rmoshoeshoe@gmail.com
 Gerard Mosiej=gmosiej@tlen.pl
 Alejandro Mosiño=alejandro.mosino@ugto.org
 Solmaz Moslehi=solmaz.moslehi@monash.edu
 Karl Mosler=mosler@statistik.uni-koeln.de
 Paul Mosley=p.mosley@shef.ac.uk
 Charles B Moss=cbmoss@ufl.edu
 Tarek Mostafa=t.mostafa@ioe.ac.uk
 Mehdi Mostaghimi=mehdi@mostaghimi.net
 Fábio Batista Mota=motafb@hotmail.com
 Isabel Mota=imota@fep.up.pt
 Mesbah John Motamed=mmotamed@ers.usda.gov
 Rui Pedro Mota=rmota@ist.utl.pt
 Pascale Combes Motel=pascale.motel_combes@udamail.fr
 Elisabet Motellón=emotellon@ub.edu
 Caroline Danièle Mothe=caroline.mothe@univ-savoie.fr
 Meryl Isobel Motika=mmotika@uci.edu
 Kazuyuki Motohashi=motohashi-kazuyuki@rieti.go.jp
 Maurizio Motolese=maurizio.motolese@unicatt.it
 Alberto Motta=motta@unsw.edu.au
 Giorgio E. Motta=g.motta@lancaster.ac.uk
 Massimo Motta=massimo.motta@upf.edu
 Pierre von Mouche=pvmouche@yahoo.fr
 El Mouhoub MOUHOUD=em.mouhoud@dauphine.fr
 Mustapha Moulai=mmoulai@usthb.dz
 Sonia Moulet=sonia.moulet@gmail.com
 Eric Moulines=moulines@tsi.enst.fr
 Herve Moulin=herve.moulin@glasgow.ac.uk
 Léonard Moulin=leonard.moulin@ens-cachan.org
 Brent R. Moulton=brent.moulton@bea.gov
 Dean Clarence Mountain=mountain@mcmaster.ca
 Andrew Mountford=a.mountford@rhul.ac.uk
 Heitor Moura Filho=heitormoura@yahoo.com.br
 Filipe Moura=fmoura@ist.utl.pt
 Marcelo L. Moura=marcelom@insper.edu.br
 Paulo Mourão=paulom@eeg.uminho.pt
 Kostas Mouratidis=k.mouratidis@sheffield.ac.uk
 Susana Mourato=s.mourato@lse.ac.uk
 Ismael MOURIFIÉ=ismael.mourifie@utoronto.ca
 Annabelle Mourougane=annabelle.mourougane@gmail.com
 Gilles MOURRE=gilles.mourre@ec.europa.eu
 Julien Mousquès=mousques@irdes.fr
 Zakaria Moussa=zakaria.moussa@univ-nantes.fr
 Thomas Moutos=tmoutos@aueb.gr
 Mohammad Movahedi=mohammad.movahedi@unicaen.fr
 Vahagn Movsesyan=vahagn.movsesyan@edhec.edu
 Andres Moya=a.moya@uniandes.edu.co
 Musa Moya=musamoya@yahoo.com
 Jose Moyano-Fuentes=jmoyano@ujaen.es
 Stéphane Moyen=stephane.moyen@bundesbank.de
 Patrick Moyes=patrick.moyes@u-bordeaux4.fr
 Busani Moyo=myxbus001@gmail.com
 Anne Moysan Louazel=anne.moysan-louazel@univ-rennes1.fr
 Monika Mrazova=m.mrazova@surrey.ac.uk
 Mico Mrkaic=mmrkaic@imf.org
 Omid M. Rouhani=om67@cornell.edu
 Thomas A. Mroz=tmroz@clemson.edu
 Siwa Msangi=s.msangi@cgiar.org
 Elibariki Emmanuel Msuya=mzeeba@hotmail.com
 Elvis Mtonga=fellymtonga1@yahoo.com
 Edwin Muchapondwa=edwin.muchapondwa@uct.ac.za
 Johannes Muck=johannes.muck@dice.hhu.de
 Ram Mudambi=ram.mudambi@temple.edu
 Shannon Mudd=smudd@haverford.edu
 Samuel Muehlemann=muehlemann@bwl.lmu.de
 John Muellbauer=john.muellbauer@nuffield.ox.ac.uk
 Barbara Mueller=barbara.mueller@unibas.ch
 Bernardo Mueller=bmueller@unb.br
 Bettina Mueller=bettina.mueller@zew.de
 Carsten Vernon Mueller=carsten.mueller@gmx.eu
 Daniel Mueller=dani.mueller@unibas.ch
 Dennis C. Mueller=dennis.mueller@univie.ac.at
 Elisabeth Mueller=e.mueller@fs.de
 Mueller-Langer=frank.mueller-langer@ip.mpg.de
 Pamela Mueller=pamela.mueller@gmx.net
 Philippe Mueller=p.mueller@lse.ac.uk
 Richard Mueller=richard.mueller@uleth.ca
 Marc-Andreas Muendler=muendler@ucsd.edu
 Ruud Muffels=ruud.j.muffels@uvt.nl
 Amin W. Mugera=amin.mugera@uwa.edu.au
 Hammad Ul Haq Mughal=hammad.mughal@yahoo.com
 Khalid Mahmood Mughal=drkhalid0@gmail.com
 Mazhar Yasin Mughal=mazharmughal@free.fr
 Andrew Muhammad=amuhammad@ers.usda.gov
 Nabeel Muhammad=nabeel_muhammad1@hotmail.com
 Basilio Zefanias Muhate=basilio.muhate@gmail.com
 Martin Mühleisen=mmuhleisen@imf.org
 Tony Muhumuza=tony.muhumuza@gmail.com
 Leonel Muinelo Gallo=lmuinelo@iecon.ccee.edu.uy
 Dirk Muir=dmuir@imf.org
 Vai-Lam Mui=vai-lam.mui@buseco.monash.edu.au
 Sujoy Mukerji=sujoy.mukerji@economics.ox.ac.uk
 Bulat Mukhamediyev=bmukhamediyev@gmail.com
 Anit N. Mukherjee=anit@nipfp.org.in
 Arijit Mukherjee=arijit@msu.edu
 Debasri Mukherjee=debasri.mukherjee@wmich.edu
 Deepraj Mukherjee=dmukherj@kent.edu
 Dipa Mukherjee=medipa@rediffmail.com
 Sacchidananda Mukherjee=sachs.mse@gmail.com
 Sanchita Mukherjee=sanchitam@gmail.com
 Saptarshi Mukherjee=saptarshi.isi@gmail.com
 Shibashis Mukherjee=shish.eco@gmail.com
 Shrabani Mukherjee=shrabani0808@gmail.com
 Soumyatanu Mukherjee=lexsm16@nottingham.ac.uk
 Vivekananda Mukherjee=mukherjeevivek@hotmail.com
 Zinnia Mukherjee=zinnia.mukherjee@simmons.edu
 Pundarik Mukhopadhaya=pundarik.mukhopadhaya@mq.edu.au
 Abhiroop Mukhopadhyay=abhiroop@isid.ac.in
 Bappaditya Mukhopadhyay=bappa@mdi.ac.in
 Dripto Mukhopadhyay=dripto.mukhopadhyay@gmail.com
 Lekha Mukhopadhyay=lekhamukherjee@msn.com
 Megha Mukim=mmukim@worldbank.org
 Toshihiko Mukoyama=toshihiko.mukoyama@gmail.com
 Admir Mulaj=amulaj@yahoo.com
 Ismir Mulalic=imu@transport.dtu.dk
 Carlos Mulas-Granados=cmulasgr@ucm.es
 Abay Mulatu=a.mulatu@londonmet.ac.uk
 Machiel Mulder=machiel.mulder@acm.nl
 Nanno Mulder=nanno.mulder@eclac.org
 Peter Mulder=p.mulder@vu.nl
 Kranti Mulik=kmulik@ucsusa.org
 Marcella Mulino=marcella.mulino@univaq.it
 Benoît MULKAY=benoit.mulkay@univ-montp1.fr
 John Mullahy=jmullahy@wisc.edu
 Sendhil Mullainathan=mullain@fas.harvard.edu
 Conner Mullally=connerm@ufl.edu
 Joseph E. Mullat=jm@datalaundering.com
 Kathleen J. Mullen=kmullen@rand.org
 Adrian Muller=adrian.mueller@fibl.org
 Alfred Müller=mueller@mathematik.uni-siegen.de
 Andrew Muller=mullera@mcmaster.ca
 Benjamin Müller=benjamin.mueller@snb.ch
 Christophe MULLER=christophe.muller@univ-amu.fr
 Daniel Müller=mueller@iamo.de
 Hans Christian Müller=mueller2@dice.uni-duesseldorf.de
 Julia Müller=jmuller@ese.eur.nl
 Marlene Müller=marlene.mueller@gmx.de
 Nikolas Müller-Plantenberg=nikolas@mullerpl.net
 Victor Octavian Müller=vmuller@econ.ubbcluj.ro
 Walter Joseph Muller, III=walter.j.muller@bankofamerica.com
 Werner G. Müller=werner.mueller@jku.at
 Gordon Mulligan=mulligan@email.arizona.edu
 James G. Mulligan=mulligaj@udel.edu
 Millan L. B. Mulraine=millan.mulraine@utoronto.ca
 Karen A. Mumford=karen.mumford@york.ac.uk
 Kevin J. Mumford=mumford@purdue.edu
 Soofia Mumtaz=soofia@pide.org.pk
 Luciano Munari=luciano.munari@unipr.it
 Abdul Munasib=munasib@uga.edu
 Lalith Munasinghe=lm25@columbia.edu
 Max Munday=mundaymc@cf.ac.uk
 Yair Mundlak יאיר מונדלק=mundlak@agri.huji.ac.il
 Kusum Mundra=kmundra@andromeda.rutgers.edu
 Luigi Mundula=luigimundula@unica.it
 Jonathan Munemo=jxmunemo@salisbury.edu
 Michael Munger=munger@duke.edu
 Dr. Oswald Kombe Mungule, PhD=oswald.mungule@cbu.ac.zm
 Daniel MÜNICH=daniel.munich@cerge-ei.cz
 Kashif Munir=kashif_ok@hotmail.com
 Joseph Muchai Muniu=muchaimuniu@gmail.com
 Poonam Munjal=pmunjal@ncaer.org
 Murat Khairzhan-uli Munkin=mmunkin@coba.usf.edu
 Fernando Muñoz-Bullón=fernando.munoz@uc3m.es
 Félix-Fernando Muñoz=felix.munoz@uam.es
 Francisco David Munoz=francisco.munoz@jhu.edu
 pablo antonio Muñoz Gallego=pmunoz@usal.es
 Felix Munoz-Garcia=fmunoz@wsu.edu
 Manuel Muñoz-Herrera=e.m.munoz.herrera@rug.nl
 Juan Sebastian Munoz=jsmunoz@iadb.org
 Juan Carlos Muñoz-Mora=jcmunozmora@gmail.com
 Ercio Andrés Muñoz Saavedra=ercio.andres@gmail.com
 Alistair Munro=alistair-munro@grips.ac.jp
 Darla K. Munroe=munroe.9@osu.edu
 John H. A. Munro=john.munro@utoronto.ca
 Farzana Munshi=fmunshi@bracu.ac.bd
 kaivan Munshi=munshi@econ.cam.ac.uk
 Mihaela-Carmen Muntean=mihaela_c_muntean@yahoo.com
 Alin Munteanu=a_munteanu@yahoo.com
 Ionica Munteanu=ionica.munteanu@gmail.com
 Valentin Munteanu=valentin.munteanu@feaa.uvt.ro
 Ignacio Munyo=imunyo@ceres-uy.org
 Sonja Munz=sonja.munz@hm.edu
 Yaz Gulnur Muradoglu=y.g.muradoglu@qmul.ac.uk
 S. M. Woahid Murad=woahidmurad@ymail.com
 Balazs Murakozy=murakozy@econ.core.hu
 Karthik Muralidharan=kamurali@ucsd.edu
 Bogdan Muraraşu=bogdanmurarasu@yahoo.com
 Roberto Mura=roberto.mura@mbs.ac.uk
 Yasutomo Murasawa=murasawa@eco.osakafu-u.ac.jp
 Marina Murat=marina.murat@unimore.it
 Yusuf Muratoğlu=yusufmuratoglu@hitit.edu.tr
 Александр Муравьев (Alexander Muravyev)=muravyev@iza.org
 Mayumi Murayama=murayama@ide.go.jp
 Raviv Murciano-Goroff=ravivmg@post.harvard.edu
 James C. Murdoch=murdoch@utdallas.edu
 Johannes Mure=johannes.mure@bbt.admin.ch
 Ren Mu=rmu@tamu.edu
 Astri Muren=astri.muren@ne.su.se
 Aurora Murgea=aurora.murgea@feaa.uvt.ro
 Maurizio Murgia=maurizio.murgia@unibz.it
 Beatriz Muriel H.=beatriz_muriel@hotmail.com
 Carmen Murillo=murilloc@unican.es
 Chris Muris=cmuris@sfu.ca
 Johann Peter Murmann=repec@professor-murmann.net
 Mawar Murni Yunus=mawarmurni@kuis.edu.my
 Juan Muro=juan.muro@uah.es
 Anthony Murphy=anthony.murphy@dal.frb.org
 Daniel Patrick Murphy=murphyd@darden.virginia.edu
 Gavin Murphy=gavin.murphy@esri.ie
 James J. Murphy=murphy@uaa.alaska.edu
 Kevin Murphy=kjmurphy@usc.edu
 Robert G. Murphy=murphyro@bc.edu
 Roy Emerson Murphy=roymurphy@computer.org
 Cameron K. Murray=ckmurray@gmail.com
 Matthew N. Murray=mmurray1@utk.edu
 Michael J. Murray=mmurray@bemidjistate.edu
 Peter Murrell=murrell@econ.umd.edu
 Pierluigi Murro=pmurro@luiss.it
 Antu Murshid=amurshid@uwm.edu
 José Murteira=jmurt@fe.uc.pt
 Fabrice MURTIN=fabrice.murtin@oecd.org
 Sucheta Murty=mn_murty@hotmail.com
 Sushama Murty=s.murty@exeter.ac.uk
 Aldo Musacchio=amusacchio@hbs.edu
 Marie Musard-Gies=musard@hotmail.com
 Mihai Sabin Muscalu=msmuscalu@yahoo.com
 Alex Andrea Muscatelli=amuscatelli@tiscali.co.uk
 Vito Antonio Muscatelli=principal@glasgow.ac.uk
 Radu Cristian Musetescu=radu.musetescu@rei.ase.ro
 Ralph Stephen Musgrave=ralph@fram.ndo.co.uk
 Jerry Mushin=jerry.mushin@vuw.ac.nz
 Mian Shahzad Mushtaq, Sr.=mianb19@yahoo.com
 Kelly Musick=musick@cornell.edu
 Nathan Musick=nathanm@cbo.gov
 Stéphane Mussard=smussard@adm.usherbrooke.ca
 Richard Mussa=rimussa@yahoo.co.uk
 Wesley Musser=wmusser@arec.umd.edu
 Oliver Musshoff=oliver.musshoff@agr.uni-goettingen.de
 Chiara Mussida=chiara.mussida@unicatt.it
 Fabio Musso=fabio.musso@uniurb.it
 Maurizio Mussoni=maurizio.mussoni@unibo.it
 Khalid Mustafa=khalidku2009@yahoo.com
 Usman Mustafa=usman@pide.org.pk
 David B. Mustard=mustard@uga.edu
 Răzvan Valentin Mustaţă=razvan.mustata@econ.ubbcluj.ro
 Jose Mustre-del-Rio=jose.mustre-del-rio@kc.frb.org
 Ignazio Musu, Sr.=musu@unive.it
 Sisule Musungu=fsisule@thesmklawfirm.com
 Zaenal Mutaqin=zaenalmutaqin@hiroshima-u.ac.jp
 Mihai Ioan Mutascu=mmutascu74@yahoo.com
 John Muteba Mwamba=johnmu@uj.ac.za
 Selvarasu Appasamy Mutharasu=aselvarasu@gmail.com
 Johannes Muthers=johannes.muthers@uni-wuerzburg.de
 Abhinay Muthoo=a.muthoo@warwick.ac.uk
 Jan Mutl=jan.mutl@ebs.edu
 Piyusha Mutreja=mutrejap@gmail.com
 Mirabelle Muûls=m.muuls@imperial.ac.uk
 Yibin Mu=ymu@post.harvard.edu
 Joan Muysken=j.muysken@maastrichtuniversity.nl
 Silvia Muzzioli=silvia.muzzioli@unimore.it
 Nkunde Mwase=nmwase@imf.org
 Dagmara Mycielska=dmycielska@wne.uw.edu.pl
 Jerzy Mycielski=mycielski@wne.uw.edu.pl
 Michal Myck=mmyck@cenea.org.pl
 Caitlin Knowles Myers=cmyers@middlebury.edu
 Linda A. Myers=lmyers@walton.uark.edu
 Robert J. Myers=myersr@msu.edu
 Samuel L. Myers, Jr.=rwilkins@umn.edu
 Steven Myers=myers@uakron.edu
 Olena Mykhaylova=omykhayl@richmond.edu
 Gareth Myles=gdmyles@ex.ac.uk
 Nikolaos Mylonidis=nmylonid@uoi.gr
 Kairat T. Mynbaev=kairat_mynbayev@yahoo.com
 Rafael Myro=r.myro@ccee.ucm.es
 Jaroslav Mysiak=jaroslav.mysiak@feem.it
 Martina Mysíková=martina.mysikova@centrum.cz
 Lynn Krieger Mytelka=lmytelka@gmail.com
 Naoufel Mzoughi=nmzoughi@avignon.inra.fr
