 Krzysztof Wach=wachk@uek.krakow.pl
 Jessica A. Wachter=jwachter@wharton.upenn.edu
 Susan M. Wachter=wachter@wharton.upenn.edu
 Johann Wackerbauer=wackerbauer@ifo.de
 Romain Wacziarg=wacziarg@ucla.edu
 Christopher A. Wada=cawada@hawaii.edu
 Roy Wada=roywada@hotmail.com
 Tatsuma Wada=tatsuma.wada@wayne.edu
 Glen Waddell=waddell@uoregon.edu
 Andrea Waddle=andrea.waddle@gmail.com
 C. Jeffrey Waddoups=jeffrey.waddoups@unlv.edu
 Eskil Wadensjö=eskil.wadensjo@sofi.su.se
 Waqar Ahmed Wadho=wadho.waqar@gmail.com
 William Morgan Wadman=wadmanw@uncw.edu
 Syed Naimul Wadood=syednw@yahoo.com
 Zia Wadud=ziawadud@ce.buet.ac.bd
 Keith Waehrer=keith.waehrer@bateswhite.com
 Urs Waelchli=urs.waelchli@ifm.unibe.ch
 Sébastien Waelti=swaelti@imf.org
 Andreas Wagener=wagener@sopo.uni-hannover.de
 Florian Oskar Ottokar Wagener=f.o.o.wagener@uva.nl
 Daniel F. Waggoner=dwaggoner@frbatlanta.org
 Swarnim Wagle=swarnim@post.harvard.edu
 Udaya R. Wagle=udaya.wagle@wmich.edu
 Liad Wagman=lwagman@stuart.iit.edu
 Caroline Wagner=wagner.911@osu.edu
 Christian Wagner=cwa.fi@cbs.dk
 Gert G. Wagner=gwagner@diw.de
 Gert R. Wagner=gwagner@faceapuc.cl
 Joachim Wagner=wagner@leuphana.de
 Liam Wagner=l.wagner@uq.edu.au
 Marcus Wagner=marcus.wagner@uni-wuerzburg.de
 Mathis Wagner=mathis.wagner@bc.edu
 Natascha Wagner=wagner@iss.nl
 Niklas F Wagner=nwagner@alum.calberkeley.org
 Richard Wagner=rwagner@gmu.edu
 Robert Wagner=robert.wagner@bwl.lmu.de
 Wolf Wagner=wagner@uvt.nl
 Wolfgang Wagner=wwagner@hsfk.de
 Adam Wagstaff=awagstaff@worldbank.org
 Abdul Waheed=waheed@merit.unu.edu
 Muhammad Waheed=waheed_sbp@hotmail.com
 Fabian Wahl=fabian.wahl@uni-hohenheim.de
 Israel Waichman=waichman@eco.uni-heidelberg.de
 Sevrin Waights=s.g.waights@lse.ac.uk
 John Wainio=jwainio@ers.usda.gov
 Andrew Wait=andrew.wait@sydney.edu.au
 Alecia Waite=aawaite@umich.edu
 Linda J. Waite=l-waite@uchicago.edu
 Abdul Wajid=wajidiiu@gmail.com
 Tim Wakeley=timwakeley1@msn.com
 Parag Waknis=parag.waknis@umassd.edu
 Anne L.J. ter Wal=a.terwal@imperial.ac.uk
 Konrad Walczyk=kwalcz1@sgh.waw.pl
 Waldeck Roger=roger.waldeck@telecom-bretagne.eu
 Klaus Wälde=klaus.waelde@uni-mainz.de
 Daniel Waldenström=daniel.waldenstrom@nek.uu.se
 Joel Waldfogel=jwaldfog@umn.edu
 Andreas Waldkirch=andreas.waldkirch@colby.edu
 Donald M. Waldman=waldman@colorado.edu
 Michael Waldman=mw46@cornell.edu
 Robert Waldmann=robert.waldmann@gmail.com
 Karl Walentin=karl.walentin@riksbank.se
 Barnabé Walheer=bwalheer@ulb.ac.be
 Adam N. Walk=a.walk@griffith.edu.au
 David Walker=d.walker@latrobe.edu.au
 Douglas M. Walker=walkerd@cofc.edu
 Eduardo Walker=ewalker@uc.cl
 Ian Walker=ian.walker@lancaster.ac.uk
 James T. Walker=j.t.walker@henley.reading.ac.uk
 Jay K. Walker=jwalker@niagara.edu
 W. Reed Walker=rwalker@haas.berkeley.edu
 Scott Walker=scott.walker@uts.edu.au
 Thomas R. Walker=thowalker@deloitte.com
 Tom Walker=lumpoflabor@gmail.com
 Gari Walkowitz=gari.walkowitz@uni-koeln.de
 Frederick Wallace=wallacefred9@gmail.com
 Neil Wallace=neilw@psu.edu
 Sally Wallace=swallace@gsu.edu
 Jessica Seddon=jseddon@okapia.co
 Alan Wall=awall@uniovi.es
 Christopher Waller=cwaller@stls.frb.org
 Mårten Wallette=marten.wallette@nek.lu.se
 Yabibal Mulualem Walle=ywalle@uni-goettingen.de
 Howard J. Wall=hwall@lindenwood.edu
 Bernard Walliser=walliser@mail.enpc.fr
 Jan Walliser=jwalliser@worldbank.org
 Gavin Wallis=g.wallis@ucl.ac.uk
 Kenneth F. Wallis=k.f.wallis@warwick.ac.uk
 Patrick H J Wallis=p.h.wallis@lse.ac.uk
 Larry D. Wall=larry.wall@atl.frb.org
 Martin Wall=martinwjwall@yahoo.co.uk
 Margaret Walls=walls@rff.org
 Michael Walls=m.walls@ucl.ac.uk
 Jacek Wallusch=jacek.wallusch@ue.poznan.pl
 Benoît Walraevens=benoit.walraevens@unicaen.fr
 Carl Walsh=walshc@ucsc.edu
 Frank Walsh=frank.walsh@ucd.ie
 Keith Walsh=keithw@revenue.ie
 Patrick John Walsh=walsh.patrick@epa.gov
 Patrick Maurice Walsh=pwalsh@smcvt.edu
 Patrick Paul Walsh=ppwalsh@ucd.ie
 Randall Phillip Walsh=walshr@pitt.edu
 Sharon Walsh=walshs30@tcd.ie
 Fábio Domingues Waltenberg=waltenberg@economia.uff.br
 John Robert Walter=john.walter@rich.frb.org
 Matthias Walter=mwalter.research@googlemail.com
 Terry Walter=terry.walter@sydney.edu.au
 Thomas Walter=walter@zew.de
 Ansgar Walther=ansgar.walther@gmail.com
 Olivier Walther=ow@sam.sdu.dk
 Markus Walzl=markus.walzl@uibk.ac.at
 Joseph Makwata Wambia=jwambia2002@yahoo.com
 Alan T.K. Wan=msawan@cityu.edu.hk
 Marianne Hinds Wanamaker=wanamaker@utk.edu
 Tanya Wanchek=tnw4j@virginia.edu
 Kirsten Wandschneider=kirsten@oxy.edu
 Waly Wane=wwane@worldbank.org
 Ben Zhe Wang=ben.wang@mq.edu.au
 Bo Wang=nizzwb@163.com
 Chaoyan Wang=chaoyan.wang@beds.ac.uk
 Chen Wang=c.wang@law.leidenuniv.nl
 Chengsi Wang=chewang@mail.uni-mannheim.de
 Chunbei Wang=cwang@bsc.edu
 Chunhua Wang=chunhua.wang@rocketmail.com
 Cindy Shin-huei Wang=cindywang9177@gmail.com
 Dong Wang=dong.wang@alumni.anu.edu.au
 Erpeng Wang=youxuels@163.com
 Gaowang Wang=wanggaowang@gmail.com
 Hansheng Wang=hansheng@gsm.pku.edu.cn
 Hao Wang, Sr.=hwang@ccer.edu.cn
 Haoying Wang=halking@psu.edu
 Honglin Wang=hwang@hkma.gov.hk
 Hua Wang=hwang1@worldbank.org
 Hung-Jen Wang=wangh@ntu.edu.tw
 Jialan Wang=jialanw@gmail.com
 Jian Wang=jian.wang@dal.frb.org
 JIao Wang=jiao.wang@ag.gov.au
 Jinxia Wang=jxwang.ccap@igsnrr.ac.cn
 Jiwei Wang=jwwang@smu.edu.sg
 Joseph Tao-yi Wang=josephw@ntu.edu.tw
 Ke Wang=wangkebit@bit.edu.cn
 Ko Wang=drkowang@gmail.com
 Kuan Min Wang=wkminn@ocu.edu.tw
 Le Wang=le.wang.econ@gmail.com
 Liang Wang=lwang2@hawaii.edu
 Lili Wang=wang@merit.unu.edu
 Liqun Wang=liqun.wang@ad.umanitoba.ca
 Miao Wang=grace.wang@mu.edu
 Neng Wang=nw2128@columbia.edu
 Pengfei Wang=pfwang@ust.hk
 Ping Wang=pingwang@wustl.edu
 Ruixin Wang=rey.rxwang@gmail.com
 Ruqu Wang=wangr@qed.econ.queensu.ca
 Shengzu Wang=swang2@imf.org
 Siyan Wang=wangs@lerner.udel.edu
 Tianxi Wang=wangt@essex.ac.uk
 Tianyi Wang=tianyiwangmath@gmail.com
 Tong Wang=divinites@gmail.com
 Guanghua Wan万广华 (Guanghua Wan)=gwan@adb.org
 Wei Wang=wwangc@wustl.edu
 Weimin Wang=weimin.wang@statcan.gc.ca
 X. Henry Wang=wangx@missouri.edu
 Xia Wang=xiawang.z@gmail.com
 Xiaodong Wang=wxd888@139.com
 Xiaohu Wang=xiaohu.wang.2008@phdecons.smu.edu.sg
 Xiaojun Wang=xiaojun@hawaii.edu
 Xingchun Wang=xchwangnk@aliyun.com
 Xiuqing Wang=wangxq@cau.edu.cn
 Xuewu Wang=xuewu.wang@scranton.edu
 Yafeng Wang=econwang@pku.edu.cn
 Yan Wang=ywang2005b@gmail.com
 Yikai Wang=yikai.wang@econ.uzh.ch
 Yong Wang=wangyong.cg@gmail.com
 Yong Wang=efywang@cityu.edu.hk
 Yuntong Wang=yuntong@uwindsor.ca
 Yu-Ter Wang=ytwang@mail.mcu.edu.tw
 Zhao-Hua Wang=wangzhaohua@bit.edu.cn
 Zheng Wang=ralwang@gmail.com
 Zhiguo Wang=wangzhiguo66@gmail.com
 Zigan Wang=zw2160@columbia.edu
 Joschka Wanner=joschka.wanner@uni-bayreuth.de
 Muhammad Waqas=economist147@hotmail.com
 Wirya Wardaya=wiryawardaya@yahoo.com
 Jennifer Ward-Batts=ward-batts@wayne.edu
 Charles W. Ward=c.ward@reading.ac.uk
 Peter Wardley=peter.wardley@uwe.ac.uk
 Michael B. Ward=michael.ward@monash.edu
 Michael R. Ward=mikeward@uta.edu
 Patrick S. Ward=p.ward@cgiar.org
 Ruby Ward=rward@econ.usu.edu
 Roger Ware=ware@qed.econ.queensu.ca
 Massimo Warglien=warglien@unive.it
 Thierry Warin=thierry.warin@hec.ca
 Casey Warman=warmanc@dal.ca
 Andrew M. Warner=awarner@imf.org
 Koko Warner=warner@ehs.unu.edu
 Arne Jonas Warnke=warnke@zew.de
 Usman Ali Warraich=warraich.u.a@gmail.com
 Patrick L. Warren=patrick.lee.warren@gmail.com
 Ronald Warren=warren@terry.uga.edu
 Peter George Warr=peter.warr@anu.edu.au
 Missaka Warusawitharana=m1mnw00@frb.gov
 Travis Wayne Warziniack=twwarziniack@fs.fed.us
 Robert Waschik=r.waschik@latrobe.edu.au
 Rick Wash=rwash@umich.edu
 Wilson S. K. Wasike=wilson.wasike@aercafrica.org
 Karsten Wasiluk=karsten.wasiluk@uni-konstanz.de
 Etienne Wasmer=etienne.wasmer@sciences-po.fr
 Malgorzata Wasmer=malgorzata.wasmer@yahoo.com
 Krzysztof Waśniewski=krzysztof.wasniewski@gmail.com
 Cédric Wasser=cedric.wasser@uni-bonn.de
 Robert William Wassmer=rwassme@csus.edu
 Naoki Watanabel=n-wata@fc.ritsumei.ac.jp
 Makoto Watanabe=makoto.wtnb@gmail.com
 Mariko Watanabe=mariko.wt@gmail.com
 Masahiro Watanabe=masahiro.watanabe@ualberta.ca
 Takahiro Watanabe=contact_nabe08@nabenavi.net
 Wako Watanabe=wakow@fbc.keio.ac.jp
 Peter Waterman=pwaterma@gmail.com
 Alex Waters=a.waters@commonwealth.int
 George A. Waters=gawater@gmail.com
 John P. Watkins=jwatkins@westminstercollege.edu
 Todd A. Watkins=taw4@lehigh.edu
 Joel Watson=jwatson@ucsd.edu
 John Watson=jr.watson@monash.edu
 William D. Watson=wwatson63@comcast.net
 Stuart Ian Wattam=stuart.wattam@btinternet.com
 Peter Andrew Watt=p.a.watt@bham.ac.uk
 Richard Watt=richard.watt@canterbury.ac.nz
 David Watts=dwatts98@gmail.com
 Michael Watts=mwatts@purdue.edu
 Ross Leslie Watts=rwatts@mit.edu
 Martin Watzinger=martin.watzinger@lrz.uni-muenchen.de
 Andrew William Waugh=awwaugh@gmail.com
 Walter Karl Waymeyer=wwaymeyer@sbcglobal.net
 Piotr Wdowinski=piotrw@uni.lodz.pl
 Martin Robert Weale=mweale@niesr.ac.uk
 Dave D. Weatherspoon=weathe42@msu.edu
 Robert D. Weaver=r2w@psu.edu
 Bruce David Webb=webbbd@cardiff.ac.uk
 Craig Stewart Webb=craig.webb@manchester.ac.uk
 David Webb=d.c.webb@lse.ac.uk
 Don J Webber=don.webber@uwe.ac.uk
 Ryan Webb=webbr@econ.queensu.ca
 Claudio Weber Abramo=crwa@uol.com.br
 Andrea Weber=a.weber@uni-mannheim.de
 Anke Weber=aweber@imf.org
 Caroline E. Weber=cweber5@uoregon.edu
 Ernst Juerg Weber=juerg.weber@uwa.edu.au
 Gerald Weber=webergerald@t-online.de
 Guglielmo Weber=guglielmo.weber@unipd.it
 Henning Weber=henning.weber@ifw-kiel.de
 Jeremy Glenn Weber=jeweber@ers.usda.gov
 Jörg Weber=joerg.weber@nottingham.ac.uk
 Michael Weber=weber.m@ifo.de
 Michael T. Weber=webermi@msu.edu
 Patrick Weber=patrick.weber@ebs.edu
 Robert James Weber=rjweber@northwestern.edu
 Roberto A. Weber=roberto.weber@econ.uzh.ch
 Sebastian Weber=sebastian.weber@graduateinstitute.ch
 Shlomo Weber=sweber@mail.smu.edu
 Stefan Weber=weber@math.tu-berlin.de
 Sylvain Weber=sylvain.weber@unine.ch
 Elizabeth Webster=e.webster@unimelb.edu.au
 Jan Wedemeier=wedemeier@hwwi.org
 Margaret Weden=mweden@rand.org
 Mark Weder=mark.weder@adelaide.edu.au
 Michael Wedow=michael.wedow@ecb.int
 Melvyn Weeks=mw217@econ.cam.ac.uk
 Arie Weeren=arie.weeren@ua.ac.be
 Gregory Cedric Wegmann=gregory.wegmann@u-bourgogne.fr
 Gert D. Wehinger=gert.wehinger@oecd.org
 Alfons J. Weichenrieder=a.weichenrieder@em.uni-frankfurt.de
 Chenyang Wei=chenyang.wei@aig.com
 Doris Weichselbaumer=doris.weichselbaumer@jku.at
 Chu WEI=xiaochu@ruc.edu.cn
 Marc Weidenmier=marc_weidenmier@claremontmckenna.edu
 Benjamin Weigert=benjamin.weigert@wirtschaft.uni-giessen.de
 Hans-Peter Weikard=hans-peter.weikard@wur.nl
 Torsten Weiland=weiland@econ.mpg.de
 David Weil=david_weil@brown.edu
 Lijian Wei=weilijian@gmail.com
 Laurent Weill=laurent.weill@unistra.fr
 Pierre-Olivier Weill=poweill@econ.ucla.edu
 Philippe Weil=philippe.weil@gmail.com
 Thierry Weil=thierry.weil@ensmp.fr
 Andrew Weinbach=aweinbac@coastal.edu
 Daniel H. Weinberg=dhweinberg@gmail.com
 Marca Weinberg=weinberg@ers.usda.gov
 Matthew Weinberg=mcw325@drexel.edu
 Joann Martens Weiner=jmweiner@gwu.edu
 Peter Weingarten=peter.weingarten@ti.bund.de
 Barry R. Weingast=weingast@stanford.edu
 Felix Weinhardt=felix.weinhardt@hu-berlin.de
 Michael Weinhardt=mweinhardt@diw.de
 Diana Weinhold=d.weinhold@lse.ac.uk
 Federico Weinschelbaum=fweinsch@udesa.edu.ar
 David Weinstein=dew35@columbia.edu
 Jonathan Lewis Weinstein=jweinstein22@wustl.edu
 Matthew C Weinzierl=mweinzierl@hbs.edu
 Sharada Weir=sharada.weir@umassmed.edu
 Michael Steven Weisbach=michael@weisbach.net
 Julian Weisbrod=julianweisbrod@wiwi.uni-goettingen.de
 Charles Louis Weise=cweise@gettysburg.edu
 Daniel Weiserbs=daniel.weiserbs@uclouvain.be
 David A. Weiskopf=weiskoda@yahoo.com
 Andrew Weiss=aweiss@weissasset.com
 Avi Weiss=avi.weiss@biu.ac.il
 David Weiss=davidweiss@post.tau.ac.il
 Dominik Weiß=weiss@igg.uni-bonn.de
 Franziska Weiss=franziska.weiss@econ.uzh.ch
 Jan Frederic Weiss=jan.weiss@ihh.hj.se
 Laurence Marc Weiss=lweiss@bloomberg.net
 Marco Weiss=weiss@finance.uni-frankfurt.de
 Martin Weiss=martin.weiss1@gmx.de
 Matthias M. Weiss=m.weiss@mea.mpisoc.mpg.de
 Pia Weiss=piaweiss@yahoo.com
 Randall D. Weiss=rdweiss52@yahoo.com
 Thomas Weiss=t-weiss@ku.edu
 Volkmar Weiss=volkmar-weiss@t-online.de
 Christian Weistroffer=christian.weistroffer@esma.europa.eu
 Taoyuan Wei=taoyuan.wei@cicero.uio.no
 Matthias Weitzel=matthias.weitzel@ifw-kiel.de
 Thomas Weitzenblum=thomas.weitzenblum@univ-lemans.fr
 Xiangdong Wei=xdwei@ln.edu.hk
 Yi-Ming Wei=wei@bit.edu.cn
 Yingqi Wei=yingqi.wei@york.ac.uk
 Zheng (Annie), Wei=annie.wei@anu.edu.au
 Ivo Welch=ivo.welch@anderson.ucla.edu
 Matthew John Welch=welchmat@gmail.com
 Paul Welfens=welfens@eiiw.uni-wuppertal.de
 Christian E. Weller=christian.weller@umb.edu
 Linda Welling=lwelling@uvic.ca
 Richard Wellings=rwellings@iea.org.uk
 Michael Wellman=wellman@umich.edu
 Isabell M. Welpe=welpe@tum.de
 Angelika Welte=awelte@bankofcanada.ca
 Dr. Jesse W.J. Weltevreden=jesseweltevreden@bovag.nl
 Peter Welzel=peter.welzel@wiwi.uni-augsburg.de
 Peter Welz=peter.welz@gmx.net
 Florian Wendelspiess Chávez Juárez=florian.wendelspiess@unige.ch
 Nicolai Wendland=wendland@vwl.tu-darmstadt.de
 Ron Wendner=ronald.wendner@uni-graz.at
 Ming-Jang Weng=mjweng@nuk.edu.tw
 Erik Wengström=erik.wengstrom@nek.lu.se
 Quinn Weninger=weninger@iastate.edu
 Jean-Francois Wen=wen@ucalgary.ca
 Karl Jonas Wennberg=karl.wennberg@hhs.se
 Quan Wen=wenq2@uw.edu
 文一 (Yi Wen)=yi.wen@stls.frb.org
 Jan Wenzelburger=j.wenzelburger@liverpool.ac.uk
 Michael Wenz=m-wenz@neiu.edu
 Andreas Werblow=andreas.werblow@tu-dresden.de
 Martin Werding=martin.werding@ruhr-uni-bochum.de
 Marzenna Anna Weresa=mweres@sgh.waw.pl
 Seth H. Werfel=swerfel@stanford.edu
 Niels-Erik Wergin-Cheek=n.wergin@gre.ac.uk
 Bas J.M. Werker=werker@tilburguniversity.nl
 Birger Wernerfelt=bwerner@mit.edu
 Jan Werner=jan.werner@publicfinance.de
 Katarzyna Maria Werner=katarzyna.werner-2@postgrad.manchester.ac.uk
 Stephan K. Werner=stephan.klaus.werner@gmail.com
 Kris Wernstedt=krisw@vt.edu
 Rafał Weron=rafal.weron@pwr.wroc.pl
 Martin Wersing=martin.wersing@abdn.ac.uk
 Bruno Wertlen=bruno.wertlen@vodafone.com
 Justus Wesseler=justus.wesseler@wur.nl
 Peter F Westaway=peter.westaway@vanguard.co.uk
 Paul C. Westcott=westcott@ers.usda.gov
 Douglas S. West=douglas.west@ualberta.ca
 Niklas Johan Westelius=nwestelius@imf.org
 Vanja Westerberg=vanja.westerberg@iucn.org
 Mark M. Westerfield=mwesterf@uw.edu
 Niels Westergaard-Nielsen=nwn.int@cbs.dk
 Peter Westerheide=westerheide@zew.de
 Frank Westerhoff=frank.westerhoff@uni-bamberg.de
 Joakim Westerlund=j.westerlund@deakin.edu.au
 Olle Westerlund=olle.westerlund@econ.umu.se
 Andreas Westermark=andreas.westermark@riksbank.se
 Sjur Westgaard=sjur.westgaard@iot.ntnu.no
 Jonas Kristoffer Westin=jonas.westin@umu.se
 Lars Westin=lars.westin@econ.umu.se
 James E West=j_west@baylor.edu
 Kenneth D. West=kdwest@wisc.edu
 Tatu Josef Westling=tatu.westling@helsinki.fi
 Hans Westlund=hans.westlund@infra.kth.se
 Hanna Westman=hanna.westman@bof.fi
 Sarah E. West=wests@macalester.edu
 David Wettstein=wettstn@bgu.ac.il
 Heike Wetzel=heike.wetzel@uni-koeln.de
 James N. Wetzel=wetzelwetzel2002@yahoo.com
 Cecile Wetzels=cmmp.wetzels@gmail.com
 Christian Wey=wey@dice.uni-duesseldorf.de
 Eric Glen Weyl=weyl@uchicago.edu
 Diana N. Weymark=diana.weymark@vanderbilt.edu
 John Allan Weymark=john.weymark@vanderbilt.edu
 Yoon-Jae Whang=whang@snu.ac.kr
 Warren C. Whatley=wwhatley@umich.edu
 Stephen Wheatley Price=swp2@le.ac.uk
 Christopher H. Wheeler=cwheeler@ftc.gov
 Sarah Ann Wheeler=sarah.wheeler@unisa.edu.au
 William J. Wheeler=wheeler.william@epa.gov
 David Wheelock=wheelock@stls.frb.org
 Christopher T. Whelan=christopher.whelan@ucd.ie
 Ciara Whelan=ciara.whelan@ucd.ie
 Daniel J. Whelan=whelan@hendrix.edu
 Karl T. Whelan=karl.whelan@ucd.ie
 Stephen Patrick Whelan=stephen.whelan@sydney.edu.au
 Alexander White=awhite@sem.tsinghua.edu.cn
 Ben White=benedict.white@uwa.edu.au
 Douglas R. White=drwhite@uci.edu
 Toni Whited=toni.whited@simon.rochester.edu
 Eugene White=white@economics.rutgers.edu
 Peter Whiteford=peter.whiteford@anu.edu.au
 John C. Whitehead=whiteheadjc@appstate.edu
 Edward Whitehouse=edwardrwhitehouse@gmail.com
 Howard White=hwhite@3ieimpact.org
 Lawrence H. White=lwhite11@gmu.edu
 Charles H. Whiteman=whiteman@uiowa.edu
 Mark D. White=profmdwhite@hotmail.com
 michael v. white, V=mike.white@monash.edu.au
 Roger White=rwhite1@whittier.edu
 T. Kirk White=thomas.kirk.white@census.gov
 John Whittaker=john.whittaker@lancaster.ac.uk
 William Whittaker=william.whittaker@manchester.ac.uk
 Stuart Whitten=stuart.whitten@csiro.au
 Dale Whittington=dale_whittington@unc.edu
 Stephen Whyte=sg.whyte@qut.edu.au
 Quentin Wibaut=quentin.wibaut@nbb.be
 Jacob Wibe=jacob.wibe@ucdenver.edu
 Kodrat Wibowo=kodrat.wibowo@fe.unpad.ac.id
 Sigit Wibowo=sigit.sw@ui.ac.id
 Laura Wichert=laura.wichert@bundesbank.de
 Bruno Wichmann=bwichmann@ualberta.ca
 Piyasiri Wickramasekara=pywicks@gmail.com
 Rick Wicks=rw-admnstrtv@outlook.com
 David Geoffrey Wiczer=wiczerd@gmail.com
 Lars M. Widell=lars.widell@gmail.com
 Anna Widerberg=annawiderberg@hotmail.com
 Karl Widerquist=karl@widerquist.com
 Barbro Widerstedt=barbro.widerstedt@tillvaxtanalys.se
 Philippe Karl Widmer=philippe.widmer@econ.uzh.ch
 Tri Widodo=kociwid@yahoo.com
 Manfred Wiebelt=manfred.wiebelt@ifw-kiel.de
 Uwe-Carsten Wiebers=carsten.wiebers@kfw.de
 Simon Wiederhold=wiederhold@ifo.de
 Mirko Wiederholt=wiederholt@wiwi.uni-frankfurt.de
 Johannes Wiegand=jwiegand@imf.org
 Elisabeth Wieland=wieland@ifo.de
 Volker Wieland=wieland@wiwi.uni-frankfurt.de
 Axel Wieneke=a.wieneke@latrobe.edu.au
 Jonathan B. Wiener=wiener@law.duke.edu
 Zvi Wiener=mswiener@mscc.huji.ac.il
 Elmer Gerald Wiens=egwiens@egwald.ca
 Margarethe F. Wiersema=mfwierse@uci.edu
 Robert Wieser=robert.wieser@tuwien.ac.at
 Berthold Wigger=berthold.wigger@googlemail.com
 Richard Donovan Wiggins=r.wiggins@ioe.ac.uk
 Jonathan B. Wight=jwight@richmond.edu
 Simon Wigley=wigley@bilkent.edu.tr
 Ganeshan Wignaraja=gwignaraja@yahoo.com
 Magnus Wikström=magnus.wikstrom@econ.umu.se
 Kenneth C. Wilbur=kwilbur@usc.edu
 Nathaniel T. Wilcox=nwilcox@chapman.edu
 David Wildasin=dew@davidwildasin.us
 Joachim Wilde=joachim.wilde@uni-osnabrueck.de
 Joshua Wilde=jkwilde@usf.edu
 Matthijs R. Wildenbeest=mwildenb@indiana.edu
 Parke Wilde=parke.wilde@tufts.edu
 John Wildman=j.r.wildman@ncl.ac.uk
 Phillip Wild=p.wild@uq.edu.au
 Tom Wilfer=tom.wilfer@wiwi.uni-jena.de
 Bernd Wilfling=bernd.wilfling@wiwi.uni-muenster.de
 Jochen E. M. Wilhelm=jochen.wilhelm@uni-passau.de
 Mark O. Wilhelm=mowilhel@iupui.edu
 Anders Wilhelmsson=anders.vilhelmsson@nek.lu.se
 Mats Wilhelmsson=matsw@infra.kth.se
 Jerzy Wilkin=wilkin@wne.uw.edu.pl
 James T. Wilkinson=jim.wilkinson@kc.frb.org
 Roger Kingsley Wilkins=rkw@unimelb.edu.au
 Henry Willebald=hwillebald@iecon.ccee.edu.uy
 Peter Willemé=pw@plan.be
 Dirk Willenbockel=d.willenbockel@ids.ac.uk
 Juliane Willert=willert@statistik.uni-hannover.de
 Andrew David Williams=andrew.williams@uwa.edu.au
 Arlington Walton Williams=williama@indiana.edu
 Benjamin Williams=bdwilliams@gwu.edu
 David M. Williams=david.williams.ox@gmail.com
 Donald Williams=dwilliam@kent.edu
 Geoffrey Williams=geoffrey.williams@responsibleacademy.com
 Geoffrey Fain Williams=gwilliams@econ.rutgers.edu
 Gwion Williams=abs037@bangor.ac.uk
 Heidi L. Williams=heidiw@nber.org
 Jenny Williams=jenny.williams@unimelb.edu.au
 John C. Williams=john.c.williams@sf.frb.org
 Marcela M. Williams=marcela.m.williams@stls.frb.org
 Nicolas Williams=nicolas.williams@uc.edu
 Noah Williams=nmwilliams@wisc.edu
 Claudia R. Williamson=claudia.williamson@msstate.edu
 Jeffrey Gale Williamson=jwilliam@fas.harvard.edu
 Stephen Williamson=swilliam@artsci.wustl.edu
 Wendy Williamson=wendy@umn.edu
 Roberton C. Williams III=roberton@umd.edu
 Ruth F. G. Williams=ruth.williams@latrobe.edu.au
 Tomas Williams=tomas.williams@upf.edu
 Jan Willing=jwilling@munichre.com
 Manuel Willington=manuel.willington@uai.cl
 Jonathan L. Willis=jonathan.willis@kc.frb.org
 Robert J. Willis=rjwillis@umich.edu
 Alpo Willman=alpo.willman@gmail.com
 Gerald Willmann=gerald@willmann.com
 Larry Willmore=larrywillmore@yahoo.com
 Gabrielle Wills=gabriellewills@gmail.com
 Samuel Wills=samuel.wills@economics.ox.ac.uk
 Ulrike Will=will@europa-uni.de
 Bart J. Wilson=bartwilson@gmail.com
 Bonnie Wilson=wilsonbe@slu.edu
 Chris Wilson=c.m.wilson@lboro.ac.uk
 Clevo Wilson=clevo.wilson@qut.edu.au
 Daniel Wilson=daniel.wilson@sf.frb.org
 Deborah Wilson=d.wilson@bristol.ac.uk
 James R. Wilson=jwilson@orkestra.deusto.es
 John Sullivan Wilson=jswilson@worldbank.org
 Leonard S. Wilson=sam.wilson@ualberta.ca
 Linus Wilson=linuswilson@louisiana.edu
 Nathan E. Wilson=nwilson@ftc.gov
 Nicholas Logan Wilson=nicholas.l.wilson@williams.edu
 Norbert Lance Weston Wilson=wilsonl@auburn.edu
 Patrick Wilson=wilsonpatrick4948@yahoo.com.au
 Paul W. Wilson=pww@clemson.edu
 Robert Butler Wilson=rwilson@stanford.edu
 Stuart Wilson=stuart.wilson@uregina.ca
 Tanya Wilson=tanya.wilson.2011@rhul.ac.uk
 Wesley W. Wilson=wwilson@uoregon.edu
 Rizki Ernadi Wimanda=rizki@bi.go.id
 Frank Windmeijer=f.windmeijer@bristol.ac.uk
 Paul Windrum=paul.windrum@nottingham.ac.uk
 Stanley Winer=stanley.winer@carleton.ca
 Rainer Winkelmann=rainer.winkelmann@econ.uzh.ch
 Diego Winkelried=diegowq@cantab.net
 Peter Winker=peter.winker@wirtschaft.uni-giessen.de
 Anne E. Winkler=awinkler@umsl.edu
 Deborah Winkler=dwinkler2@worldbank.org
 Hernan Winkler=hwinkler@ucla.edu
 Ralph Winkler=mail@ralph-winkler.de
 Robin M. Winkler=robin.winkler@balliol.ox.ac.uk
 Roland C. Winkler=roland.winkler@tu-dortmund.de
 Hannes Winner=hannes.winner@sbg.ac.at
 Viktor Winschel=winschel@rumms.uni-mannheim.de
 Christoph Winter=christoph.winter@econ.uzh.ch
 Rudolf Winter-Ebmer=rudolf.winterebmer@jku.at
 Eyal Winter=mseyal@pluto.huji.ac.il
 Fabian S. Winter=fabian.winter@soz.unibe.ch
 Jennifer Winter=jwinter@ucalgary.ca
 Joachim Winter=winter@lmu.de
 Johannes Winter=johannes.winter@wiso.uni-koeln.de
 Peter Winter=peter.winter@daad-alumni.de
 Ralph A. Winter=ralph.winter@sauder.ubc.ca
 Sidney Winter=winter@wharton.upenn.edu
 John V. Winters=jvwinte@okstate.edu
 Paul C. Winters=winters@american.edu
 Sien Winters=sien.winters@hiva.kuleuven.be
 Christian Dahl Winther=cwinther@econ.au.dk
 Rene J.M. Wintjes=r.wintjes@maastrichtuniversity.nl
 Tony S. Wirjanto=twirjant@uwaterloo.ca
 Ariel Luis Wirkierman=ariwirkierman@gmail.com
 Peter Wirtz=peter.wirtz.fcs@gmail.com
 David Wise=dwise@nber.org
 Thomas Wiseman=wiseman@austin.utexas.edu
 Timothy A. Wise=tim.wise@tufts.edu
 Jon D. Wisman=jdwisma@american.edu
 Sebastian Wismer=sebastian.wismer@uni-wuerzburg.de
 Matthew James Wiswall=matt.wiswall@gmail.com
 Agnieszka Wiszniewska-Matyszkiel=agnese@mimuw.edu.pl
 Glenn Alexander Withers=glenn.withers@anu.edu.au
 Bartosz Witkowski=bwitko@sgh.waw.pl
 Olivier Witmeur=olivier.witmeur@ulb.ac.be
 Sarut Wittayarungruangsri=sarutw@yahoo.com
 Mark David Witte=wittem@cofc.edu
 Martin Wittenberg=martin.wittenberg@uct.ac.za
 David Wittenburg=dwittenburg@mathematica-mpr.com
 Knut M. Wittkowski=kmw@rockefeller.edu
 Robert Witt=r.witt@surrey.ac.uk
 Jiří Witzany=witzanyj@vse.cz
 Yupana Wiwattanakantang=yupana@nus.edu.sg
 Quentin Wodon=qwodon@worldbank.org
 Martin Woerter=woerter@kof.ethz.ch
 Julia Maria Woerz=julia.woerz@oenb.at
 Ludger Woessmann=woessmann@ifo.de
 Mark Wohar=mwohar@mail.unomaha.edu
 Florian Wöhlbier=florian.woehlbier@ec.europa.eu
 Klaus Wohlrabe=wohlrabe@ifo.de
 Hans-Werner Wohltmann=wohltmann@economics.uni-kiel.de
 Ulrich Woitek=ulrich.woitek@econ.uzh.ch
 Oliver W. Wojahn=owojahn@googlemail.com
 Timothy Richard Wojan=twojan@ers.usda.gov
 Piotr Wójcik=pwojcik@wne.uw.edu.pl
 Mintesnot G Woldeamanuel=mintesnot@gmail.com
 Andinet Woldemichael=awoldemichael@rx.umaryland.edu
 Barbara L. Wolfe=bwolfe@wisc.edu
 Justin Wolfers=jwolfers@umich.edu
 Edward Nathan Wolff=ew1@nyu.edu
 François-Charles Wolff=francois.wolff@univ-nantes.fr
 Hendrik Wolff=hgwolff@u.washington.edu
 Irenaeus Wolff=wolff@twi-kreuzlingen.ch
 Maximilian Martin Wolf=wolf@lfi-muenchen.de
 Yvonne Anna Wolfmayr=yvonne.wolfmayr@wifo.ac.at
 Michael Wolf=michael.wolf@econ.uzh.ch
 Nikolaus Wolf=nikolaus.wolf@wiwi.hu-berlin.de
 Elmar Wolfstetter=wolfstetter@gmail.com
 Tina Wolf=tina.wolf@uni-jena.de
 Zoltán Wolf=zoltan.wolf@census.gov
 John David Wolken=john.d.wolken@gmail.com
 Scott A. Wolla=scott.a.wolla@stls.frb.org
 Conny Ernst-Peter Wollbrant=conny.wollbrant@economics.gu.se
 Timo Wollmershäuser=wollmershaeuser@ifo.de
 Oliver Woll=woll@zew.de
 Tobias Woll=tobias.woll@energieagentur.rlp.de
 Alexander L. Wolman=alexander.wolman@rich.frb.org
 Guido Wolswijk=guido.wolswijk@ecb.int
 Joanna Wolszczak-Derlacz=jwo@zie.pg.gda.pl
 Juergen Wolters=wolters@wiwiss.fu-berlin.de
 Ronald Wolthoff=ronald.p.wolthoff@gmail.com
 Geert Woltjer=geert.woltjer@wur.nl
 Stephane Wolton=stephane.wolton@gmail.com
 Ann Wolverton=wolverton.ann@epa.gov
 Benjamin Wong=benjamin.wong@rbnz.govt.nz
 Chin-Yoong Wong=wongcy@utar.edu.my
 Ging Wong=ging.wong@gmail.com
 Jacob Wong=jacob.wong@adelaide.edu.au
 Jose Carlos Wong=jcfrankfurt@hotmail.com
 Kar-Yiu Wong=karyiu@u.washington.edu
 Kin Ming Wong=arieswong@chuhai.edu.hk
 Koi Nyen Wong=koinyenw@sunway.edu.my
 Linda Yuet-Yee Wong=lwong@binghamton.edu
 M. C. Sunny Wong=mwong11@usfca.edu
 Melissa Oi Ming Wong=melissa.wong@unsw.edu.au
 Poh Kam Wong=pohkam@nus.edu.sg
 Shirly Siew-Ling Wong=shirlywong87@hotmail.com
 Tsz-Nga Wong=rwong@bankofcanada.ca
 Warapong Wongwachara=warapong.won@tmbbank.com
 Wei-Kang Wong=ecswong@nus.edu.sg
 Wing-Keung Wong=awong@hkbu.edu.hk
 Woon K. Wong=wongwk3@cardiff.ac.uk
 Christopher Woock=chris.woock@abbott.com
 Andrew Wood=wooda@essex.ac.uk
 Christina A. Wood=cwood@worldbank.org
 Simon D. Woodcock=swoodcoc@sfu.ca
 Mark Peter Wooden=m.wooden@unimelb.edu.au
 John Wooders=john.wooders@uts.edu.au
 Myrna Wooders=myrna.wooders@vanderbilt.edu
 Alan Woodfield=alan.woodfield@canterbury.ac.nz
 Michael Woodford=mw2230@columbia.edu
 Joel Wood=joel.wood@fraserinstitute.org
 Justine Wood=j.a.wood@lboro.ac.uk
 Alan Donald Woodland=a.woodland@unsw.edu.au
 Peter John Wood=peter.j.wood@anu.edu.au
 Christopher Woodruff=c.woodruff@warwick.ac.uk
 Stanley Wood=stanley.wood@gatesfoundation.org
 Timothy A. Woods=tim.woods@uky.edu
 Douglas P. Woodward=woodward@moore.sc.edu
 Jaejoon Woo=jwoo@imf.org
 Ingrid Woolard=ingrid.woolard@uct.ac.za
 Michael Woolcock=mwoolcock@worldbank.org
 Jeffrey Wooldridge=wooldri1@msu.edu
 Frances Woolley=frances_woolley@carleton.ca
 Rossitza Bouneva Wooster=wooster@pdx.edu
 Ian Wooton=ian.wooton@strath.ac.uk
 Wing Thye Woo=wtwoo@ucdavis.edu
 Andreas Wörgötter=andreas.woergoetter@oecd.org
 Shane Mathew Worner=s.worner@iosco.org
 Glenn A Woroch=glenn@econ.berkeley.edu
 Tim Worrall=tim.worrall@ed.ac.uk
 Manuel Wörsdörfer=woersdoerfer@wiwi.uni-frankfurt.de
 Christopher Worswick=christopher_worswick@carleton.ca
 Andrew Worthington=a.worthington@griffith.edu.au
 Peter Wostner=pwostner@yahoo.com
 Raf Wouters=rafael.wouters@nbb.be
 Nancy Wozabal=nancy.wozabal@univie.ac.at
 David Wozniak=dwozniak@gmail.com
 Rafal Wozniak=rwozniak@wne.uw.edu.pl
 Tomasz Woźniak=tomasz.wozniak@unimelb.edu.au
 Jan Wrampelmeyer=jan.wrampelmeyer@unisg.ch
 Matthias Wrede=matthias.wrede@fau.de
 Liam Wren-Lewis=liamwrenlewis@cantab.net
 Simon Wren-Lewis=simon.wren-lewis@economics.ox.ac.uk
 Allan Silveria Wright=wright@cemla.org
 Brian Davern Wright=bwright@berkeley.edu
 Donald Wright=don.wright@sydney.edu.au
 Gavin Wright=write@stanford.edu
 Greg C. Wright=gwright4@ucmerced.edu
 Julian Wright=jwright@nus.edu.sg
 Mark Wright=mwright@frbchi.org
 Peter William Wright=p.wright@sheffield.ac.uk
 Randall Wright=rwright@bus.wisc.edu
 Robert E. Wright=r.e.wright@strath.ac.uk
 Stephen Hurst Wright=s.wright@bbk.ac.uk
 Andrew George Wrobel=andrew.wrobel@gmail.com
 Ewa Wróbel=ewa.wrobel@nbp.pl
 Katharina Wrohlich=kwrohlich@diw.de
 Binzhen Wu=wubzh@sem.tsinghua.edu.cn
 Ansgar Wübker=ansgar.wuebker@rwi-essen.de
 Changqi Wu=topdog@gsm.pku.edu.cn
 Cheng Wu=cwucnspt@hotmail.com
 Dash Wu=dash@risklab.ca
 Eliza Wu=eliza.wu@uts.edu.au
 Diethelm Wuertz=wuertz@phys.ethz.ch
 WU Fuxiang=wfxnju@hotmail.com
 Guiying Laura Wu=guiying.wu@ntu.edu.sg
 Haoyang Wu=yangki76@163.com
 Harry X. Wu=harry.wu@ier.hit-u.ac.jp
 Jason Wu=jason.j.wu@frb.gov
 Jing Cynthia Wu=cynthia.wu@chicagobooth.edu
 John Wu=jwugse@gmail.com
 Jyun-Yi Wu=jywu@cdri.org.tw
 Lemin Wu=wulm.03@gmail.com
 Liuren Wu=liuren.wu@baruch.cuny.edu
 Conny Wunsch=conny.wunsch@unibas.ch
 Sacha Wunsch-Vincent=sacha.wunschvincent@wipo.int
 Qiang Wu=wuq2@rpi.edu
 Jeffrey Wurgler=jwurgler@stern.nyu.edu
 Eckhard Georg Wurzel=eckhard.wurzel@oecd.org
 Shih-Ying Wu=wus@mx.nthu.edu.tw
 Shu Wu=shuwu@ku.edu
 Stephen Wu=swu@hamilton.edu
 Steven Wu=sywu@purdue.edu
 Miriam Wüst=miw@sfi.dk
 Tao Wu=twu@imf.org
 Thomas Wu=thomaswu@ucsc.edu
 Tommy Wu=ttowu@hkma.gov.hk
 Xi Wu=wuxi@cufe.edu.cn
 Xianyi Wu=xywu@stat.ecnu.edu.cn
 Ximing Wu=wuximing05@gmail.com
 Yiqun Wu=ywu2@imf.org
 Zhongmin Wu=zhongmin.wu@ntu.ac.uk
 James Wyckoff=wyckoff@virginia.edu
 Mark Wynne=mark.a.wynne@dal.frb.org
 Charles Wyplosz=charles.wyplosz@graduateinstitute.ch
 Michael Wyrwich=michael.wyrwich@uni-jena.de
 Allen F. Wysocki=wysocki@ufl.edu
 Robert Wyszynski=rwyszy@yahoo.com
 Michael Louis Wyzan=wyzan@hotmail.com
