 Xavier Gabaix=xgabaix@stern.nyu.edu
 Gaetano Gaballo=gaetano.gaballo@banque-france.fr
 Giampaolo Gabbi=gabbi@sdabocconi.it
 Emmanuelle Gabillon=emmanuelle.gabillon@u-bordeaux4.fr
 Alain Gabler=alain.gabler@snb.ch
 Alberto Gabriele=alberto.gabriele@unctad.org
 Roberto Gabriele=roberto.gabriele@unitn.it
 Tommaso Gabrieli=tommaso.gabrieli.1@city.ac.uk
 Péter Gábriel=gabrielp@mnb.hu
 Tommy Staahl Gabrielsen=tommy.gabrielsen@econ.uib.no
 Jonas Gabrielsson=jonas.gabrielsson@circle.lu.se
 Stuart A. Gabriel=stuart.gabriel@anderson.ucla.edu
 Hubert Gabrisch=gab@antec-kabel.de
 Jean Gabszewicz=jean.gabszewicz@uclouvain.be
 Yannick Gabuthy=yannick.gabuthy@univ-fcomte.fr
 Martin Gächter=martin.gaechter@uibk.ac.at
 Simon Gächter=simon.gaechter@nottingham.ac.uk
 János Gács=gacs@econ.core.hu
 María Dolores Gadea=lgadea@unizar.es
 Lucie Gadenne=l.gadenne@ucl.ac.uk
 Arya B. Gaduh=agaduh@walton.uark.edu
 Wulf Christian Gaertner=wulf.gaertner@uni-osnabrueck.de
 Michael Joseph Gagen=mjgagen@gmail.com
 Alberto A. Gaggero=alberto.gaggero@unipv.it
 Paul Gaggl=pgaggl@uncc.edu
 Wagner Piazza Gaglianone=wagner.gaglianone@bcb.gov.br
 Francesca Gagliardi=f.gagliardi@herts.ac.uk
 Stefano Gagliarducci=stefano.gagliarducci@uniroma2.it
 Philippe Gagnepain=philippe.gagnepain@univ-paris1.fr
 Robert Gagné=robert.gagne@hec.ca
 Laurent Gagnol=gagnol@cournot.u-strasbg.fr
 Etienne Gagnon=etienne.gagnon@frb.gov
 Jason Gagnon=jason.gagnon@oecd.org
 Emin Gahramanov=eming@deakin.edu.au
 Firouz Gahvari=fgahvari@illinois.edu
 Norbert J. Gaillard=gaillard@alumni.princeton.edu
 Michael Gail=michael.gail@uni-siegen.de
 Eugenio Gaiotti=eugenio.gaiotti@bancaditalia.it
 Beatriz Gaitan=beatriz.gaitan@fu-berlin.de
 Sandra Constanza Gaitan Riaño=sgaitanr@eafit.edu.co
 Janusz Gajda=janusz.gajda@pwr.wroc.pl
 Thibault Gajdos=thibault.gajdos@univ-amu.fr
 Radha Krishna Gajulapally=grkrishna1963@gmail.com
 Dinesh Prasad Gajurel=dinesh.gajurel@utas.edu.au
 Lewis Landry Gakpa=gakpalewis@yahoo.fr
 Titus J. Galama=galama@usc.edu
 Jose Raymundo Galan Gonzalez=raygalan@gmail.com
 Spyros Galanis=s.galanis@soton.ac.uk
 Jorge E. Galán=jegalan@est-econ.uc3m.es
 Jose Manuel Galan=jmgalan@ubu.es
 Paulo Gala=pgala@uol.com.br
 Ibon Galarraga=ibon.galarraga@bc3research.org
 Omar Galarraga=omar_galarraga@brown.edu
 Francisco B. Galarza=galarza_fb@up.edu.pe
 Emanuela Galasso=egalasso@worldbank.org
 Vincenzo Galasso=vincenzo.galasso@unibocconi.it
 Antonino Galati=antonino.galati@unipa.it
 Gabriele Galati=e.b.g.galati@dnb.nl
 Stefano Galavotti=stefano.galavotti@unipd.it
 Marco Galbiati=marcogalbiati.london@gmail.com
 Jose Enrique Galdon-Sanchez=jose.galdon@unavarra.es
 Virgilio Galdo=vgaldo@syr.edu
 Ewa Gałecka-Burdziak=ewa.galecka-burdziak@sgh.waw.pl
 Douglas Gale=douglas.gale@nyu.edu
 Aurora Galego=agalego@uevora.pt
 Lewis R. Gale, IV=lgale@pacific.edu
 Manolis Galenianos=manolis.galenianos@gmail.com
 Andrea Galeotti=agaleo@essex.ac.uk
 Elisa Galeotti=elisagaleotti@seznam.cz
 Marzio Galeotti=marzio.galeotti@unimi.it
 Alessandro Galesi=alessandro.galesi@cemfi.edu.es
 Alexander Galetovic=alexander@galetovic.cl
 William Glenn Gale=wgale@brookings.edu
 Fabrice GALIA=fabrice.galia@escdijon.eu
 Aida Galiano=aida.galiano@esisl.com
 Jordi Gali=jgali@crei.cat
 Koresh Galil=galilk@bgu.ac.il
 Jaqueson Kingeski Galimberti=jakaga2002@yahoo.com.br
 Gregmar Ignacio Galinato=ggalinato@wsu.edu
 Arturo José Galindo=ajgalindo@gmail.com
 Fernando Galindo-Rueda=fernando.galindo-rueda@oecd.org
 David R. Gallagher=david.gallagher@uts.edu.au
 Emer Marie Gallagher=gallagher-e15@email.ulster.ac.uk
 Liam A. Gallagher=liam.gallagher@dcu.ie
 Mark Gallagher=awaymark@aol.com
 Ryan M Gallagher=r-gallagher1@neiu.edu
 Georges Gallais-Hamonno=georges.gallais-hamonno@univ-orleans.fr
 José Gallardo=jgallardo@pucp.edu.pe
 Mauricio Gallardo=megallar67@hotmail.com
 Natalia Gallardo=nigallar@uc.cl
 R. Karina Gallardo=karina_gallardo@wsu.edu
 delphine Gallaud=dgallaud@dijon.inra.fr
 Marco Gallegati=marco.gallegati@univpm.it
 Mauro Gallegati=mauro.gallegati@gmail.com
 Domingo Gallego=dgallego@unizar.es
 Francisco A. Gallego=fgallego@faceapuc.cl
 Juan Miguel Gallego=juan.gallego@urosario.edu.co
 Nuria Gallego-Lopez=nuria.gallego@uam.es
 Sebastian Gallegos=sebastiangallegos@gmail.com
 Sergio Galletta=sergio.galletta@usi.ch
 Jacques Gallezot=jacques.gallezot@ec.europa.eu
 Danielle Galliano=galliano@toulouse.inra.fr
 Andrea Gallice=andrea.gallice@carloalberto.org
 Emilie-Pauline Gallié=emilie-pauline.gallie@dauphine.fr
 Fausto Galli=fgalli@unisa.it
 Nancy Theresa Gallini=nancy.gallini@ubc.ca
 Giovanni Gallipoli=gallipol@mail.ubc.ca
 Silvia Galli=silvia.galli@unisg.ch
 Michael F. Gallmeyer=mgallmeyer@virginia.edu
 Andres Gallo=agallo@unf.edu
 Crescenzio Gallo=c.gallo@unifg.it
 Fredrik Gallo=fredrik.gallo@nek.lu.se
 Giampiero M. Gallo=gallog@disia.unifi.it
 Faïz Gallouj=faiz.gallouj@univ-lille1.fr
 Thomas Gall=t.gall@soton.ac.uk
 Jesus Gallurt Povedano=jgallurt@etea.com
 Esther Gal-Or=esther@katz.pitt.edu
 Oded Galor=oded_galor@brown.edu
 George C. Galster=aa3571@wayne.edu
 Franck Galtier=franck.galtier@cirad.fr
 Marco Galvagno=mgalvagno@unict.it
 Ana Beatriz Galvão=a.ferreira@qmul.ac.uk
 Gabriel Galvez-Behar=ggalvezbehar@gmail.com
 Luis Armando Galvis=lgalviap@banrep.gov.co
 Sébastien Galy=sebgaly@yahoo.com
 Zoltán Gál=galz@rkk.hu
 Jose R. Gamarra=jgamarve@banrep.gov.co
 Astrid Gamba=astrid.gamba@unimib.it
 Leonardo Gambacorta=leonardo.gambacorta@bis.org
 Marco Gambaro=marco.gambaro@unimi.it
 Francesca Gambarotto=francesca.gambarotto@unipd.it
 Gerardo Fujii Gambero=fujii@unam.mx
 Luca Gambetti=luca.gambetti@uab.es
 Alessandro Gambini=a.gambini@univpm.it
 Lynn Gambin=lynn.gambin@warwick.ac.uk
 Luis Fernando Gamboa=luis.gamboa@urosario.edu.co
 Carlos Gamero Burón=gamero@uma.es
 Sarah Gammage=gammage@oitchile.cl
 Valeriy V. Gamukin=valgam@mail.ru
 Gino Gancia=ggancia@crei.cat
 Giancarlo Gandolfo=kunz@gandolfo.org
 Christopher Gandrud=gandrud@yonsei.ac.kr
 Luca Gandullia=luca.gandullia@unige.it
 Giovanni Ganelli=gganelli@imf.org
 Mariana Cristina Gănescu=cristina_ganescu@yahoo.com
 Georgy Ganev=gogi@cls-sofia.org
 Kaloyan Ganev=k.ganev@gmail.com
 Ira Gang=gang@economics.rutgers.edu
 Amynah Gangji=amgangji@ulb.ac.be
 Jianhua Gang=jhgang@ruc.edu.cn
 Bernhard Ganglmair=ganglmair@utdallas.edu
 Byron Scott Gangnes=gangnes@hawaii.edu
 Partha Gangopadhyay=partha_gang@hotmail.com
 Alejandro Jorge Ganimian=alejandro_ganimian@mail.harvard.edu
 Mohammad Osman Gani=ganiosman@hotmail.com
 Aytül Ganioğlu=aytul.ganioglu@tcmb.gov.tr
 Junwu Gan=junwu_gan@fanniemae.com
 Li Gan=gan@econmail.tamu.edu
 Joshua Gans=joshua.gans@gmail.com
 Mattias Ganslandt=mattias.ganslandt@colorado.edu
 Maria Gantner=mariagantner@gmail.com
 Andrea Ganzaroli=andrea.ganzaroli@unimi.it
 Grace Xing Gao=grace.gao@curtin.edu.au
 Hang Gao=hang.gao@kuleuven.be
 Hong Gao=gaohongfd@gmail.com
 Jiti GAO=jiti.gao@monash.edu
 Lei Gao (皋磊) (Lei Gao)=lei.gao@csiro.au
 Liping Gao=lzg0005@auburn.edu
 Pingyang Gao=pingyang.gao@chicagobooth.edu
 Qingwu Gao=qwgao@yahoo.cn
 Wei Gao=gaow@nenu.edu.cn
 Xiang Gao=gao.xiang@shufe.edu.cn
 Yanyan Gao=adamesky@gmail.com
 Yuning Gao=yg245@cam.ac.uk
 Petr Gapko=petr.gapko@seznam.cz
 Tatiana A. Garanina=garanina@gsom.pu.ru
 Giorgio Garau=giorgio@uniss.it
 Aaron Levi Garavito=agaravac@banrep.gov.co
 Cecilia Garavito=cecilia.garavito@pucp.pe
 Juan-Pedro Garces-Voisenat=juan-pedro.garces-voisenat@durham.ac.uk
 Agustin Garcia Garcia=agarcia@unex.es
 Pascual García Alba=pgarcia_alba@prodigy.net.mx
 Rosa Maria Garcia Almada=rosaga@colef.mx
 Lorena Garcia-Alonso=lorena@uniovi.es
 Jose-Maria Garcia Alvarez-Coque=jmgarcia@upvnet.upv.es
 Emilia Garcia-Appendini=emilia.garcia@unisg.ch
 Rodrigo García Arancibia=rgarcia@fce.unl.edu.ar
 Benjamin Garcia=bejgarci@ucsc.edu
 Belen Garcia Carceles=garcarbe@uv.es
 Raul Lizardo Garcia Carpio=rgarcia@osinerg.gob.pe
 Miguel Garcia-Cerrutti=mcerrutt@energy.state.ca.us
 Santiago García Couto=santgarc@ucu.edu.uy
 Dolores Garcia-Crespo=gcrespo@uma.es
 Gustavo Adolfo García Cruz=gusgarciacruz@gmail.com
 Daniel Garcia=daniel.garcia@univie.ac.at
 Pedro Garcia-del-Barrio=pgarcia@uic.es
 Javier García Enríquez=javier.garcia@ehu.es
 Filomena Garcia=fgarcia@iseg.utl.pt
 Walter Garcia-Fontes=walter.garcia@upf.edu
 Javier Ignacio García-Fronti=fronti@econ.uba.ar
 Aurora García-Gallego=mgarcia@eco.uji.es
 Catalina Garcia Garcia=cbgarcia@ugr.es
 Pilar Garcia-Gomez=garciagomez@ese.eur.nl
 Anna Garcia Gonzalez=annagarciagonzalez@gmail.com
 Gonzalo Daniel Garcia, Sr.=garcia_gonzalo_daniel@economicas.uba.ar
 Alicia Garcia Herrero=aligarciaherrero@yahoo.com
 Alfredo Garcia-Hiernaux=agarciah@ccee.ucm.es
 Jesus M. Garcia-Iglesias=jmgarcia@unex.es
 John J. García=jgarcia@eafit.edu.co
 José Ignacio Uribe García, Sr.=jose.i.uribe@correounivalle.edu.co
 Jose Ramon Garcia=jose.r.garcia@uv.es
 José Luis García-Lapresta=lapresta@eco.uva.es
 Leidy Y. Garcia=legarcia@fen.uchile.cl
 Leonardo García=legarcia@uniandes.edu.co
 Juan Ramón García López=juanramon.gl@bbva.com
 Luis García=lgarcia@pucp.edu.pe
 Marcio G. P. Garcia=mgarcia@econ.puc-rio.br
 Teresa Garcia-Marco=tgmarco@unavarra.es
 María Saavedra García=maluisasaavedra@yahoo.com
 Maria Teresa Medeiros Garcia=mtgarcia@iseg.utl.pt
 Mario García Molina=mgarciamo@unal.edu.co
 Hector Garcia Montero=hector.garciamontero@unibocconi.it
 Teresa M. García-Muñoz=tgarciam@ugr.es
 Ronald Garcia Negrette=rgneconomia@gmail.com
 Pablo Marcelo Garcia=pgarcia@iadb.org
 Cecilia Garcia-Penalosa=cecilia.garcia-penalosa@univ-amu.fr
 Cesar Garcia Perez de Leon=cesar.garciaperezdeleon@sciences-po.org
 J. Ignacio García Pérez=jigarper@upo.es
 Mónica García-Pérez=migarciaperez@stcloudstate.edu
 Armando Jose Garcia Pires=armando.pires@snf.no
 Fernando García-Quero=fgquero@ugr.es
 Jose Garcia-Quevedo=jgarciaq@ub.edu
 Renato Garcia=renato.garcia@poli.usp.br
 René Garcia=rene.garcia@edhec.edu
 Juan Pablo García Rubiano=jpgarciar@gmail.com
 Roberto Garcia-Saltos=rgarciasaltos@imf.org
 Juan Manuel García-Samaniego=mgarcia@utpl.edu.ec
 Antonio GARCIA SANCHEZ=acichez@us.es
 Jaume García Segarra=jagarcia@eco.uji.es
 Serge Garcia=garcia@nancy-engref.inra.fr
 Carlos Garcia-Serrano=carlos.garcia@uah.es
 Pablo García Silva=pgarciasilva@bcentral.cl
 José García Solanes=solanes@um.es
 Andres Felipe Garcia-Suaza=andres.garcia@urosario.edu.co
 Antonio García-Tabuenca=antonio.gtabuenca@uah.es
 Maria A. Garcia-Valiñas=mariangv@uniovi.es
 Rodrigo Garcia-Verdu=rgarciaverdu@imf.org
 Santiago García-Verdú=sgarciav@gmail.com
 Javier Gardeazabal=javier.gardeazabal@ehu.es
 Rodrigo Gardella=gardellarodrigo@hotmail.com
 Gloria Gardenal=ggardenal@unive.it
 Colin Gardiner=colin.gardiner@pearl.com
 Laura Gardini=laura.gardini@uniurb.it
 Lucien Gardiol=lucien.gardiol@chuv.ch
 Alexandros Garefalakis=alex_garefalakis@yahoo.gr
 Maria Lorena Garegnani=lgaregnani@bcra.gov.ar
 Johannes Gareis=johannes.gareis@uni-wuerzburg.de
 Paolo Giorgio Garella=paolo.garella@unimi.it
 Pierre Garello=pierre.garello@univ-amu.fr
 Stefania Garetto=garettos@bu.edu
 Michelle R Garfinkel=mrgarfin@uci.edu
 Ana F. Gargallo-Castel=gargallo@unizar.es
 Reetika Garg=rgarg@econdse.org
 Pietro Garibaldi=pietro.garibaldi@unito.it
 Luis Garicano=luis.garicano@gmail.com
 Gaia Garino=gg44@le.ac.uk
 Gloria Pérez Garmendia=gloriaperez22@hotmail.com
 Phillip Garner=pgarner@coe.edu
 Jean-Philippe Garnier=jean-philippe.garnier@univ-lille3.fr
 Julien Garnier=julien.garnier@caissedesdepots.fr
 Giuseppe Garofalo=garofalo@unitus.it
 Nuno Garoupa=ngaroupa@illinois.edu
 Anthony Garratt=anthony.garratt@wbs.ac.uk
 Rodney Garratt=garratt@econ.ucsb.edu
 A. Bowen Garrett=bowen_garrett@mckinsey.com
 Daniel F. Garrett=daniel.garrett@tse-fr.eu
 James Garrett=j.garrett@cgiar.org
 Thomas Garrett=tgarrett@olemiss.edu
 Melissa M. Garrido=melissa.garrido@mssm.edu
 Rubén Garrido-Yserte=ruben.garrido@uah.es
 Carlos Garriga=carlos.garriga@stls.frb.org
 Marcelo Garriga=marcelogarriga@yahoo.com.ar
 Luke Garrod=l.garrod@lboro.ac.uk
 Mauricio Garrón B.=mgarron@hotmail.com
 Christelle Laetitia Garrouste=christelle.garrouste@univ-orleans.fr
 Christopher Garroway=chris.garroway@unctad.org
 Josean Garrues-Irurzun=jgarrues@ugr.es
 Grégoire Garsous=ggarsous@ulb.ac.be
 Dennis L. Gärtner=dennis.gaertner@uni-bonn.de
 Hermann Gartner=hermann.gartner@iab.de
 Manfred Gärtner=manfred.gaertner@unisg.ch
 Robert Jean Michel Gary-Bobo=robert.gary-bobo@ensae.fr
 Jesus G. Garza-Garcia=jesus_garza@hacienda.gob.mx
 M. Dolores Garza-Gil=dgarza@uvigo.es
 Giampaolo Garzarelli=giampaolo.garzarelli@wits.ac.za
 María Begona Garzon=mariabegona.garzon@ehu.es
 Frédéric Gaschet=gaschet@u-bordeaux4.fr
 Charles Stephen Gascon=charles.s.gascon@stls.frb.org
 Stephane Gascon=stephane.gascon@hrsdc-rhdcc.gc.ca
 Agata Gąsiorowska=agata.gasiorowska@swps.edu.pl
 Ugo Gasparino=ugo.gasparino@gmail.com
 José Maria Lopes Gaspar=jgaspar.phd@fep.up.pt
 Frédéric Gaspart=frederic.gaspart@uclouvain.be
 Martin Gassebner=m.gassebner@reading.ac.uk
 Joachim Gassen=gassen@wiwi.hu-berlin.de
 Franziska Gassmann=franziska.gassmann@maastrichtuniversity.nl
 Emanuel Gasteiger=emanuel.gasteiger@iscte.pt
 Daniel Gat=dangat@bezeqint.net
 Hayette Gatfaoui=hgatfaoui@gmail.com
 John Gathergood=john.gathergood@nottingham.ac.uk
 Christina Gathmann=christina.gathmann@awi.uni-heidelberg.de
 Ksenia Gatskova=gatskova@ios-regensburg.de
 Valerio Gatta=valerio.gatta@uniroma1.it
 Donatella Gatti=gatti@univ-paris13.fr
 Luca Gattini=l.gattini@eib.org
 Roberta Gatti=rgatti@worldbank.org
 Silvia Gatti=silvia.gatti@unibo.it
 Mathieu Gatumel=mathieu.gatumel@ensae.org
 Patrice Gaubert=patrice.gaubert@u-pec.fr
 Jacques Gaude=jgaude@ip-worldcom.ch
 Gérard Gaudet=gerard.gaudet@umontreal.ca
 Alexia Gaudeul=a.gaudeul@gmail.com
 Carl Gaudreault=gaudreault.carl@fin.gc.ca
 James Michael Gaughan=james.gaughan@york.ac.uk
 Patrick Gaulé=patrickgaule@gmail.com
 Guillaume Gaulier=guillaume.gaulier@gmail.com
 Varun Gauri=vgauri@worldbank.org
 Eric Gaus=egaus@ursinus.edu
 Bishnu Prasad Gautam=gautam.biji@gmail.com
 Vikash Gautam=vikash.igidr@gmail.com
 Bernard Gauthier=bernard.gauthier@hec.ca
 Antony GAUTIER=antony.gautier@univ-lille3.fr
 Axel Gautier=agautier@ulg.ac.be
 Erwan Gautier=erwan.gautier@univ-nantes.fr
 Pieter Gautier=p.a.gautier@vu.nl
 Ludovic Gauvin=ludovic.gauvin@gmail.com
 Yin-Feng Gau=yfgau@ncu.edu.tw
 Federico Gavazzoni=federico.gavazzoni@insead.edu
 William Thomas Gavin=gavin@stls.frb.org
 Arieh Gavious=ariehg@bgu.ac.il
 Alejandro Gaviria=agaviria@minsalud.gov.co
 Nicolas Gavoille=nicolas.gavoille@univ-rennes1.fr
 Frédéric Gavrel=frederic.gavrel@unicaen.fr
 Alexandru Adrian Gavrila=galex@ase.ro
 Ionela Gavrila-Paven=ionelapaven@yahoo.com
 Camelia Gavrilescu=cgavrilescu@eadr.ro
 Marius Dan Gavriletea=mgavriletea@yahoo.com
 Kishore Gawande=kgawande@tamu.edu
 Remigiusz Gawlik=remigiusz.gawlik@uek.krakow.pl
 Jean-Pascal GAYANT=jpgayant@univ-lemans.fr
 Daniel Gay=danielrgay@yahoo.co.uk
 Philip G. Gayle=gaylep@ksu.edu
 Martin Gaynor=mgaynor@cmu.edu
 Vladimír Gazda=vladimir.gazda@tuke.sk
 Ardjan Gazheli=a.gazheli@gmail.com
 Robert Gazzale=robert.gazzale@utoronto.ca
 Patrizia Gazzola=patrizia.gazzola@uninsubria.it
 David Sedo Gbaguidi=gbaguididavid@yahoo.fr
 Liviu Geambaşu=liviugeambasu@gmail.com
 Bartosz T. Gebka=b.t.gebka@ncl.ac.uk
 Sebastian Gechert=sebastian-gechert@boeckler.de
 Alemayehu Geda=ag112526@gmail.com
 Ayse Gedik=gedik@metu.edu.tr
 Deborah Gefang=dg171@le.ac.uk
 Agnieszka Gehringer=agehrin@gwdg.de
 Christian Gehrke=christian.gehrke@uni-graz.at
 Alexander Geissler=a.geissler@tu-berlin.de
 Alexander Geist=12alge@gmail.com
 Wouter Gelade=wouter.gelade@fundp.ac.be
 Paolo Gelain=paologelain@yahoo.it
 Ayele Ulfata Gelan=augelana@gmail.com
 Alexander M. Gelber=agelber@nber.org
 Stephen Gelb=sgelb@the-edge.org.za
 Maarten Gelderman=mgelderman@planet.nl
 Hatice Kerra Geldi=hkerra@yeditepe.edu.tr
 Marc Christopher Gelhausen=marc.gelhausen@dlr.de
 Chris Geller=cgeller@westga.edu
 R. Gaston Gelos=ggelos@imf.org
 Martin Gelter=mgelter@law.fordham.edu
 Norman Gemmell=norman.gemmell@vuw.ac.nz
 Jonathan Gemus=jgemus@gmail.com
 Hans Genberg=genberg@verbier.ch
 Ramazan Gencay=gencay@sfu.ca
 Vassil Evgeniev Genchev=vassil.genchev@gmail.com
 Murat Genc=murat.genc@otago.ac.nz
 Murat Can GENC=mcgenc@yahoo.com
 Mario Genco=genco@csilmilano.com
 Talat Genc=tgenc@uoguelph.ca
 Catherine Gendron-Saulnier=c.gendron.saulnier@gmail.com
 Garance Genicot=gg58@georgetown.edu
 Nicola Gennaioli=ngennaioli@crei.cat
 Bernd Genser=bernd.genser@uni-konstanz.de
 Karine Gente=karine.gente@univ-amu.fr
 Andrea Gentili=andreagentiliuni@gmail.com
 Paul Frederick Gentle=meiguorengentle@yahoo.com
 William Gentry=wgentry@williams.edu
 Matthew Aaron Gentzkow=gentzkow@chicagobooth.edu
 Anastassios Gentzoglanis=anastassios.gentzoglanis@usherbrooke.ca
 Pierre Yves Geoffard=geoffard@pse.ens.fr
 Zoe Georganta=zoe@uom.gr
 Nikolaos Georgantzís=n.georgantzis@reading.ac.uk
 Dimitris Georgarakos=georgarakos@hof.uni-frankfurt.de
 Co-Pierre Georg=co-pierre.georg@gsb.uct.ac.za
 Lisa George=lisa.george@hunter.cuny.edu
 Yannis Georgellis=y.georgellis@gmail.com
 Michael L George=mike@entropy2718.com
 Christophre Georges=cgeorges@hamilton.edu
 George Georgescu=georgescu_geo@clicknet.ro
 Irène GEORGESCU=irenegeorgescu@neuf.fr
 Irina Georgescu=irina.georgescu@csie.ase.ro
 Maria - Andrada Georgescu=andradageor@yahoo.com
 Patrick Georges=pgeorges@uottawa.ca
 Teodora Marinova Georgieva=teodora.georgieva@mail.bg
 Kurt Geppert=kgeppert@diw.de
 Petra Maria Geraats=petra.geraats@econ.cam.ac.uk
 Andrea Geraci=agerac@essex.ac.uk
 Andrea Gerali=andrea.gerali@bancaditalia.it
 David Gerard=david.gerard@lawrence.edu
 Kristopher Gerardi=kristopher.gerardi@atl.frb.org
 Marcel Gerard=marcel.gerard@fucam.ac.be
 Иветта Герасимчук (Ivetta Gerasimchuk)=gerasimchuk@mail.ru
 Eddie Gerba=e.e.gerba@lse.ac.uk
 Philippe Gerber=philippe.gerber@ceps.lu
 Christer Gerdes=christer.gerdes@sofi.su.se
 Geoffrey Richard Gerdes=geoffrey.gerdes@frb.gov
 Áron Gereben=a.gereben@eib.org
 Olivier Gergaud=olivier.gergaud@kedgebs.com
 Heiko Gerlach=h.gerlach@uq.edu.au
 Petra Gerlach-Kristen=petra.gerlach@snb.ch
 Stefan Gerlach=hms.gerlach@gmail.com
 Fabrizio Gerli=gerli@unive.it
 Anna Rita Germani=annarita.germani@uniroma1.it
 Fabrizio Germano=fabrizio.germano@upf.edu
 Guido Germano=guido.germano@uni-marburg.de
 Vicente German-Soto=vicentegerman@uadec.edu.mx
 Johannes Gernandt=johannes.gernandt@vdma.org
 Margherita Gerolimetto=margherita.gerolimetto@unive.it
 Athanasios Geromichalos=ageromich@ucdavis.edu
 Emanuele Gerratana=eg198@columbia.edu
 Berit Christiane Gerritzen=berit.gerritzen@unisg.ch
 Christopher J. Gerry=c.gerry@ucl.ac.uk
 Hans Gersbach=hgersbach@ethz.ch
 Seth Gershenson=gershens@american.edu
 Boris Gershman=bgershman@gmail.com
 Mikhail Anatolievich Gershman=mgershman@hse.ru
 Mariana Gerstenblüth=mariana@decon.edu.uy
 Mark Gertler=mark.gertler@nyu.edu
 Paul Gertler=gertler@haas.berkeley.edu
 Pavel Gertler=pavel.gertler@nbs.sk
 Antoine Gervais=agervais@nd.edu
 Jean-Philippe Gervais=jpgervais5@gmail.com
 Martin Gervais=martin-gervais@uiowa.edu
 Simon Gervais=sgervais@duke.edu
 Klarita Gërxhani=k.gerxhani@uva.nl
 Suqin Ge=ges@vt.edu
 Yoseph Yilma Getachew=yoseph.getachew@durham.ac.uk
 Pedro Gete=pg252@georgetown.edu
 Aldo Geuna=aldo.geuna@unito.it
 Deniz Gevrek=deniz_gevrek@yahoo.com
 Alois Geyer=alois.geyer@wu.ac.at
 Johannes Geyer=jgeyer@diw.de
 Olfa N. Ghali=olfa.ghali@gnet.tn
 Sofiane Ghali=sofiane.ghali@gnet.tn
 Tarek Ghalwash=ghalwash@bcsr.gov.bh
 Ejaz Ghani=ejazg@yahoo.com
 Ejaz Ghani=eghani@worldbank.org
 Gairuzazmi M Ghani=gairuzazm@iium.edu.my
 Naghmana Ghani=naghmana@pide.org.pk
 Philip Gharghori=philip.gharghori@monash.edu
 Mojtaba Ghasemi=mojtaba.ghasemi3@gmail.com
 Maitreesh Ghatak=m.ghatak@lse.ac.uk
 Chetan Ghate=cghate@isid.ac.in
 Saghir Pervaiz Ghauri=saghir_ghauri@yahoo.com
 Manuk Ghazanchyan=mghazanchyan@imf.org
 Assaad GHAZOUANI=ghazouani_assaad@yahoo.fr
 kamel Ghazouani=kamel.ghazouani@ihec.rnu.tn
 Hend Ghazzai=hend.ghazzai@qu.edu.qa
 Laurent Gheeraert=lgheerae@ulb.ac.be
 Adrian Ghencea=adighencea@gmail.com
 Andra C. Ghent=aghent@asu.edu
 Anca Gheorghiu=anca.gheorghiu@gmail.com
 Rodica Gherghina=rodicagherghina@yahoo.com
 Ştefan Cristian Gherghina=stefan.gherghina@fin.ase.ro
 Frédéric Ghersi=ghersi@centre-cired.fr
 Christian Ghiglino=cghig@essex.ac.uk
 Emanuela Ghignoni=emanuela.ghignoni@uniroma1.it
 Paul Ghijsen=paul.ghijsen@ou.nl
 Matteo Francesco Ghilardi=mghilardi@imf.org
 Teresa Ghilarducci=teresa.ghilarducci@gmail.com
 Ramesh Ghimire=ghimire@uga.edu
 Paolo Ghinetti=paolo.ghinetti@unicatt.it
 Amandine Ghintran=amandine.ghintran@univ-lille3.fr
 Paolo Ghirardato=paolo.ghirardato@carloalberto.org
 Fabio Ghironi=ghiro@uw.edu
 Claudia Ghisetti=claudia.ghisetti@unibo.it
 Eugen Ghita=eugen67@gmail.com
 Lilia Ghitiu=ghitiulilia@yahoo.com
 Ion Ghizdeanu=ion.ghizdeanu@cnp.ro
 Mohammad Mahdi Ghodsi=mahdi.ghodsi@gmail.com
 Hassan Gholipour Fereidouni=hassanhgf@gmail.com
 Ahmed Farouk Ghoneim=aghoneim@gmx.de
 Sourendra Nath Ghosal=sourenghosal@sify.com
 Vivek Ghosal=vivek.ghosal@econ.gatech.edu
 Anindya Ghose=aghose@stern.nyu.edu
 Arghya Ghosh=a.ghosh@unsw.edu.au
 Arkadipta Ghosh=aghosh@mathematica-mpr.com
 Atish Ghosh=aghosh@imf.org
 Aurobindo Ghosh=aurobindo@smu.edu.sg
 Sayantan Ghosh Dastidar=s.ghoshdastidar@dundee.ac.uk
 Dipak Ghosh=dipak.ghosh@stir.ac.uk
 Diptesh Ghosh=diptesh@iimahd.ernet.in
 Himangshu Ranjan Ghosh=hrghosh@yahoo.com
 Indradeep Ghosh=ighosh@haverford.edu
 Madanmohan Ghosh=madanmohan.ghosh@ec.gc.ca
 Parikshit Ghosh=pghosh@econdse.org
 Rishab Aiyer Ghosh=ghosh@merit.unu.edu
 Sugata Ghosh=sugata.ghosh@brunel.ac.uk
 suman Ghosh=sghosh@fau.edu
 Tejamoy Ghosh=tejamoy@yahoo.co.uk
 Edgar Antoine Ghossoub=edgar.ghossoub@utsa.edu
 Mhamdi Ghrissi=ghrissi.mhamdi@fdseps.rnu.tn
 Samad Ghulam=ghulamsamad@hotmail.com
 Christian Ghymers=cghymers@ec.europa.eu
 Eric Ghysels=eghysels@unc.edu
 Sergio Giaccaria=sergio.giaccaria@unito.it
 Carmelo Giaccotto=cgiaccotto@business.uconn.edu
 Enzo Giacomini=egiacomini@kpmg.com
 Raffaella Giacomini=r.giacomini@ucl.ac.uk
 Olivier Giacomin=olivier.giacomin@tudor.lu
 Erasmo Giambona=e.giambona@uva.nl
 Daniel Giamouridis=dgiamour@aueb.gr
 Rossano Giandomenico=rossano1976@libero.it
 Christian GIANELLA=christian.gianella@dgtresor.gouv.fr
 Angelica Gianfreda=angelicagianfreda@yahoo.it
 Giuseppina Gianfreda=ggianfreda@unitus.it
 Nicholas A. Giannakopoulos=ngias@upatras.gr
 Demetrios S. Giannaros=giannaros@comcast.net
 Gianna Claudia Giannelli=giannelli@unifi.it
 Nikolaos Giannellis=giannellis@uoc.gr
 Simone Giannerini=simone.giannerini@unibo.it
 Caterina Giannetti=caterina.giannetti@gmail.com
 Mariassunta Giannetti=mariassunta.giannetti@hhs.se
 Christos I. Giannikos=christos.giannikos@baruch.cuny.edu
 Valentina Giannini=valentina.giannini@feem.it
 Chryssi Giannitsarou=cg349@cam.ac.uk
 Pierpaolo Giannoccolo=pierpaolo.giannoccolo@unibo.it
 Domenico Giannone=dgiannon@ulb.ac.be
 Marc P. Giannoni=marc.giannoni@ny.frb.org
 Margherita Giannoni=m.giannoni@unipg.it
 Sauveur Giannoni=giannoni@univ-corse.fr
 Simone Giansante=s.giansante@bath.ac.uk
 Elena Giarda=elena.giarda@prometeia.com
 Mario Francesco Giarda Ugalde=mgiarda@bcentral.cl
 Liliane Giardino-Karlinger=lilianegk@gmail.com
 Marco Giarratana=marco.giarratana@uc3m.es
 Francesco Giavazzi=francesco.giavazzi@unibocconi.it
 Stephen Gibbons=s.gibbons@lse.ac.uk
 Michael Gibbs=michael.gibbs@chicagobooth.edu
 Robert M. Gibbs=rgibbs@ers.usda.gov
 Heather D. Gibson=hgibson@bankofgreece.gr
 John Gibson=jkgibson@waikato.ac.nz
 Mark J. Gibson=mjgibson@wsu.edu
 Matthew Gibson=magibson@ucsd.edu
 Dora Gicheva=d_gichev@uncg.edu
 Wolfgang Gick=wolf.gick@tufts.edu
 Thomas Giebe=thomas.giebe@tu-berlin.de
 Anne Christina Gielen=gielen@ese.eur.nl
 Noud van Giersbergen=n.p.a.vangiersbergen@uva.nl
 Seth H. Giertz=giertz@unl.edu
 Kristian Giesen=kristian.giesen@uni-due.de
 Sharon Gifford=sgifford@andromeda.rutgers.edu
 Chiara Gigliarano=c.gigliarano@univpm.it
 Alfredo Gigliobianco=alfredo.gigliobianco@bancaditalia.it
 Jérémie Gignoux=gignoux@pse.ens.fr
 Ilya Gikhman=gikhmani@nku.edu
 Luis Alberiko Gil-Alana=alana@unav.es
 Muriel Gilardone=muriel.gilardone@unicaen.fr
 Evan Gilbert=egilbert@sun.ac.za
 John Gilbert=jgilbert@usu.edu
 Itzhak Gilboa=igilboa@tau.ac.il
 Simon Gilchrist=sgilchri@bu.edu
 David Giles=dgiles@uvic.ca
 John Giles=jgiles@worldbank.org
 Joan Gil=joangil@ub.edu
 Ana Isabel Gil-Lacruz=anagil@unizar.es
 Robert Gillanders=rgillanders@gmail.com
 David Gill=d.gill@univ.oxon.org
 Belen Gill-de-Albornoz=noguer@cofin.uji.es
 Enrique Gilles=enriquegilles@gmail.com
 Fabrice GILLES=fabrice.gilles@univ-lille1.fr
 Donna Gilleskie=dgill@email.unc.edu
 Stuart R. Gillespie=s.gillespie@cgiar.org
 Roland GILLET=roland.gillet@univ-paris1.fr
 Véronique Gille=veronique.gille@univ-paris1.fr
 Gilbert-Rainer Gillich=gr.gillich@uem.ro
 Frederic Gilli=frederic.gilli@ensae.org
 Daniel O. Gilligan=d.gilligan@cgiar.org
 Manfred Gilli=manfred.gilli@unige.ch
 Mario Gilli=mario.gilli@unimib.it
 Kenneth Thomas Gillingham=kenneth.gillingham@yale.edu
 Max Gillman=gillmanm@umsl.edu
 Luciana Araujo Gil=luciana.dearaujo@umayor.cl
 Maria Jose Gil Molto=m.j.gil-molto@sheffield.ac.uk
 Ricard Gil=ricard.gil@jhu.edu
 Andrew R. Gimber=andrew.gimber@eui.eu
 José-Manuel Giménez-Gómez=josemanuel.gimenez@urv.cat
 Jose Ignacio Gimenez-Nadal=ngimenez@unizar.es
 David Gindis=d.gindis@herts.ac.uk
 Thomas (Tim) H. Gindling=gindling@umbc.edu
 Miguel Gines-Vilar=mgines@eco.uji.es
 Xavier Gine=xgine@worldbank.org
 Rita Ginja=rita.ginja@nek.uu.se
 William Ginn=william.ginn@oxfordbusinessalumni.org
 Victor A. Ginsburgh=vginsbur@ulb.ac.be
 Herbert Gintis=hgintis@comcast.net
 Maela Giofre'=maela.giofre@unito.it
 Francesca Gioia=fgioia@unical.it
 Eugenio Pedro Giolito=egiolito@uahurtado.cl
 Germana Giombini=germana.giombini@uniurb.it
 Nicola Giommetti=n.giommetti@email.com
 Gastón Andrés Giordana=gaston_andres.giordana@bcl.lu
 Paolo Giordani=paolo.giordani@riksbank.se
 Claire Giordano=claire.giordano@bancaditalia.it
 Luca Giordano=l.giordano@consob.it
 Raffaela Giordano=raffaela.giordano@bancaditalia.it
 Giovanni Maria Giorgi=giovanni.giorgi@uniroma1.it
 Gianluigi Giorgioni=g.giorgioni@liverpool.ac.uk
 Claude Giorno=claude.giorno@oecd.org
 Alessandro Giosi=giosi@uniroma2.it
 Pierre Giot=pierre.giot@fundp.ac.be
 Alessandro Giovannelli=alessandro.giovannelli@uniroma2.it
 Emanuele Giovannetti=giovannetti@cantab.net
 Giorgia Giovannetti=giorgia.giovannetti@unifi.it
 Alessandro Giovannini=alessandro.giovannini@ceps.eu
 Liudas Giraitis=l.giraitis@qmul.ac.uk
 Andrés Giraldo=a.giraldo@javeriana.edu.co
 Luca Giraldo=giraldo@unitus.it
 Dimitris Giraleas=giralead@aston.ac.uk
 Alessandro Girardi=alessandro.girardi@ymail.com
 Daniele Girardi=daniele.girardi@cresme.it
 Eric Girardin=eric.girardin@univ-amu.fr
 Claudia Girardone=cgirardone@essex.ac.uk
 Gaël Giraud=gael.giraud@parisschoolofeconomics.eu
 Eric Giraud-Héraud=eric.giraud-heraud@ivry.inra.fr
 Raphaël Giraud=rphlgiraud@gmail.com
 Yann Giraud=yann.giraud@u-cergy.fr
 Šarūnas Girdėnas=sg325@exeter.ac.uk
 Federico Giri=f.giri@univpm.it
 Ayca Ebru Giritligil=ayca.ebru@bilgi.edu.tr
 Sourafel Girma=sourafel.girma@nottingham.ac.uk
 Guillaume Girmens=ggirmens@univ-tlse1.fr
 Nathalie Girouard=nathalie.girouard@oecd.org
 Ana Gisbert=ana.gisbert@uam.es
 Rachel M. Gisselquist=rachel.gisselquist@gmail.com
 William Gerard Gissy=wgissy@kimep.kz
 Seth R. Gitter=srgitter@gmail.com
 R. Kaj Gittings=kaj.gittings@ttu.edu
 Maury Gittleman=gittleman_m@bls.gov
 Lara Gitto=gitto@ceis.uniroma2.it
 Vincent Gitz=vincent.gitz@m4x.org
 Gabriele Giudice=gabriele.giudice@ec.europa.eu
 Giudici=giudici@unipv.it
 Antonio Giuffrida=agiuffrida@worldbank.org
 Elisa Giuliani=elisagiuliani@gmail.com
 Laura M. Giuliano=l.giuliano@miami.edu
 Paola Giuliano=paola.giuliano@anderson.ucla.edu
 Corrado Giulietti=giulietti@iza.org
 Monica Giulietti=monica.giulietti@wbs.ac.uk
 Francesco Giuli=francesco.giuli@uniroma3.it
 Massimo Giuliodori=m.giuliodori@uva.nl
 Gianfranco Giulioni=g.giulioni@unich.it
 Anna Giunta=agiunta@uniroma3.it
 Giovanni Osea Giuntella=osea.giuntella@bsg.ox.ac.uk
 Carlo Giupponi=cgiupponi@unive.it
 Michele Giuseppe Giuranno=michele.giuranno@unisalento.it
 Adriana GIURGIU=agiurgiu@uoradea.ro
 Luisa Giuriato=luisa.giuriato@uniroma1.it
 Andrea Giusto=andrea.giusto@dal.ca
 Gregory E. Givens=gegivens@cba.ua.edu
 Carl Gjersem=carl.gjersem@nhd.dep.no
 Steven Gjerstad=gjerstad@chapman.edu
 Aristea Gkagka=argkagka@cc.uoi.gr
 Vasileios Gkionakis=vasileios.gkionakis@unicredit.eu
 Andreas Gkouzos=andreasgko@yahoo.gr
 Jean-Michel Glachant=jean-michel.glachant@eui.eu
 Matthieu Glachant=glachant@mines-paristech.fr
 Edward Ludwig Glaeser=eglaeser@harvard.edu
 John L. Glascock=john.glascock@business.uconn.edu
 Amy Glass=aglass@econmail.tamu.edu
 Manuel Glave=mglave@grade.org.pe
 Pascal Glémain=pascal.glemain@essca.fr
 Paul William Glewwe=pglewwe@umn.edu
 Murray Glickman=murray@mitglick.fsnet.co.uk
 Reuven Glick=reuven.glick@sf.frb.org
 Baruch Gliksberg=baruchg@econ.haifa.ac.il
 Albrecht Glitz=albrecht.glitz@upf.edu
 Tomislav Globan=tgloban@efzg.hr
 Steven Globerman=steven.globerman@wwu.edu
 Vincent Glode=vglode@wharton.upenn.edu
 Oliver Gloede=gloede@gif.uni-hannover.de
 Gerhard Glomm=gglomm@indiana.edu
 Terry Glover=tglover@econ.usu.edu
 Ela Glowicka=eglowi@yahoo.com
 Konstantin Gluschenko=glu@nsu.ru
 Pablo Alfredo Gluzmann=gluzmann@yahoo.com
 Nicholas Glytsos=nglytsos@otenet.gr
 Jean-Yves Gnabo=jygnabo@fundp.ac.be
 Patrick Gneuss=vetter@europa-uni.de
 Blaise Gnimassoun=blaise.gnimassoun@u-paris10.fr
 Stefano Gnocchi=stefano.gnocchi@gmail.com
 Claude Gnos=claude.gnos@wanadoo.fr
 Giorgio Gobbi=giorgio.gobbi@bancaditalia.it
 Niko Gobbin=nikogobbin@yahoo.com
 Bertrand Gobillard=bertrand.gobillard@tse-fr.eu
 Laurent Gobillon=laurent.gobillon@ined.fr
 Matthias Göcke=matthias.goecke@wirtschaft.uni-giessen.de
 Lukasz Goczek=lgoczek@wne.uw.edu.pl
 Geir Godager=geir.godager@medisin.uio.no
 Laurence GODARD=laurence.godard@univ-fcomte.fr
 Mathilde Godard=mathilde.godard@ensae.fr
 Olivier Godard=olivier.godard@polytechnique.edu
 Thomas Goda=tgoda@eafit.edu.co
 Vish Goda=vishgoda@gmail.com
 Raphael Godefroy=raphael.godefroy@umontreal.ca
 Lucas Lúcio Godeiro=lucas.godeiro@hotmail.com
 Benedikt Goderis=b.v.g.goderis@uvt.nl
 E. Bruce Godfrey=bruceg@econ.usu.edu
 Antoine Godin=godin.antoine@gmail.com
 Manuel Mira Godinho=mgodinho@iseg.utl.pt
 Pedro Cortesão Godinho=pgodinho@fe.uc.pt
 Christophe J. Godlewski=godlewski@unistra.fr
 Andrew Christopher Godley=a.c.godley@reading.ac.uk
 Jan Goebel=jgoebel@diw.de
 Juergen Goebel=juergen.goebel9@googlemail.com
 Henry Goecke=henry.goecke@tu-dortmund.de
 Tim Goedemé=tim.goedeme@uantwerpen.be
 Micheline Goedhuys=micheline.goedhuys@gmail.com
 Silja Goehlmann=silja.goehlmann@rwi-essen.de
 Deepti Goel=deepti@econdse.org
 Aditya Goenka=ecsadity@nus.edu.sg
 Jacob K Goeree=jacob.goeree@gmail.com
 Sebastian J. Goerg=sgoerg@fsu.edu
 Laszlo Goerke=goerke@iaaeu.de
 Francisco José Goerlich Gisbert=francisco.j.goerlich@uv.es
 Johanna Goertz=jgoertz@uoguelph.ca
 Timo Goeschl=goeschl@eco.uni-heidelberg.de
 Tatiana Goetghebuer=tatiana.goetghebuer@fundp.ac.be
 Christophe Goethals=c.goethals@crisp.be
 Frank Geert Goethals=f.goethals@ieseg.fr
 Lorenz Goette=lorenz.goette@unil.ch
 William Goetzmann=william.goetzmann@yale.edu
 Martin Richard Goetz=martin.r.goetz@gmail.com
 Florence Goffette-Nagot=goffette-nagot@gate.cnrs.fr
 William Goffe=bill.goffe@psu.edu
 Periklis Gogas=perrygogas@gmail.com
 Sumayya Goga=sumgogawork@gmail.com
 Jean Goggin=jean.goggin@centralbank.ie
 Joseph Gogodze=sosogogodze@yahoo.com
 Kim-Leng Goh=klgoh@um.edu.my
 Sookhoon Goh=sookhoongoh@gmail.com
 Srecko Goic=goic@efst.hr
 Omer Gokcekus=gokcekom@shu.edu
 Gunes Gokmen=gunesgokmen@gmail.com
 Idil Goksel=idil.goksel@ieu.edu.tr
 Turkmen Goksel=turkmen_goksel@yahoo.com
 Soner Gokten=soner.gokten@gazi.edu.tr
 Devrim Göktepe-Hultén=devrim.goktepe-hulten@fpi.lu.se
 Christian Gokus=christian.gokus@uni-due.de
 Amos Golan=agolan@american.edu
 Limor Golan=lgolan@artsci.wustl.edu
 Devra Golbe=dgolbe@hunter.cuny.edu
 Stefan Goldbach=goldbach@vwl.tu-darmstadt.de
 David Goldbaum=david.goldbaum@uts.edu.au
 Sergio Goldbaum=sergio.goldbaum@fgv.br
 Dror Goldberg=dg@drorgoldberg.com
 Linda S. Goldberg=linda.goldberg@ny.frb.org
 Pinelopi Goldberg=penny.goldberg@yale.edu
 Lonnie Golden=lmg5@psu.edu
 Miriam A. Golden=golden@ucla.edu
 Avi Goldfarb=agoldfarb@rotman.utoronto.ca
 Brent Goldfarb=brentg@umd.edu
 Robert Goldfarb=gldfrb@gwu.edu
 Jacob Goldin=jsgoldin@gmail.com
 Steven Goldman=goldman@econ.berkeley.edu
 Robert Gold=robert.gold@ifw-kiel.de
 Peter Goldsmith=pgoldsmi@illinois.edu
 Markus P. Goldstein=mgoldstein@worldbank.org
 Michael Goldstein=goldstein@babson.edu
 Jack A. Goldstone=jgoldsto@gmu.edu
 Anna Golejewska=agolejew@gnu.univ.gda.pl
 Yorgos Goletsis=goletsis@cc.uoi.gr
 Demid Golikov=demid@rocketmail.com
 Roberto Golinelli=roberto.golinelli@unibo.it
 Adam Golinski=adam.golinski@york.ac.uk
 Srinivas Goli=sirispeaks2u@gmail.com
 Daniel Göller=dgoeller@uni-bonn.de
 Jane Golley=jane.golley@anu.edu.au
 Christian Gollier=christian.gollier@tse-fr.eu
 Douglas Gollin=dgollin@williams.edu
 Frank M. Gollop=gollop@bc.edu
 Kamran Golmohammadpoor Azar=st_k.golmohammadpoor@urmia.ac.ir
 Rolf Golombek=rolf.golombek@frisch.uio.no
 Antonio A. Golpe=antonio.golpe@dehie.uhu.es
 Eric Golson=e.b.golson@lse.ac.uk
 Bart Golsteyn=b.golsteyn@maastrichtuniversity.nl
 Alla A. Golub=golub@purdue.edu
 Anastasia A. Golubeva=golubeva@gsom.pu.ru
 Andrey Golubov=andrey.golubov.1@city.ac.uk
 Elif Golveren=elifgolveren@gmail.com
 Ichiro Gombi=gombi@ec.ritsumei.ac.jp
 Matteo Gomellini=matteo.gomellini@bancaditalia.it
 Armando Gomes=gomes@wustl.edu
 Francisco Gomes=fgomes@london.edu
 João F. Gomes=gomesj@wharton.upenn.edu
 Delfim Gomes Neto=dneto@eeg.uminho.pt
 Nicolas Dias Gomes=nicolasdiasgomes@gmail.com
 Orlando Gomes=omgomes@iscal.ipl.pt
 Pedro Gomes=pgomes@eco.uc3m.es
 Renato Gomes=renato.gomes@tse-fr.eu
 Sandra Gomes=sandra.cristina.gomes@bportugal.pt
 Victor Gomes=victorgomes@unb.br
 Mario Gómez Aguirre=gomez_ininee@hotmail.com
 Rebeca Gomez Betancourt=rebeca.gomezbetancourt@univ-lyon2.fr
 Javier Gómez Biscarri=javier.gomez@upf.edu
 David Matesanz Gómez=matesanzdavid@uniovi.es
 Georgina Mercedes Gomez=georginamg@yahoo.com
 Jose Eduardo Gomez-Gonzalez=jgomezgo@banrep.gov.co
 Estrella Gomez-Herrera=estrellagh@gmail.com
 Jaime Gómez=jaime.gomez@unizar.es
 Juan Camilo Gomez=jgomez@uwb.edu
 Claudia S. Gómez-López=claudia.gomez@ugto.org
 Ana Gómez-Loscos=agomezloscos@bde.es
 Miguel Gómez=mga@ccee.ucm.es
 Wilman Arturo Gomez Muñoz=wvongomez@gmail.com
 Alvaro Pìo Gòmez Olaya=alvaropiogomez@gmail.com
 Mario Gomez Olivares=magoliv@iseg.utl.pt
 Blanca Lizeth Gómez OLivo=blancagomez.olivo@gmail.com
 Monica Alexandra Gomez Ospina=monica.gomezos@gmail.com
 Antonio Gómez Gómez-Plana=agomezgp@unavarra.es
 Marta Gómez-Puig=marta.gomezpuig@ub.edu
 Rafael Gomez=ralph.gomez@utoronto.ca
 Rosa Gomez Redondo=rgomez@poli.uned.es
 Rosario Gómez=gomez_zr@up.edu.pe
 Juan Carlos Gomez Sala, Sr.=gsala@ua.es
 Silvia C. Gomez Soler=silvia.gomez@javeriana.edu.co
 Gustavo Alejandro Gomez-Sorzano=alexgosorzano@yahoo.com
 Manuel A. Gómez Suárez=mago@udc.es
 Alberto Emilio Gómez Torres=agomez@unitecnologica.edu.co
 Gerardo Jacinto Gómez-Velázquez=ixcoatl1@hotmail.com
 Paul Gomme=paul.gomme@concordia.ca
 Paul Alan Gompers=pgompers@hbs.edu
 André Daniel Gonçalves, Sr.=adnips@gmail.com
 Carlos Eduardo Goncalves=cesg73@usp.br
 Fernando M. Goncalves=fmg215@gmail.com
 Flávio de Oliveira Gonçalves=f.goncalves@ufpr.br
 Ricardo Gonçalves=rgoncalves@porto.ucp.pt
 Silvia Goncalves=silvia.goncalves@umontreal.ca
 Anatoliy G. Goncharuk=agg@ua.fm
 Ahmet Goncu=ahmet.goncu@xjtlu.edu.cn
 Celine Gondat-Larralde=celine.gondat-larralde@bankofengland.co.uk
 Mihaela Göndör=mihaelagondor@yahoo.com
 Feride Doganer Gonel=gonel@yildiz.edu.tr
 Chi Gong=gongchi81@hotmail.com
 Erick Gong=egong@middlebury.edu
 Honge Cathy Gong=cathy.gong@natsem.canberra.edu.au
 Jiong Gong=johngong@gmail.com
 Liutang Gong=ltgong@gsm.pku.edu.cn
 Xiaodong Gong=xiaodong.gong@natsem.canberra.edu.au
 Yundan Gong=y.gong1@aston.ac.uk
 Eleimon Gonis=eleimon2.gonis@uwe.ac.uk
 Gustavo Gonzaga=gonzaga@econ.puc-rio.br
 Alberto Gonzales=apg2ny@virginia.edu
 Efrain Gonzales de Olarte=egonzal@pucp.edu.pe
 Rolando Gonzales Martínez=rgonzales@udape.gob.bo
 Adrian Gonzalez=adrian.gonzalez.cr@gmail.com
 Carlos González-Aguado=cgonagu@gmail.com
 Aldo Gonzalez=agonzalez@econ.uchile.cl
 Andres Gonzalez=a.gonzalez78@uniandes.edu.co
 Angela González Arbeláez=gonza491@umn.edu
 Ariel Sebastian Gonzalez, Sr.=agonzalez@caei.com.ar
 Miguel Angel Gonzalez Belmonte=miguel.belmonte@strath.ac.uk
 Sara M. González-Betancor=sgonzalez@dmc.ulpgc.es
 Daniel Jose Gonzalez Buitrago=daniel.gonzalez@ben.colfuturo.org
 Jorge González Chapela=jorgegc@unizar.es
 Osiel González Dávila=osiel.davila@soas.ac.uk
 Carlos Giovanni González Espitia=cggonzalez@icesi.edu.co
 Eduardo González Fidalgo=efidalgo@uniovi.es
 Fidel Gonzalez=fxg001@shsu.edu
 Mario González-Flores=mg0043a@american.edu
 Francisco M. Gonzalez=francisco.gonzalez@uwaterloo.ca
 Germán Héctor González=ghgonza@uns.edu.ar
 González-Gómez, Francisco=fcojose@ugr.es
 Jose González, Sr.=10.josegonzalez@gmail.com
 Libertad Gonzalez=libertad.gonzalez@upf.edu
 Miguel González-Loureiro=mloureiro@uvigo.es
 Miguel González-Maestre=mmaestre@um.es
 Christian Gonzalez-Martel=cgonzalez@dmc.ulpgc.es
 Xose Manuel Gonzalez Martinez=xmgonzalez@uvigo.es
 Maximiliano González=maxgonza@uniandes.edu.co
 Pablo Gonzalez M.=pablogon@uahurtado.cl
 Marco Gonzalez-Navarro=marco.gonzalez.navarro@utoronto.ca
 Pablo Gonzalez=pgonzale@dii.uchile.cl
 Patrick Gonzalez=pgon@ecn.ulaval.ca
 Paula González=pgonzalez@upo.es
 Wildo Gonzalez P.=wildogonzalez@yahoo.com
 Gloria Gonzalez-Rivera=gloria.gonzalez@ucr.edu
 Rosa Marina González Marrero=rmglzmar@ull.es
 Martin Gonzalez-Rozada=mrozada@utdt.edu
 Mar González Savignat=savignat@uvigo.es
 Stéphane Gonzalez=stephane.gonzalez@univ-paris1.fr
 Steven Gonzalez=steven.gonzalez@ic.gc.ca
 Rafael González-Val=rafaelg@unizar.es
 Victor Manuel Gonzalez, Sr.=lero_go@hotmail.com
 Fernando González-Vigil=gonzalez_lf@up.edu.pe
 Jesus Gonzalo=jesus.gonzalo@uc3m.es
 Amanda H. Goodall=amanda@amandagoodall.com
 Marvin Goodfriend=marvingd@andrew.cmu.edu
 Joshua S. Goodman=joshua_goodman@hks.harvard.edu
 Timothy J. Goodspeed=timothy.goodspeed@hunter.cuny.edu
 Barry Kent Goodwin=barry.k.goodwin@gmail.com
 Craufurd David Goodwin=goodwin@econ.duke.edu
 Jan G. De Gooijer=j.g.degooijer@uva.nl
 Austan Goolsbee=goolsbee@gsb.uchicago.edu
 Prateek Goorha=goorha@sent.com
 Maarten Goos=maarten.goos@econ.kuleuven.be
 Peter Goos=peter.goos@ua.ac.be
 Pawan Gopalakrishnan=pawan8ad@gmail.com
 Radhakrishnan Gopalan=gopalan@wustl.edu
 Ramu Gopalan=gopalan.ramu@gmail.com
 Sasidaran Gopalan=sasi.daran@gmail.com
 Marie Goppelsroeder=mariegoppelsroeder@web.de
 Bino Paul G D=binogd@yahoo.com
 Olga Gorbachev=olgag@udel.edu
 Russell Gorddard=russell.gorddard@csiro.au
 Hugo Gordijn=hugo.gordijn@xs4all.nl
 Niccolo' Gordini=niccolo.gordini@unimib.it
 Jorge P. Gordin=gordin@giga-hamburg.de
 Brett R. Gordon=brgordon@columbia.edu
 Daniel V. Gordon=dgordon@ucalgary.ca
 David B. Gordon=gd@clemson.edu
 Lawrence Allan Gordon=lgordon@rhsmith.umd.edu
 Leo-Rey C. Gordon=leorey.c.gordon@wilmu.edu
 Nora E. Gordon=neg24@georgetown.edu
 Robert J. Gordon=rjg@northwestern.edu
 Sidartha Gordon=sidartha.gordon@sciencespo.fr
 Michael Gordy=michael.gordy@frb.gov
 Paul K. Gorecki=pkgorecki@gmail.com
 Erkan Gören=erkan.goeren@uni-oldenburg.de
 Manuela Goretti=mgoretti@imf.org
 Nadezhda Goreyko=ngoreyko@hse.ru
 Tue Gorgens=tue.gorgens@anu.edu.au
 Holger Görg=goerg@economics.uni-kiel.de
 Konrad Görg=konrad.goerg@fal.de
 Stéphane Goria=stephane.goria@univ-lorraine.fr
 Juan Gorigoitia=juan.gorigoitia@usach.cl
 Luca Gori=luca.gori@unige.it
 Michele Gori=michele.gori@unifi.it
 Joanna Górka=joanna.gorka@umk.pl
 Christian Gormsen=cgo@cevea.dk
 Şakir Görmüş=sgormus@sakarya.edu.tr
 Martin Gornig=mgornig@diw.de
 Arantza Gorostiaga=arantza.gorostiaga@ehu.es
 Vyacheslav Gorovoy=vgorovoy@gmail.com
 Janko Gorter=janko.gorter@dnb.nl
 Matthew Gorton=matthew.gorton@ncl.ac.uk
 Mette Gørtz=mette.gortz@econ.ku.dk
 Grzegorz Gorzelak=gorzelak@post.pl
 Zizi Goschin=zizigoschin@yahoo.com
 Amanda Gosling=a.gosling@kent.ac.uk
 Nikolay Gospodinov=nikolay.gospodinov@atl.frb.org
 Pierre Gosselin=gosselin@ujf-grenoble.fr
 Dr. Gour Gobinda Goswami=gour@northsouth.edu
 Samrat Goswami=sam449@rediffmail.com
 Maximilian Göthner=maximilian.goethner@uni-jena.de
 Iurie Gotisan=gotisani@hotmail.com
 Daisaku Goto=dgoto@hiroshima-u.ac.jp
 Elisabetta Gotor=e.gotor@cgiar.org
 Piero Gottardi=gottardi@unive.it
 Nils Gottfries=nils.gottfries@nek.uu.se
 Charles Gottlieb=charles.gottlieb@economics.ox.ac.uk
 Daniel Gottlieb=danielgt@nioi.gov.il
 Daniel Gottlieb=dgott@wharton.upenn.edu
 Joshua D. Gottlieb=joshua.gottlieb@ubc.ca
 Katrin Gottschalk=katrin.gottschalk@aut.ac.nz
 Peter Gottschalk=gottscha@bc.edu
 Sandra Gottschalk=gottschalk@zew.de
 Radim Gottwald=radim.gottwald@mendelu.cz
 Georg Götz=georg.goetz@wirtschaft.uni-giessen.de
 Linde Götz=goetz@iamo.de
 Thomas Götz=t.gotz@maastrichtuniversity.nl
 Teycir Abdelghani Goucha=goucha@hotmail.com
 Hojatallah Goudarzi=hg502003@yahoo.com
 René Goudriaan=r.gou3aan@xs4all.nl
 Richard B. Goud, Jr.=blake.goud@gmail.com
 Christophe Gouel=christophe.gouel@grignon.inra.fr
 Antoine Goujard=antoine.goujard@gmail.com
 Michael Goujon=michael.goujon@udamail.fr
 Catarina Goulão=catarina.goulao@toulouse.inra.fr
 Pedro Goulart=pgoulart@iscsp.ulisboa.pt
 Eleftherios Goulas=egoulas@upatras.gr
 Neelesh Gounder=neelesh.gounder@gmail.com
 Catherine Gourbin=catherine.gourbin@uclouvain.be
 Julien Gourdon=julien.gourdon@cepii.fr
 Pierre-Olivier Gourinchas=pog@econ.berkeley.edu
 Francois Gourio=fgourio@gmail.com
 Stéphane Goutte=goutte@math.univ-paris-diderot.fr
 Miguel Gouveia=mig@ucp.pt
 Sofia Gouveia=sgouveia@utad.pt
 Chandran V G R=vgrchan@gmail.com
 Arbiana Govori=govoriarbiana@gmail.com
 John Gowdy=johngowdy@earthlink.net
 Abhinav Goyal=agoyal@liv.ac.uk
 Amit Goyal=amit.goyal@unil.ch
 Aparajita Goyal=agoyal3@worldbank.org
 Vidhan K. Goyal=goyal@ust.hk
 Jonathan Goyette=jonathan.goyette@usherbrooke.ca
 Estelle Gozlan=esgozlan@grignon.inra.fr
 Juan Carlos Gozzi=j.c.gozzi-valdez@warwick.ac.uk
 Thomas de Graaff=t.de.graaff@vu.nl
 Janusz K. Grabara=janusz@grabara.eu
 Markus M. Grabka=mgrabka@diw.de
 Martin F. Grace=mgrace@gsu.edu
 Tim A. Graciano=tim.graciano@ey.com
 Kathryn Graddy=kgraddy@brandeis.edu
 Giani Gradinaru=giani_gradinaru@ase.ro
 Carlos Gradín=cgradin@uvigo.es
 Mark Gradstein=grade@bgumail.bgu.ac.il
 Raymond Gradus=r.h.j.m.gradus@vu.nl
 Patrick Michael Grady=p_grady@global-economics.ca
 Michał Gradzewicz=mgradz@gmail.com
 Andreas Graefe=andreas.graefe@ifkw.lmu.de
 Georg Graetz=g.graetz@lse.ac.uk
 Dominik Grafenhofer=dominik@grafenhofer.at
 Michael Graff=graff@kof.ethz.ch
 Julia Graf=julia.graf@uni-bamberg.de
 R. Quentin Grafton=quentin.grafton@anu.edu.au
 Ugo Maurizio Gragnolati=u.gragnolati@sssup.it
 Bryan S. Graham=bryangraham@berkeley.edu
 James Graham=james.graham@rbnz.govt.nz
 John W. Graham=jwgraham@andromeda.rutgers.edu
 Stuart J.H. Graham=graham@gatech.edu
 Andreas Graichen=andreas.graichen@wiwi.uni-regensburg.de
 Peter Grajzl=grajzlp@wlu.edu
 Theoharry Grammatikos=theoharry.grammatikos@uni.lu
 Joachim Grammig=joachim.grammig@uni-tuebingen.de
 María José Granado=mjgranado@gmail.com
 Joan Camilo Granados Castro=jcgranadosc@unal.edu.co
 Paulina Andrea Granados Zambrano=paulina.granados@eui.eu
 Catalina Granda Carvajal=catalina.granda@udea.edu.co
 Silvia Grandi=silvia.grandi@unimore.it
 Gilles Grandjean=grandjean@fusl.ac.be
 Jean-Michel Grandmont=grandmon@ensae.fr
 Luis Granero=luis.m.granero@uv.es
 Ðura-Georg Granić=georg.granic@uni-koeln.de
 Laurent Granier=granier@lameta.univ-montp1.fr
 Bligh Grant=bgrant5@une.edu.au
 Darren Grant=dgrant@shsu.edu
 Hugh M K Grant=h.grant@uwinnipeg.ca
 Jason H. Grant=jhgrant@vt.edu
 Laura E. Grant=lgrant@bren.ucsb.edu
 Simon Grant=simongrant@uq.edu.au
 Brigitte Evelyne Granville=b.granville@qmul.ac.uk
 Urban Gråsjö=urban.grasjo@hv.se
 Tobias Grasl=t.grasl@bbk.ac.uk
 Emanuele Grassi=emanuele.grassi@unisalento.it
 Laura Grassini=laugrassini@libero.it
 Simona Grassi=simona.grassi@unil.ch
 Stefano Grassi=s.grassi@kent.ac.uk
 Alessandro Giovanni Grasso=agrasso@unimore.it
 Verena Grass=vgrass@diw.de
 Gabriele Gratton=g.gratton@unsw.edu.au
 Manfred Grautoff, Sr.=mgrautoff@msn.com
 Barbara Susanne Grave=barbara.grave@stifterverband.de
 Hugh Gravelle=hg8@york.ac.uk
 Jane G. Gravelle=jgravelle@crs.loc.gov
 Toni R. Gravelle=tgravelle@bank-banque-canada.ca
 Nicolas Gravel=nicolas.gravel@univ-amu.fr
 Ebbe Krogh Graversen=ebbe.krogh.graversen@cfa.au.dk
 Philip E. Graves=philip.graves@colorado.edu
 Joanna Gravier-Rymaszewska=jgr@pmail.ntu.edu.sg
 Nathan D. Grawe=ngrawe@carleton.edu
 Alastair Gray=alastair.gray@dph.ox.ac.uk
 Allan Wayne Gray=gray@purdue.edu
 Colin Gray=ctgray90@gmail.com
 Rowena Gray=rgray6@ucmerced.edu
 Virginia Gray=vagray@email.unc.edu
 Wayne B. Gray=wgray@clarku.edu
 Wesley R. Gray=wgray@uchicago.edu
 Clara Graziano=clara.graziano@uniud.it
 Marcello Graziano=marcello.graz@gmail.com
 Maria Gabriella Graziano=mgrazian@unina.it
 Fabio Grazi=grazif@afd.fr
 Marco Grazzi=marco.grazzi@unibo.it
 Lisa Grazzini=lisa.grazzini@unifi.it
 Ana Grdović Gnip=agrdovic@unipu.hr
 Mads Greaker=mgr@ssb.no
 Thomas Grebel=thomas.grebel@tu-ilmenau.de
 Petr Grebennikov=petrgrebennikov@yandex.ru
 Tim Grebe=grebe@wiwi.hu-berlin.de
 Luciano G. Greco=luciano.greco@unipd.it
 Alan Green=greena@econ.queensu.ca
 Nathalie Greenan=nathalie.greenan@cee-recherche.fr
 David Greenaway=david.greenaway@nottingham.ac.uk
 Seth Greenblatt=sgreenblatt@austin.rr.com
 Colin P. Green=c.p.green@lancaster.ac.uk
 David A. Green=green@econ.ubc.ca
 Edward Green=edgreen@psu.edu
 William H Greene=wgreene@stern.nyu.edu
 Francis Green=f.green@ioe.ac.uk
 Christine Anne Greenhalgh=christine.greenhalgh@spc.ox.ac.uk
 Lorna A. Greening=lgdoone@aol.com
 Kenneth P. Green=ken.green@fraserinstitute.org
 Kesten Charles Green=kesten@me.com
 Mitchell Ray Green=mrgcn3@mail.umkc.edu
 Richard John Green=r.green@imperial.ac.uk
 Richard Green=richarkg@usc.edu
 Jennifer Victoria Greenslade=jennifer.greenslade@bankofengland.co.uk
 Michael Greenstone=mgreenst@mit.edu
 Jeremy Greenwood=do-not-use@jeremygreenwood.net
 Birgitte Gregersen=bg@business.aau.dk
 Matthew T. Gregg=mgregg@rwu.edu
 Filippo Gregorini=filippo.gregorini@gmail.com
 Andros Gregoriou=andros.gregoriou@brunel.ac.uk
 Wildmer Daniel Gregori=wildmer.gregori@unibo.it
 Allan W. Gregory=awg@qed.econ.queensu.ca
 Christian A. Gregory=cgregory@ers.usda.gov
 Mary Gregory=mary.gregory@economics.ox.ac.uk
 Robert George Gregory=bob.gregory@anu.edu.au
 Ian Gregory-Smith=i.gregory-smith@sheffield.ac.uk
 Terry Gregory=gregory@zew.de
 Avner Greif=avner@stanford.edu
 Ben Greiner=bgreiner@unsw.edu.au
 Jenny Grek=jenny.grek@ihh.hj.se
 Carl GREKOU=g.grekou@u-paris10.fr
 Marian Grendar=umergren@savba.sk
 Julien Grenet=julien.grenet@ens.fr
 Gilles Grenier=gilles.grenier@uottawa.ca
 Francesca Greselin=francesca.greselin@unimib.it
 Thomas A. Gresik=tgresik@nd.edu
 Christopher Gresse=cgresse@gmx.net
 Michal Greszta=mgreszta@wne.uw.edu.pl
 Alexei Gretchikha=gretchikha@geocities.com
 Richard T. Gretz=rgretz@bradley.edu
 Jane Greve=jg@rff.dk
 Wolf-Heimo Grieben=wolf-heimo.grieben@wiwi.uni-halle.de
 Daniela Grieco=daniela.grieco@unibocconi.it
 Kevin Grier=angus@ou.edu
 Robin Marie Grier=rgrier@ou.edu
 Ronald Edward Grieson=grieson@ucsc.edu
 Roy H. Grieve=roygrieve@btinternet.com
 Marnie Griffith=marnie.griffith@monash.edu
 Rachel Griffith=rgriffith@ifs.org.uk
 Charles Griffiths=griffiths.charles@epa.gov
 David T. Griffiths=david.griffiths@treasury.gov
 William Edward Griffiths=wegrif@unimelb.edu.au
 Ian Grigg=iang@iang.org
 Michel Louis Grignon=grignon@mcmaster.ca
 Francesco Grigoli=francesco.grigoli.82@gmail.com
 Laura Grigolon=laura.grigolon@mcmaster.ca
 Florian Dumitru Grigore=gdflorian@yahoo.com
 Adriana Grigorescu=adrianagrigorescu11@gmail.com
 Theocharis Grigoriadis=theocharis.grigoriadis@fu-berlin.de
 David Grigorian=dgrigorian@imf.org
 Therese Cavlovic Grijalva=tgrijalva@weber.edu
 Leonardo Grilli=grilli@disia.unifi.it
 Luca Grilli=luca.grilli@unifg.it
 Markus Grillitsch=markus.grillitsch@circle.lu.se
 Federico Grillo=fgrillo@bcra.gov.ar
 Michele Grillo=michele.grillo@unicatt.it
 Filipe Grilo=100421007@fep.up.pt
 Gianluca Grimalda=grimalda@uji.es
 Raffaele Grimaldi=raffaele.grimaldi@polimi.it
 Arthur Grimes=grimes.tarrant@xtra.co.nz
 Paul W. Grimes=paul.grimes@pittstate.edu
 Heike Grimm=heike.grimm@uni-erfurt.de
 Oliver R. Grimm=ogrimm@ethz.ch
 Veronika Grimm=veronika.grimm@fau.de
 Christoph Grimpe=cg.ino@cbs.dk
 Damian Grimshaw=damian.grimshaw@mbs.ac.uk
 Ruslan Semenovich Grinberg=grinberg@inecon.ru
 Dimitri Grinkevich=gridl@mail.com
 Yaniv Grinstein=yg33@cornell.edu
 Francisco Grippa=grippa_fa@up.edu.pe
 Olesya V. Grishchenko=olesya.v.grishchenko@frb.gov
 Elena Grishina=egrishinawork@gmail.com
 Christian Grisse=christian.grisse@snb.ch
 Maria Grith=gritmari@wiwi.hu-berlin.de
 Felix Groba=fgroba@diw.de
 Lisa M. Grobar=lgrobar@csulb.edu
 Mathieu Grobéty=mathieu.grobety@snb.ch
 Christelle Grobler=cgrobler@sun.ac.za
 Jan Grobovsek=jan.grobovsek@ed.ac.uk
 Willem van Groenendaal=w.j.h.vgroenendaal@uvt.nl
 Patrick Groenen=groenen@ese.eur.nl
 Rolf Adriaan Groeneveld=rolf.groeneveld@wur.nl
 Jan J. J. Groen=jan.groen@ny.frb.org
 Kelly A. Grogan=kellyagrogan@ufl.edu
 Olaf Groh-Samberg=ogrohsamberg@bigsss.uni-bremen.de
 José L. Groizard=joseluis.groizard@uib.es
 Dominik Groll=dominik.groll@ifw-kiel.de
 Erik Grönqvist=erik.gronqvist@ifau.uu.se
 Marc Gronwald=mgronwald@abdn.ac.uk
 Ben Groom=b.groom@lse.ac.uk
 Paul Grootendorst=paul.grootendorst@utoronto.ca
 Peter A. Groothuis=groothuispa@appstate.edu
 Loek Groot=l.f.m.groot@uu.nl
 Reint Gropp=reint.gropp@hof.uni-frankfurt.de
 Adrian Grosanu=adrian.grosanu@econ.ubbcluj.ro
 Anders Grosen=gro@asb.dk
 Nicolas Groshenny=nicolas.groshenny@adelaide.edu.au
 Pauline Grosjean=p.grosjean@unsw.edu.au
 Shoshana Grossbard=shosh@mail.sdsu.edu
 Adam J. Grossberg=adam.grossberg@trincoll.edu
 Christian Gross=gross@econ.mpg.de
 Dominique M. Gross=dgross@sfu.ca
 Elena Gross=elena.gross@uni-bayreuth.de
 Jens Grosser=jgrosser@fsu.edu
 Stefan Grosse=stefan.grosse@googlemail.com
 Luca Grosset=grosset@math.unipd.it
 Luigi Grossi=luigi.grossi@univr.it
 Brit Grosskopf=b.grosskopf@bham.ac.uk
 Emiliano Grossman=emiliano.grossman@sciences-po.fr
 Gene Grossman=grossman@princeton.edu
 Michael Grossman=mgrossman@gc.cuny.edu
 Volker Grossmann=volker.grossmann@unifr.ch
 Philip J. Grossman=philip.grossman@monash.edu
 Richard S. Grossman=rgrossman@wesleyan.edu
 Zachary Grossman=grossman@econ.ucsb.edu
 Till Gross=till_gross@carleton.ca
 Veronica Grosu=doruveronica@yahoo.it
 Gerda Charlotta Groth=charlotta.groth@zurich.com
 Christian Groth=chr.groth@econ.ku.dk
 John C. Groth=kari01@neo.tamu.edu
 Gabriela Grotkowska=ggrotkowska@wne.uw.edu.pl
 Pascal GROUIEZ=pascal.grouiez@univ-paris-diderot.fr
 Arti Grover=artigrover@gmail.com
 Alexander Groves=agroves@ulb.ac.be
 Jeremy Ross Groves=jgroves@niu.edu
 Theodore Groves=tgroves@ucsd.edu
 Jakub Growiec=jakub.growiec@sgh.waw.pl
 Christian Growitsch=christian.growitsch@uni-koeln.de
 Farley Grubb=grubbf@udel.edu
 Michael D. Grubb=michael.grubb@bc.edu
 Herbert Grubel=herbert.grubel@shaw.ca
 Jonathan Gruber=gruberj@mit.edu
 Stefan Gruber=stefan.gruber@innsbruckeconomics.com
 Tanja Grublješič=tanja.grubljesic@ef.uni-lj.si
 Sven Gruener=sven.gruener@landw.uni-halle.de
 Guillaume P. Gruère=ggruere@gmail.com
 Andraž Grum=andraz.grum@ifin.si
 Thomas Ulrich Grund=thomas.u.grund@gmail.com
 Nicole Grunewald=ngrunew@uni-goettingen.de
 Marek Gruszczynski=marek.gruszczynski@sgh.waw.pl
 Maria Grydaki=maria.grydaki@stir.ac.uk
 Adelina Gschwandtner=adelina.gschwandtner@univie.ac.at
 Thomas Gschwend=gschwend@uni-mannheim.de
 Maria Guadalupe=maria.guadalupe@insead.edu
 Claudia Guagliano=claudia.guagliano@gmail.com
 Carlos Guaipatin=guaipatin@yahoo.com
 Danilo Guaitoli=daguaitoli@gmail.com
 Guillermo Guajardo Soto=guillermo.guajardo@unam.mx
 Elisabetta Gualandri=elisabetta.gualandri@unimore.it
 Dabo Guan=dg346@cam.ac.uk
 Barbara Guardabascio=guardabascio@istat.it
 Alessandra Guariglia=a.guariglia@bham.ac.uk
 Arlen Guarin=aguariga@banrep.gov.co
 Giulio Guarini=giulioguarini@unitus.it
 Antonio Guarino=a.guarino@ucl.ac.uk
 Gianni Guastella=gianni.guastella@gmail.com
 Juan Carlos Guataquí=juan.guataqui@urosario.edu.co
 Alain Guay=guay.alain@uqam.ca
 Flore Gubert=gubert@dial.prd.fr
 Matthias Gubler=matthias.gubler@snb.ch
 Calogero Guccio=guccio@unict.it
 Chao Gu=guc@missouri.edu
 Mehmet Güçlü=mehmet.guclu@ege.edu.tr
 Jens Gudmundsson=jens.gudmundsson@nek.lu.se
 Sveinn Gudmundsson=s.gudmundsson@esc-toulouse.fr
 Manelle Guechtouli=manel.guech@yahoo.fr
 Gaël Gueguen=g.gueguen@esc-toulouse.fr
 Anita Guelfi=aguelfi@worldbank.org
 Maia Güell=maia.guell@gmail.com
 Alexander Guembel=alexander.guembel@tse-fr.eu
 Charlotte Guénard=guenard@univ-paris1.fr
 Alfred V. Guender=alfred.guender@canterbury.ac.nz
 Abdelkrim Ahmed Guendouz=dr.guendouz@gmail.com
 Samira Guennif=samira@guennif.com
 Eric Guerci=eric.guerci@gredeg.cnrs.fr
 Kevin John Guerin=kevin.guerin@treasury.govt.nz
 Pierre Guérin=pguerin@bankofcanada.ca
 Gerardo A. Guerra=gguerra@aya.yale.edu
 Giuliano Guerra=giuliano.guerra@ti.ch
 José Alberto Guerra=jguerraforero@gmail.com
 Maria Letizia Guerra=mletizia.guerra@unibo.it
 Marco Guerrazzi=guerrazzi@economia.unige.it
 David Guerreiro=david.guerreiro@univ-paris8.fr
 Gertrudes Saúde Guerreiro=gdsg@uevora.pt
 Carlos Guerrero=carlos.guerrero.de.lizardi@gmail.com
 David Guerrero=d-guerrero@cunef.edu
 Rodolfo Guerrero=rgmora@banxico.org.mx
 Santiago Guerrero=sguerreroe@gmail.com
 Gabriela A. Guerrero Serdan=ag_guerreroserdan@yahoo.com
 Luca Guerrieri=luca.guerrieri@frb.gov
 Carmine Guerriero=c.guerriero@uva.nl
 Guesnerie Roger=roger.guesnerie@college-de-france.fr
 paul M. Guest=p.guest@surrey.ac.uk
 Imene Guetat=iguetat@yahoo.fr
 Delphine Guex=delphine.guex@unine.ch
 Alois Guger=alois.guger@wifo.ac.at
 Alexi GUGUSHVILI=alexi.gugushvili@eui.eu
 Brishti Guha=bguha@smu.edu.sg
 Katja Guhr=katja.guhr@iwh-halle.de
 Benedetto Gui=benedetto.gui@unipd.it
 Renelle Guichard=renelle.gaudin@laposte.net
 Francesco Guidi=f.guidi@gre.ac.uk
 Marco E.L. Guidi=mel.guidi@ec.unipi.it
 Massimo Guidolin=massimo.guidolin@unibocconi.it
 Pablo Emilio Guidotti=pguidotti@utdt.edu
 Jordi Guilera=jordiguilerarafecas@yahoo.es
 Joaquim Jose Martins Guilhoto=guilhoto@usp.br
 Rachel Guillain=guillain@u-bourgogne.fr
 Michel Guillard=michel.guillard@univ-evry.fr
 Elvire Guillaud=elvire.guillaud@univ-paris1.fr
 Cyriac Guillaumin=cyriac.guillaumin@upmf-grenoble.fr
 Sylviane Guillaumont Jeanneney=sylviane.guillaumont@udamail.fr
 Patrick Guillaumont=p.guillaumont@u-clermont1.fr
 Catherine Guillemineau=cguillemineau@orange.fr
 Jorge Guillén=jguillen@esan.edu.pe
 Montserrat Guillen=mguillen@ub.edu
 Osmani Teixeira de Carvalho Guillén=osmani.guillen@bcb.gov.br
 Pablo Guillen=pablo.guillen@sydney.edu.au
 Amélie Guillin=guillin.amelie@gmail.com
 María Dolores Guilló=guillo@ua.es
 Yves Guillotin=yves.guillotin@univ-lemans.fr
 Sarah Guillou=sarah.guillou@sciencespo.fr
 Sophie Guilloux-Nefussi=sophie.nefussi@gmail.com
 Christophe Z. Guilmoto=guilmoto@ird.fr
 Paulo Guimaraes=pguimaraes2001@gmail.com
 Raquel Rangel de Meireles Guimarães=raquelrguima@gmail.com
 Céline Guimas=c.guimas.1@research.gla.ac.uk
 Houssein Guimbard=houssein.guimbard@cepii.fr
 GUINDE Loïc=loic.guinde@antilles.inra.fr
 G Emmanuel Guindon=emmanuel.guindon@umontreal.ca
 Timothy Guinnane=timothy.guinnane@yale.edu
 Anne-Catherine GUIO=ac.guio@yahoo.fr
 Fernando Guirao=fernando.guirao@upf.edu
 Jean-Pascal Guironnet=jean-pascal.guironnet@unicaen.fr
 M. Carmen Guisan=mcarmen.guisan@usc.es
 Luigi Guiso=guiso@tin.it
 Brahim GUIZANI=brahim_guizani@yahoo.fr
 Gujjarappa Thimmaiah=thimmaiahgujjarappa@yahoo.com
 Adam Hubert Gulan=adam.gulan@bof.fi
 Sumeet Gulati=sumeetgul@gmail.com
 Magnus Gulbrandsen=magnus.gulbrandsen@tik.uio.no
 Ejaz Gul=ejazgul@bzu.edu.pk
 Bulent Guler=bguler@indiana.edu
 Mustafa Haluk Guler=haluk.guler@tcmb.gov.tr
 Joakim Gullstrand=joakim.gullstrand@nek.lu.se
 Sajid Gul=sajidali10@hotmail.com
 Eda Gulsen=edagulsen@gmail.com
 Saba Gulzar=sabagulzar@gmail.com
 Fabià Gumbau-Brisa=gumbau-brisa@post.harvard.edu
 Anil Gumber=a.gumber@shu.ac.uk
 Erdal Gümüş=egumus25@gmail.com
 Gulcin Gumus=ggumus@fau.edu
 Theresia Gunawan=theresia@msm.nl
 Asha Dilshani Gunawardena=asha1oct@gmail.com
 Emine Nur Ozkan Gunay=gunayen@boun.edu.tr
 Philip Gunby=philip.gunby@canterbury.ac.nz
 Sebastian Gundel=sebastian.gundel@occstrategy.de
 Marco Gundermann=mgundermann@uwic.ac.uk
 Craig Gundersen=cggunder@illinois.edu
 Michael A. Gunderson=mgunders@purdue.edu
 Morley Gunderson=morley.gunderson@utoronto.ca
 Erich Gundlach=erich.gundlach@wiso.uni-hamburg.de
 Naci Gundogan=ngundoga@anadolu.edu.tr
 Yalin Gündüz=yalin.gunduz@bundesbank.de
 Nezih Guner=nezih.guner@movebarcelona.eu
 Nil Demet Güngör=ndgungor@atilim.edu.tr
 Hiroshi Gunji=hgunji@ic.daito.ac.jp
 Calum Gunn=calum.gunn@comcom.govt.nz
 Christopher M. Gunn=chris.gunn@carleton.ca
 Lasse Frisgaard Gunnersen=lgunnersen@econ.au.dk
 Trude Gunnes=gut@ssb.no
 Jan Willem Gunning=j.w.gunning@vu.nl
 Anna Gunnthorsdottir=anna.gunnthorsdottir@wu.ac.at
 Bernhard Georg Gunter=president@bangladeshstudies.org
 Jutta Günther=jutta.guenther@uni-bremen.de
 Jochen Güntner=jochen.guentner@jku.at
 Bing Guo=bing.guo@uc3m.es
 Chao Guo=guoccn@gmail.com
 郭东 (Dong GUO)=guo.dong99@gmail.com
 Guixia Guo=guoguixia@gmail.com
 Huanxiu GUO=huanxiu.guo@udamail.fr
 Hui Guo=hui.guo@uc.edu
 Jang-Ting Guo=guojt@ucr.edu
 Kai Guo=kaiguo@post.harvard.edu
 Mengmeng Guo=gmm@swufe.edu.cn
 Nick Lei Guo=nicklguo@gmail.com
 Pei Guo=guopei307@gmail.com
 Rongxing Guo=rongxingguo@sina.com
 Shen Guo=sguo.cufe@gmail.com
 Zhichao Guo=sxguozc@hotmail.com
 Abhay Gupta=abhayg@abhayg.com
 Abhimanyu Gupta=a.gupta@essex.ac.uk
 Abhishek Gupta=agupta28@gmail.com
 Akash Gupta=no_controls@yahoo.com
 Amar Gupta=gupta@eller.arizona.edu
 Devendra B. Gupta=dbgupta219@hotmail.com
 Francis Gupta=fg1965@verizon.net
 Gautam Gupta=gautamju@yahoo.com
 Kanupriya Gupta=kgupta@adb.org
 Kartick Gupta=kartick.gupta@unisa.edu.au
 Manash Ranjan Gupta=manashgupta@isical.ac.in
 Manish Gupta=manish.econ@gmail.com
 Poonam Gupta=pgupta.nipfp@gmail.com
 Prashant Gupta=p.gupta@qmul.ac.uk
 Rakesh Gupta=r.gupta@griffith.edu.au
 Rangan Gupta=rangan.gupta@up.ac.za
 Rupayan Gupta=rxgupta@rwu.edu
 Sumedha Gupta=sumedhagupta@gmail.com
 Hasan Gürak=hasmendi@gmail.com
 Yesim Gurbuz Besek=yesim.gurbuz@gmail.com
 Burak GURBUZ=bugurbuz@gmail.com
 Burcu Gurcihan=burcu.gurcihan@tcmb.gov.tr
 Constantin Gurdgiev=gurdgic@tcd.ie
 Özgür Gürerk=ozgur.gurerk@rwth-aachen.de
 Angelo Costa Gurgel=angelo_gurgel@yahoo.com.br
 Henryk Gurgul=henryk.gurgul@gmail.com
 Tugrul Gurgur=tugrul.gurgur@tcmb.gov.tr
 Sergei Guriev=guriev@nes.ru
 Igor Gurkov=gurkov@list.ru
 Nurullah Gur=nurullahgur@yahoo.com
 Guner Gursoy=gunergursoy@yahoo.com
 Oliver Gürtler=oliver.guertler@uni-koeln.de
 Umit G. Gurun=umit.gurun@utdallas.edu
 Jonathan Guryan=j-guryan@northwestern.edu
 Tobias Guse=tobias.guse@uni-dortmund.de
 Alexander Gushchin=gushchin@mi.ras.ru
 Riccardo Gusso=rgusso@unive.it
 Johan E. Gustafsson=cje.gustafsson@gmail.com
 Martin Anders Gustafsson=mgustafsson@sun.ac.za
 Robin Gustafsson=robin.gustafsson@aalto.fi
 Magnus Gustavsson=magnus.gustavsson@nek.uu.se
 Alan L. Gustman=alan.l.gustman@dartmouth.edu
 Marius Gust=mariusgust@yahoo.com
 Nils Gutacker=nils.gutacker@york.ac.uk
 Dawit Diriba Guta=davdiriba@yahoo.com
 Graeme Guthrie=graeme.guthrie@vuw.ac.nz
 Joanne F. Guthrie=jguthrie@ers.usda.gov
 Werner Güth=gueth@econ.mpg.de
 Guillermo Gutiérrez Cárdenas=guillermongc@gmail.com
 Luis Enrique Gutiérrez Casas=lgtz@uacj.mx
 Emilio Gutierrez=emilio.gutierrez@itam.mx
 Luis Gutiérrez-Flores=luis.gutierrez@uadec.edu.mx
 Matias Alfredo Gutierrez Girault=mggirault@bcra.gov.ar
 Hamlet Gutierrez=hamletgutierrez@mail.com
 Fernando Gutiérrez Hidalgo=fguthid@upo.es
 Carlos Gutierrez-Hita=cgutierrez@umh.es
 Eva Gutierrez-i-Puigarnau=egutierrez@feweb.vu.nl
 Juan Julio Gutierrez=jgutier3@gmu.edu
 Luciano Gutierrez=info@gutierrezluciano.net
 Luis Hernando Gutiérrez=luis.gutierrez@urosario.edu.co
 María-José Gutiérrez=mariajose.gutierrez@ehu.es
 Mario A. Gutierrez=mgutierrez@mgglobalamerica.com
 Fernanda Gutierrez-Navratil=luifergu2002@hotmail.com
 Roxana Gutiérrez-Romero=roxana.gutierrez@uab.es
 Hector Elias Gutierrez Rufrancos=h.gutierrez-rufrancos@sussex.ac.uk
 Daniel Gutknecht=daniel.gutknecht@economics.ox.ac.uk
 Cahit Guven=cahit@deakin.edu.au
 Fatih Guvenen=guvenen@umn.edu
 Serhat Guven=kiratin@gmail.com
 Wulong Gu=wulong.gu@statcan.gc.ca
 Frederick Guy=f.guy@bbk.ac.uk
 Yuanyuan Gu=yuanyuan.gu@gmail.com
 Martin Guzi=martin.guzi@econ.muni.cz
 Mark G. Guzman=m.g.guzman@reading.ac.uk
 Ricardo Andrés Guzmán=rnguzman@uc.cl
 Rolando M. Guzman=rguzman@gcpareto.com
 Salome Gvetadze=s.gvetadze@eif.org
 James D. Gwartney=jgwartne@coss.fsu.edu
 Wencke Gwozdz=wg.ikl@cbs.dk
 Thorvaldur Gylfason=gylfason@hi.is
 Jacob Gyntelberg=jacob.gyntelberg@bis.org
 Attila Gyorgy=attila.gyorgy@buget-finante.ro
 Joseph Gyourko=gyourko@wharton.upenn.edu
 Henryk Gzyl=henryk.gzyl@iesa.edu.ve
