 Belkacem Laabas=belkacem@api.org.kw
 Helinä Laakkonen=helina.laakkonen@bof.fi
 Helena Laaksonen=helena.laaksonen@uta.fi
 Jani-Petri Laamanen=jani-petri.laamanen@uta.fi
 Gaston J. Labadie=labadie@ort.edu.uy
 Martin Lábaj=martinlabaj@gmail.com
 David Neil Laband=david.laband@econ.gatech.edu
 Xavier Labandeira=xavier@uvigo.es
 Giovanna Labartino=giovanna.labartino@gmail.com
 Felipe Labbé=falabbe@uchicago.edu
 Vincent Labhard=vincent.labhard@ecb.europa.eu
 Marc Labie=marc.labie@umons.ac.be
 Fabien Labondance=fabien.labondance@sciencespo.fr
 David Laborde Debucquet=d.laborde@cgiar.org
 Sandrine Labory=sandrine.labory@unife.it
 Carmen Maria Lacatus (Constantinescu)=cmlacatus@yahoo.com
 M. Victoria Lacaze=mvlacaze@mdp.edu.ar
 Nicola Lacetera=nicola.lacetera@utoronto.ca
 Jean-Pierre Lachaud=lachaud@u-bordeaux4.fr
 Michee Arnold Lachaud=michee.lachaud@fulbrightmail.org
 Catalina Lache=catalina_lache@yahoo.com
 Stefan Lachenmaier=mail@stefan-lachenmaier.de
 Oussama Lachiri=lachiri.o@gmail.com
 Łukasz Lach=llach@zarz.agh.edu.pl
 Jeffrey Lacker=jeffrey.lacker@rich.frb.org
 Mario Lackner=mario.lackner@jku.at
 Mária Lackó=lackom@econ.core.hu
 Marie Laclau=marie.laclau@ens.fr
 Anna Torres Lacomba=anna.torres@upf.edu
 Juan A. Lacomba=jlacomba@ugr.es
 Dominique Lacoue-Labarthe=dll@u-bordeaux4.fr
 Lisbeth Funding la Cour=llc.eco@cbs.dk
 Carla La Croce=carla.lacroce@eco.unipv.it
 Anne Lacroix=lacroix@grenoble.inra.fr
 Guy Lacroix=guy.lacroix@ecn.ulaval.ca
 Sumner Jonathan La Croix=lacroix@hawaii.edu
 Sarolta Laczó=sarolta.laczo@iae.csic.es
 Jacob Ladenburg=jala@kora.dk
 Elizabeth S. Laderman=elizabeth.laderman@sf.frb.org
 Jeffrey W. Ladewig=jeffrey.ladewig@uconn.edu
 Christos Ap. Ladias=caladias@otenet.gr
 Dan Ladley=d.ladley@le.ac.uk
 Norbert Jean Marie Ladoux=norbert.ladoux@tse-fr.eu
 George Madison Lady=gmlady@ix.netcom.com
 Luc Laeven=llaeven@imf.org
 Roger J. A. Laeven=r.j.a.laeven@uva.nl
 Eliana La Ferrara=eliana.laferrara@unibocconi.it
 Anne Laferrere=anne.laferrere@insee.fr
 Gilles Lafforgue=gilles.lafforgue@toulouse.inra.fr
 François Lafond=lafond@merit.unu.edu
 Francine Lafontaine=laf@umich.edu
 Paul Anthony LaFontaine=plafonta636@ucla.edu
 Jeffrey Thomas LaFrance=jeffrey.lafrance@gmail.com
 Patrick Lagadec=plagadec@club-internet.fr
 Bernhard Lageman=lageman@rwi-essen.de
 Johan N. M. Lagerlöf=johan.lagerlof@econ.ku.dk
 Nils-Petter Lagerlöf=lagerlof@econ.yorku.ca
 André Maia Gomes Lages=andre_lages@msn.com
 Luis Filipe Lages=lflages@fe.unl.pt
 Ignacio Lago=ignacio.lago@upf.edu
 Santiago Lago-Peñas=slagop@uvigo.es
 Francisco Lagos=fmlagos@ugr.es
 Marie-Aude Laguna=marie-aude.laguna@dauphine.fr
 Roger Lagunoff=lagunofr@georgetown.edu
 Dr. Soumitra Lahiri=lahiri@lahirionline.com
 Kajal Lahiri=klahiri@albany.edu
 Radhika Lahiri=r.lahiri@qut.edu.au
 Somdeb Lahiri=somdeb.lahiri@yahoo.co.in
 Rim Lahmandi-Ayed=rim.lahmandi.ayed@gmail.com
 Michael L. Lahr=lahr@rutgers.edu
 Alexandra Lai=laia@bankofcanada.ca
 Fodil LAIB=fodil.laib@cevital.com
 David Laibson=dlaibson@harvard.edu
 David Laidler=laidler@uwo.ca
 Edwin L.-C. Lai=elai@ust.hk
 Hung-pin Lai=ecdhpl@ccu.edu.tw
 Jennifer T. Lai=econlai@gmail.com
 Christopher A. Laincz=claincz@drexel.edu
 Jean Lainé=jean@bilgi.edu.tr
 Derek Laing=laing_derek@hotmail.com
 Timothy James Laing=timlaing31@gmail.com
 Pedro Lains=pedro.lains@ics.ul.pt
 Ping-yen Lai=pingyenlai@gmail.com
 Puqing Lai=laipuqing@gmail.com
 Richard Lai=lairk@wharton.upenn.edu
 Francois Laisney=laisney@zew.de
 Tat-kei Lai=tl.eco@cbs.dk
 Ulrich Laitenberger=laitenberger@zew.de
 John Laitner=jlaitner@umich.edu
 Yu-Bong Lai=yblai@nccu.edu.tw
 Fatma Lajeri=flajeri@yahoo.com
 Csilla Lakatos=csilla.lakatos@ec.europa.eu
 Arthur Lake=wuhlax@gmail.com
 James Lake=jlake@smu.edu
 Faten Lakhal=lakhal@univ-paris12.fr
 Salem Y. Lakhal=lakhals@umoncton.ca
 tarik LAKHAL=tlakhal@u-bourgogne.fr
 Rajith W. D. Lakshman=rajith71@gmail.com
 Aurélie Lalanne=aurelie.lalanne@u-bordeaux4.fr
 Etienne Lalé=etienne.lale@bristol.ac.uk
 Rafael Lalive=rafael.lalive@unil.ch
 Kaushalesh Lal=lal@merit.unu.edu
 Somik Lall=somiklall@gmail.com
 Subir Lall=slall@imf.org
 Martin Lally=martin.lally@vuw.ac.nz
 Robert John LaLonde=r-lalonde@uchicago.edu
 Massimiliano La Marca=massi.la.marca@gmail.com
 Jean-Francois Lamarche=jfl@brocku.ca
 Guilherme B. R. Lambais=gbrlambais@gmail.com
 Jean-Christian Lambelet=jean-christian.lambelet@unil.ch
 Bruce Henry Lambert=bruce@reorient.com
 Mario B. Lamberte=marlamberte3352@yahoo.com
 Luca Lambertini=luca.lambertini@unibo.it
 Luisa Lambertini=luisa.lambertini@epfl.ch
 Ariane Lambert-Mogiliansky=alambert@pse.ens.fr
 Sylvie Lambert=sylvie.lambert@ens.fr
 Thomas Lambert=thomas.lambert@uclouvain.be
 Dionysia Lambiri=d.lambiri@soton.ac.uk
 Stéphane Lambrecht=stephane.lambrecht@univ-valenciennes.fr
 Kyriacos Lambrias=kyriacos.lambrias@bcl.lu
 David Lam=davidl@umich.edu
 Nelida Lamelas=nelida.lamelas@usc.es
 Martien Lamers=martien.lamers@ugent.be
 Marco Lamieri=marco.lamieri@intesasanpaolo.com
 Karine Lamiraud=lamiraud@essec.edu
 Jean-Paul Lam=jplam@uwaterloo.ca
 Bettina Lamla=lamla@mea.mpisoc.mpg.de
 Michael Lamla=mlamla@essex.ac.uk
 Judith Lammers=judithlammers1@gmail.com
 Konrad Lammers=k-lammers@europa-kolleg-hamburg.de
 Ana Lamo=ana.lamo@ecb.int
 Andrea Roberto Lamorgese=andrea.lamorgese@bancaditalia.it
 Elina Lampi=elina.lampi@economics.gu.se
 Jennifer Lamping=jennifer_lewis@rand.org
 Pierfrancesco La Mura=plamura@hhl.de
 Luis Fernando Lanaspa Santolaria=llanas@unizar.es
 Francesco Lancia=francesco.lancia@univie.ac.at
 Mariangela Parra Lancourt=parra@un.org
 Camille Landais=c.landais@lse.ac.uk
 Claudia M. Landeo=landeo@ualberta.ca
 Jim Landers=jlanders@iga.in.gov
 Rasmus Landersø=rl@rff.dk
 Michael Landesmann=landesmann@wiiw.ac.at
 Maurice Reiff Landes=mlandes@ers.usda.gov
 William M. Landes=w-landes@uchicago.edu
 Chiara Landi=chiara.landi@for.unipi.it
 Fabio Landini=fabio.landini@medalics.org
 Florian Landis=landis@zew.de
 Erlangga Agustino Landiyanto=erlanggaagustino@yahoo.com
 David Lando=dl.fi@cbs.dk
 John Landon-Lane=lane@econ.rutgers.edu
 Stuart Landon=stuart.landon@ualberta.ca
 Anthony Landry=alandry@wharton.upenn.edu
 Craig Elliott Landry=landryc@ecu.edu
 Julia Lane=jlane@air.org
 Philip Lane=plane@tcd.ie
 Joseph Lanfranchi=lanfranchi@u-paris2.fr
 Dany Lang=lang.dany@univ-paris13.fr
 Andreas Lange=andreas.lange@wiso.uni-hamburg.de
 Andrés Langebæk=alangeba@aya.yale.edu
 Carsten Lange=clange@csupomona.edu
 Sven Langedijk=sven.langedijk@jrc.ec.europa.eu
 Fabian Lange=fabolange@gmail.com
 Fabien Lange=fabien.lange@u-bordeaux4.fr
 Ian Andrew Lange=ilange@mines.edu
 Dominika Irma Langenmayr=dominika.langenmayr@econ.lmu.de
 Simon Lange=simon.lange@wiwi.uni-goettingen.de
 Thomas Lange=t.lange@curtin.edu.au
 Kim Michelle Langfield-Smith=kim.langfield-smith@monash.edu
 Günter Lang=guenter.lang@guc.edu.eg
 Rolf J. Langhammer=rolf.langhammer@ifw-kiel.de
 Corinne Langinier=corinne.langinier@ualberta.ca
 Kevin Lang=lang@bu.edu
 Eric LANGLAIS=eric.langlais@u-paris10.fr
 Suchada Langley=slangley@ers.usda.gov
 Richard N. Langlois=richard.langlois@uconn.edu
 Markus Lang=markus-lang@gmx.net
 Matthias Lang=lang@hu-berlin.de
 Audun Langørgen=aul@ssb.no
 Francois Langot=flangot@univ-lemans.fr
 Hong Lan=lanhongken@gmail.com
 Peter Frederik Lanjouw=planjouw@worldbank.org
 Maureen Lankhuizen=m.b.m.lankhuizen@vu.nl
 Jussi Eerik Lankoski=jussi.lankoski@oecd.org
 Gauthier Lanot=gauthier.lanot@econ.umu.se
 Alessandra La Notte=alessandra.lanotte@unito.it
 Kevin J. Lansing=kevin.j.lansing@sf.frb.org
 Alessandro Lanteri=al14@aub.edu.lb
 Andrea Lanteri=a.lanteri@lse.ac.uk
 luis n. lanteri, Sr.=lnlante@yahoo.com.ar
 Van A. Lantz=vlantz@unb.ca
 Xiaohuan Lan=xhlan@ckgsb.edu.cn
 Yuexing Lan=ylan@aum.edu
 Matteo Lanzafame=mlanzafame@unime.it
 Alberto Lanzavecchia=alberto.lanzavecchia@unipd.it
 Elisa Lanzi=elisa.lanzi@oecd.org
 Jennifer La'O=jenlao@columbia.edu
 Nikiforos Laopodis=nlaopodis@alba.edu.gr
 Morgane Laouenan=morgane.laouenan@sciences-po.org
 Athanasios Lapatinas=alapatin@cc.uoi.gr
 Blandine Laperche=laperche@univ-littoral.fr
 Beverly Lapham=laphamb@econ.queensu.ca
 André Lapidus=lapidus@univ-paris1.fr
 André Lapied=a.lapied@univ-amu.fr
 Simon Lapointe=simon.lapointe@unifr.ch
 Rafael La Porta=rafael.laporta@dartmouth.edu
 Christine Laporte=christine.laporte@statcan.gc.ca
 Valentina Lapo=region24@yandex.ru
 Gabriel Lara Ibarra=glaraibarra@worldbank.org
 Manuel Laranja=mlaranja@iseg.utl.pt
 Yoandris Sierra Lara, Sr.=ysierra@fcsh.upr.edu.cu
 Mario Larch=mario.larch@uni-bayreuth.de
 Martin Larch=martin.larch@ec.europa.eu
 Valentino Larcinese=v.larcinese@lse.ac.uk
 sandrine Lardic=lardicbmo@yahoo.fr
 Andrew Olegovish Larin=fayst67@mail.ru
 Benjamin Larin=larin@wifa.uni-leipzig.de
 Sherry L. Larkin=slarkin@ufl.edu
 Maurizio La Rocca=m.larocca@unical.it
 Catherine Laroche Dupraz=laroche@agrocampus-ouest.fr
 Borja Larrain=borja.larrain@uc.cl
 Mauricio Larrain=ml3439@columbia.edu
 Sophie Larribeau=sophie.larribeau@univ-rennes1.fr
 Jeff Larrimore=jhl42@cornell.edu
 Juan M.C. Larrosa=jlarrosa@criba.edu.ar
 José María Larrú=larram@ceu.es
 Brad Larsen=bjlarsen@stanford.edu
 Jens D J Larsen=jens.larsen@rbccm.com
 Mona Larsen=ml@sfi.dk
 Daniel Joseph Larson=bshark441@gmail.com
 Donald F. Larson=dlarson@worldbank.org
 William D. Larson=larsonwd@gmail.com
 Bo Larsson=blr@du.se
 Bo IJ Larsson=bo.larsson@nek.lu.se
 Jan Larsson=jan.w.larsson@telia.com
 Anna Larsson Seim=anna.larsson@ne.su.se
 Emmanuel K.K. Lartey=elartey@fullerton.edu
 Mauro M. Laruccia=mauro.laruccia@gmail.com
 Annick Laruelle=a.laruelle@ikerbasque.org
 Andrea Lasagni=andrea.lasagni@unipr.it
 Stefan Laséen=stefan.laseen@riksbank.se
 Karlos La Serna=laserna_k@up.edu.pe
 Meziane Lasfer=m.a.lasfer@city.ac.uk
 Addisu A Lashitew=a.a.lashitew@rug.nl
 Daniel Laskar=daniel.laskar@ens.fr
 Natacha Laskowski=natacha.laskowski@u-bordeaux4.fr
 Jean-François Laslier=jean-francois.laslier@ens.fr
 Maria Grazia La Spada=mlaspada@unime.it
 Moundir LASSASSI=moundir.lassassi@etu.univ-amu.fr
 Laurence S. Lasselle=ll5@st-andrews.ac.uk
 David Dreyer Lassen=david.dreyer.lassen@econ.ku.dk
 Pierre Lasserre=lasserre.pierre@uqam.ca
 Casilda Lasso de la Vega=casilda.lassodelavega@ehu.es
 William D Lastrapes=last@uga.edu
 Jacek Aleksander Łaszek=jacek.laszek@gmail.com
 Sonia Laszlo=sonia.laszlo@mcgill.ca
 Maciej M Latek=mlatek@gmu.edu
 Davide La Torre=davide.latorre@unimi.it
 María C. Latorre=cmlatorre@estad.ucm.es
 Karine Latouche=karine.latouche@nantes.inra.fr
 Paul L. Latreille=p.latreille@sheffield.ac.uk
 Laure Latruffe=laure.latruffe@rennes.inra.fr
 Raoul Lättemäe=raoul@hot.ee
 Thomas Laubach=laubach@wiwi.uni-frankfurt.de
 Chi Keung marco lau=kenlau123@hotmail.com
 C. Oscar Lau=c.l.lau@massey.ac.nz
 Mauro Laudicella=m.laudicella@imperial.ac.uk
 Stephan Lauermann=s.lauermann@gmail.com
 Evan Lau=lphevan@feb.unimas.my
 Marita Laukkanen=marita.laukkanen@vatt.fi
 Lisa Laun=lisa.laun@ifau.uu.se
 Tobias Laun=tobias.laun@nek.uu.se
 Luís Laureano=luis.laureano@iscte.pt
 Raul M. S. Laureano=raul.laureano@iscte.pt
 James Laurenceson=j.laurenceson@uq.edu.au
 Éloi Laurent=eloi.laurent@ofce.sciences-po.fr
 Hélène Laurent=helene.laurent@unamur.be
 Sébastien Laurent=sebastien.laurent@univ-amu.fr
 Thierry Laurent=laurent@univ-evry.fr
 Márcio Laurini=mplaurini@gmail.com
 Jens Martin Lauritsen=jm.lauritsen@dadlnet.dk
 Keld Laursen=kl.ino@cbs.dk
 Didier Laussel=didier.laussel@univ-amu.fr
 Mette Lausten=mel@sfi.dk
 Delphine Lautier=delphine.lautier@dauphine.fr
 Wee-Yeap Lau=wylau@um.edu.my
 Luc Lauwers=luc.lauwers@econ.kuleuven.be
 Pablo Lavado=p.lavadopadilla@up.edu.pe
 Rouselle F. Lavado=rlavado@mail.pids.gov.ph
 Luciano Lavecchia=luciano.lavecchia@bancaditalia.it
 Henry Laverde=hlaverde@gmail.com
 Andrea Mario Lavezzi=mario.lavezzi@unipa.it
 Anne Lavigne=anne.lavigne@univ-orleans.fr
 Lena LAVINAS=lenalavinas@gmail.com
 Victor Chaim Lavy=v.lavy@warwick.ac.uk
 Ibrahim L. Awad=ibrahimphd@yahoo.com
 David Robert Colin Law=david.law@treasury.govt.nz
 Steve Lawford=steve_lawford@yahoo.co.uk
 Martina Lawless=martina.lawless@centralbank.ie
 Marc T. Law=marc.law@uvm.edu
 Peter Lawrence=p.r.lawrence@econ.keele.ac.uk
 Siong Hook Law=lawsh@upm.edu.my
 Cornelia Lawson=cornelia.meissner@unito.it
 Daniel Matthew Custance Lawson=dmlawson@oaklandcc.edu
 David Lawson=david.lawson@manchester.ac.uk
 Terra Lawson-Remer=tlr229@nyu.edu
 Robert A. Lawson=robert.a.lawson@gmail.com
 Tony Lawson=tony.lawson@econ.cam.ac.uk
 Helen Lawton Smith=h.lawton-smith@bbk.ac.uk
 Tzuo Hann Law=tzuohann@gmail.com
 Vincent Law=u4177364@anu.edu.au
 Ramanan Laxminarayan=ramanan@rff.org
 Jean-Bernard Layan=layan@u-bordeaux4.fr
 Jann Lay=lay@giga-hamburg.de
 Sok Heng Lay=henglay@gmail.com
 Ewa Lazarczyk=ewa.lazarczyk@ifn.se
 Sophia Lazaretou=slazaretou@bankofgreece.gr
 Olga Lazareva=olazareva@hse.ru
 Dimche Lazarevski=lazarevski@uacs.edu.mk
 Valery Lazarev=lazarev@hoover.stanford.edu
 Marinela Lazarica=mlazarica@yahoo.com
 Themistokles G. Lazarides=themis@themis.gr
 Panagiotis Lazaridis=t.lazaridis@aua.gr
 Dorothea C. Lazaro=thealazaro@gmail.com
 Vanya Todorova Lazarova=vlazarova@unwe.bg
 Paula Lazar=lazar_paula@yahoo.com
 Edward Lazear=lazear@stanford.edu
 Vicente Lazen=vlazen@svs.cl
 Ioannis Lazopoulos=i.lazopoulos@surrey.ac.uk
 Natalia Lazzati=nlazzati@umich.edu
 Andrew Leach=andrew.leach@ualberta.ca
 John Leach=leach@mcmaster.ca
 Dermot Leahy=dermot.leahy@nuim.ie
 Eimear Leahy=eimear.leahy3@mail.dcu.ie
 John Leahy=john.leahy@nyu.edu
 Rodrigo Mendes Leal=rmendesleal@gmail.com
 Marc Leandri=marc.leandri@u-bordeaux4.fr
 Hooi Lean=learnmy@gmail.com
 Anh Tram Le=a.le@curtin.edu.au
 Pedro Leão=pleao@iseg.utl.pt
 Carlos Frederico Leão Rocha=fred@ie.ufrj.br
 Jennifer Leavy=j.leavy@uea.ac.uk
 Thomas Le Barbanchon=tlebarbanchon@gmail.com
 Blake Lebaron=blebaron@brandeis.edu
 Nadezhda Lebedeva=nlebedeva@hse.ru
 Lara Lebedinski=lara.lebedinski@uclouvain.be
 Fuat LEBE=flebe@adiyaman.edu.tr
 Hervé LE BIHAN=herve.lebihan@banque-france.fr
 Michel Leblanc=mleblanc@michelleblanc.com
 Asli Leblebicioglu=asli.leblebicioglu@utdallas.edu
 Antoine Leblois=leblois@centre-cired.fr
 Patrick Leblond=pleblond@uottawa.ca
 Michel Le Breton=michel.lebreton@tse-fr.eu
 Victor LEBRETON=v.lebreton@quant-hedge.com
 Bernard Leca=bleca@iaelille.fr
 Jacques Le Cacheux=jacques.lecacheux@sciencespo.fr
 Remy Lecat=remy.lecat@banque-france.fr
 Patrizio Lecca=patrizio.lecca@strath.ac.uk
 Chau Hai Le=chaule@mdri.org.vn
 Valérie Lechene=v.lechene@ucl.ac.uk
 Sebastien Lechevalier=sebastien.lechevalier@ehess.fr
 Ewa Lechman=eda@zie.pg.gda.pl
 Franck LECOCQ=lecocq@centre-cired.fr
 Els Lecoutere=els.lecoutere@gmail.com
 Guilhem Lecouteux=guilhem.lecouteux@polytechnique.edu
 Wolfgang Lederer=wolfgang.lederer@i-med.ac.at
 Alan Ledesma.=alan.ledesma@bcrp.gob.pe
 Francisco Ledesma=fledesma@ull.es
 Patricia Ledesma=ledesmap@pcaobus.org
 Ivan Ledezma=ivan.ledezma@dauphine.fr
 Sylvain Leduc=sylvain.leduc@sf.frb.org
 Hannes Leeb=hannes.leeb@univie.ac.at
 Boon Liat Lee=bl.lee@qut.edu.au
 Byung-Joo Lee=blee@nd.edu
 Cassey Lee=casseylee@gmail.com
 Changmin Lee=changmin0415@gmail.com
 Chang-Yang Lee=drcylee@business.kaist.ac.kr
 Lee Chew Ging=lee.chew-ging@nottingham.edu.my
 Chia-Hao Lee=chlee@nutc.edu.tw
 Chien-Chiang Lee=cclee@cm.nsysu.edu.tw
 Lee Chin=leechin@putra.upm.edu.my
 Choonjoo Lee=bloom.rampike@gmail.com
 Chulhee Lee=chullee@snu.ac.kr
 Chul-In Lee=leeci@snu.ac.kr
 Chun-Chang Lee=lcc@npic.edu.tw
 ChunShen Lee=chunshen@mail.fcu.edu.tw
 Chuo-hsuan Lee=leeca@plattsburgh.edu
 Darin Lee=dlee@darinlee.net
 Donghoon Lee=donghoon.lee@ny.frb.org
 Dong Jin Lee=dong_jin.lee@uconn.edu
 Michael A. Leeds=mleeds@temple.edu
 Frank C. Lee=frank.lee@fin.gc.ca
 Frederic S. Lee=leefs@umkc.edu
 Gabriel S. Lee=gabriel.lee@wiwi.uni-regensburg.de
 Grace Hooi Yean Lee=grace.lee@monash.edu
 Gwanghoon Lee=econ22@paran.com
 Hahn Shik LEE=hahnlee@sogang.ac.kr
 Hei Wai Lee=heiwail@umd.umich.edu
 Hock-Ann Lee=hockannlee@yahoo.com
 Huey-Lin Lee=hlee@mail2.nccu.tw
 Jae Won Lee=jwlee@econ.rutgers.edu
 Jaewoo Lee=jlee3@imf.org
 Jeong-Dong Lee=leejd@snu.ac.kr
 Jeo S. Lee=j.lee@ibs.ac.im
 Jim Lee=jim.lee@tamucc.edu
 Jinkwon Lee=ljkjohn@hotmail.co.uk
 Jin Man Lee=jmlee@uic.edu
 Jong-Wha Lee=jongwha@korea.ac.kr
 Joonkoo Lee=joonklee@hanyang.ac.kr
 Joo-Suk Lee=leejoosuk@korea.ac.kr
 Joosung Lee=joosung@psu.edu
 Jungmin Lee=junglee@sogang.ac.kr
 Junhee Lee=lee1838@ynu.ac.kr
 Junsang Lee=junsanglee@skku.edu
 Junsoo Lee=jlee@cba.ua.edu
 Kang-Kook Lee=kangkooklee@gmail.com
 Keun Lee=klee1012@plaza.snu.ac.kr
 Keunjae Lee=kjlee@pnu.edu
 Kevin Lee=kevin.lee@nottingham.ac.uk
 Ki-Dong Lee=kdlee@kmu.ac.kr
 Kwan Ok Lee=rstleeko@nus.edu.sg
 Lena Lee=lenalee@nus.edu.sg
 Lung-Fei Lee=lee.1777@osu.edu
 Manjong Lee=manjong@korea.ac.kr
 Mark J. Lee=mlee@towson.edu
 Minsoo Lee=mlee@adb.org
 Nai Jia Lee=rstlnj@nus.edu.sg
 Eric Leeper=eleeper@indiana.edu
 Robin S. Lee=rslee@stern.nyu.edu
 Sanghoon Lee=sanghoonlee@hannam.ac.kr
 Sang-Hyop Lee=leesang@hawaii.edu
 Sang Jin Lee=legendar73@snu.ac.kr
 Sanglim Lee=sllee@keei.re.kr
 Seojeong Jay Lee=jay.lee@unsw.edu.au
 Shen-Ming Lee=smlee@fcu.edu.tw
 Shun-Fa Lee=alphalee@mail.tku.edu.tw
 Sokbae (Simon) Lee=sokbae@snu.ac.kr
 Peter T. Leeson=pleeson@gmu.edu
 Tae-Yeoun LEE=tlee@econ.ryukoku.ac.jp
 Laura Leete=leete@uoregon.edu
 Travis Lee=travis@enumerate.biz
 George van Leeuwen=glwn@cbs.nl
 Gareth David Leeves=gareth.leeves@monash.edu
 Wang-Sheng Lee=wang.lee@deakin.edu.au
 Woojin Lee=woojinlee@korea.ac.kr
 Yong Suk Lee=yong.s.lee@williams.edu
 Yong-Woo Lee=leastsquares@yu.ac.kr
 Yoon-Jin Lee=lee243@indiana.edu
 Yoonsoo Lee=ylee@sogang.ac.kr
 Young Hoon Lee=yhnlee@sogang.ac.kr
 Jérémie Lefebvre=j.lefebvre@ieseg.fr
 Marianne Lefebvre=marianne.lefebvre@ec.europa.eu
 Mathieu Lefebvre=mathieu.lefebvre@ulg.ac.be
 Pierre Lefebvre=lefebvre.pierre@uqam.ca
 Stephan Lefebvre=stephan.g.lefebvre@gmail.com
 Mélanie S.L. Lefèvre=melanie.lefevre@kuleuven.be
 Lars Lefgren=l-lefgren@byu.edu
 Julien Lefilleur=julien.lefilleur@gmail.com
 Guillermo Le Fort Varela=glefortv@leyf.cl
 Arnaud Lefranc=arnaud.lefranc@u-cergy.fr
 Philippe Le Fur=lefur@irdes.fr
 Julie Le Gallo=jlegallo@univ-fcomte.fr
 Véronique Le Gallo=veronique.le.gallo@umontreal.ca
 Gilles Le Garrec=gilles.legarrec@ofce.sciences-po.fr
 Bérangère Legendre=berangere.legendre@univ-savoie.fr
 Lawrence A. Leger=l.a.leger@lboro.ac.uk
 Pierre Thomas Leger=pierre-thomas.leger@hec.ca
 Maëlan Le Goff=maelan.legoff@cepii.fr
 Sophie Legras=sophie.legras@dijon.inra.fr
 Gabriella Legrenzi=g.d.legrenzi@keele.ac.uk
 Diègo Legros=diego.legros@u-bourgogne.fr
 monique Le Guen=leguen@univ-paris1.fr
 J. Sebastian Leguizamon=j.sebastian.leguizamon@vanderbilt.edu
 Alfred Lehar=alehar@ucalgary.ca
 Edwin Le Heron=e.le.heron@sciencespobordeaux.fr
 Nina Leheyda=leheyda@gmx.net
 Erik E. Lehmann=erik.lehmann@wiwi.uni-augsburg.de
 Etienne Lehmann=etienne.lehmann@ensae.fr
 Hartmut Lehmann=hartmut.lehmann@unibo.it
 Jee-Yeon K. Lehmann=jlehmann@uh.edu
 Michael Christian Lehmann=lehmann@pse.ens.fr
 Niklaus Lehmann=niklaus.lehmann@gmail.com
 Robert Lehmann=lehmann@ifo.de
 Sibylle H. Lehmann=lehmann.sibylle@gmail.com
 Andreas Lehnert=andreas.lehnert@gmail.com
 Ehud Lehrer=lehrer@post.tau.ac.il
 Evelyn L. Lehrer=elehrer@uic.edu
 Steven Lehrer=lehrers@queensu.ca
 Hung Viet Le=hung.leviet@sbv.gov.vn
 Andreas Leibbrandt=andreas.leibbrandt@monash.edu
 Murray Leibbrandt=murray.leibbrandt@uct.ac.za
 Fernando Leibovici=flei@yorku.ca
 Andrew Leicester=andrew.leicester@frontier-economics.com
 Stefan Markus Leiderer=stefan.leiderer@die-gdi.de
 Stephen Leider=leider@umich.edu
 Andrew Leigh=andrew_leigh@ksg02.harvard.edu
 Markus Leippold=markus.leippold@bf.uzh.ch
 David Leiser=dleiser@bgu.ac.il
 Stefan Leist=stefan.leist@seco.admin.ch
 João Leitão=jleitao@ubi.pt
 Fernanda Leite Lopez de Leon=f.de-leon@uea.ac.uk
 Kai Leitemo=kai.leitemo@bi.no
 Manuel Leite-Monteiro=mlm@ucp.pt
 Gabriel Leite Mota=galeitemota.ac@gmail.com
 Martin Leites=mleites@iecon.ccee.edu.uy
 Vasco Carvalho Leite, Sr.=vasco.leite@ccdr-n.pt
 Campbell Leith=campbell.leith@glasgow.ac.uk
 James Clark Leith=leith@uwo.ca
 Karl-Heinz Leitner=karl-heinz.leitner@ait.ac.at
 Fernando J. Leiva Bertran=fernando.leivabertran@asu.edu
 Danilo Leiva-Leon=leiv@bankofcanada.ca
 Krzysztof Leja=kleja@zie.pg.gda.pl
 Arjan Lejour=a.m.lejour@cpb.nl
 Anna Lejpras=anna.lejpras@businessschool-berlin-potsdam.de
 bongisa I. Lekezwa=bongisal@compcom.co.za
 Warn Nuarpear Lekfuangfu=nuarpear.lekfuangfu.09@ucl.ac.uk
 Jonathan W. Leland=jonathanleland@aol.com
 George N. Leledakis=gleledak@aueb.gr
 Hervé LELEU=h.leleu@ieseg.fr
 Iman van Lelyveld=i.p.p.van.lelyveld@dnb.nl
 Daniel Lema=dl@cema.edu.ar
 Daniel le Maire=daniel.le.maire@econ.ku.dk
 Rasmus Lema=lema@business.aau.dk
 Stéphane Lemarié=lemarie@grenoble.inra.fr
 Sylvaine Lemeilleur=sylvaine.lemeilleur@cirad.fr
 Clement Lemelin=lemelin.clement@uqam.ca
 Marc LE MENESTREL=marc.lemenestrel@upf.edu
 sebastien michel Lemeunier=slemeunier@gmail.com
 Thomas Lemieux=thomas.lemieux@ubc.ca
 Robert J. Lemke=lemke@lakeforest.edu
 Wolfgang Lemke=wolfgang.lemke@ecb.int
 Jan Lemmen=j.j.g.lemmen@tele2.nl
 Charmianne Lemmens=charmianne_lemmens@yahoo.com
 Francoise Lemoine=francoise.lemoine@cepii.fr
 Jean-François Lemoine=jflemoine30@hotmail.com
 Matthieu Lemoine=matthieu.lemoine@banque-france.fr
 Mauro Borges Lemos=mbl@cedeplar.ufmg.br
 Sara Lemos=sl129@leicester.ac.uk
 Chantal Le Mouël=chantal.lemouel@rennes.inra.fr
 Alain Lempereur=lempereur@brandeis.edu
 Natalia Lemus=natalialemus90@gmail.com
 Patrick Lenain=patrick.lenain@oecd.org
 Francis lendjoungou=len_fr@yahoo.com
 Jean-Sébastien Lenfant=jean-sebastien.lenfant@univ-lille1.fr
 Pascale Lengagne=lengagne@irdes.fr
 Aykut Lenger=aykut.lenger@ege.edu.tr
 Yvan Lengwiler=yvan.lengwiler@unibas.ch
 Joaquín Lennon Sabatini=juaco.lennon@gmail.com
 Terje Lensberg=terje.lensberg@nhh.no
 Robert Lensink=b.w.lensink@rug.nl
 Liam John Anthony Lenten=l.lenten@latrobe.edu.au
 Rasmus Lentz=rlentz@ssc.wisc.edu
 Michele Lenza=michele.lenza@ecb.europa.eu
 Carlos Lenz=carlos.lenz@snb.ch
 Camilla Lenzi=camilla.lenzi@polimi.it
 Maria Heloisa Lenz=helolenz@terra.com.br
 Hannes Leo=hannes@leoon.at
 Alessandro Ferdinando Leon=aleon@cleseconomia.com
 Marco Leonardi=marco.leonardi@unimi.it
 Jonathan S. Leonard=leonard@haas.berkeley.edu
 Kenneth Leonard=kleonard@arec.umd.edu
 Robert Leonard=leonard.robert@uqam.ca
 Tammy C. M. Leonard=leonard@utdallas.edu
 Thomas C. Leonard=tleonard@princeton.edu
 Carlos León=carlosleonr@hotmail.com
 Riccardo Leoncini=riccardo.leoncini@unibo.it
 John Jairo León Díaz=leon@econ.umd.edu
 Andrew J. Leone=a.leone@miami.edu
 Marinella Leone=maria.leone@unibocconi.it
 Gabriel Leon=gjl38@cam.ac.uk
 Gianmarco León=gianmarco.leon@upf.edu
 Roberto Leon-Gonzalez=rlg@grips.ac.jp
 Weishu Leong=weishuleong@gmail.com
 Leone Leonida=l.leonida@qmul.ac.uk
 Thomas Leoni=leoni@wifo.ac.at
 Janina León=jaleon@pucp.edu.pe
 Juan Leon Jara Almonte=jleon@grade.org.pe
 Jorge Leon=leonmj@bccr.fi.cr
 Miguel Leon-Ledesma=m.a.leon-ledesma@kent.ac.uk
 Sonia Mabel León=sleon@uade.edu.ar
 Samantha Leorato=samantha.leorato@uniroma2.it
 Teng Wah Leo=tleo@stfx.ca
 Nicolas Le Pape=nicolas.lepape@unicaen.fr
 Yannick LE PEN=yannick.le_pen@dauphine.fr
 Aurélia Lépine=aurelia.lepine@lshtm.ac.uk
 Samuli Mikael Leppälä=leppalasm@cardiff.ac.uk
 Matthieu Leprince=matthieu.leprince@univ-rennes1.fr
 Volodymyr Lepushynskyy=lepush@gmail.com
 Robert I. Lerman=rlerman@american.edu
 Anat Lerner=anat@cs.openu.ac.il
 Josh Lerner=jlerner@hbs.edu
 Davy Lerouge=d.lerouge@tilburguniversity.edu
 Anke D. Leroux=anke.leroux@monash.edu
 Marie-Louise Leroux=leroux.marie-louise@uqam.ca
 Stephanus le Roux=stephen.leroux@wrap.org.uk
 Laëtitia Leroy de Morel=laetleroy64@gmail.com
 James P. LeSage=jlesage@spatial-econometrics.com
 François Lescaroux=francois.lescaroux@gmail.com
 Tine Hjernø Lesner=ti@sam.sdu.dk
 Caroline Lesser=caroline.lesser@oecd.org
 Lestano=lestano@atmajaya.ac.id
 Ashley Lester=azwlester@gmail.com
 Benjamin R. Lester=benjamin.lester@phil.frb.org
 Ron J. Lesthaeghe=rlesthaeghe@yahoo.com
 Marc-Andre Letendre=letendre@mcmaster.ca
 LE Thai-Ha=thai1@e.ntu.edu.sg
 Elodie Letort=ledreau.letort@gmail.com
 Trinh Van Thi Le=trinh.le@motu.org.nz
 Martin Lettau=lettau@haas.berkeley.edu
 Wilko A. Letterie=w.letterie@maastrichtuniversity.nl
 Marion Leturcq=marion.leturcq@ined.fr
 Kasper Leufkens=kasperleufkens@hotmail.com
 Ambrose Leung=aleung@ubishops.ca
 Charles Ka Yui Leung=kycleung@cityu.edu.hk
 Danny Leung=danny.leung@statcan.gc.ca
 Frank LEUNG=fwyleung@hkma.gov.hk
 Guy C.K. Leung=guyleung@gmail.com
 Siu Fai Leung=sfleung@ust.hk
 Tim S.T. Leung=leung@ieor.columbia.edu
 Tin Cheuk Leung=tleung@cuhk.edu.hk
 Tim Leunig=t.leunig@lse.ac.uk
 Shawn Chen-Yu Leu=c.leu@latrobe.edu.au
 Florian Leuthold=florianleuthold@gmail.com
 Edwin Leuven=edwin.leuven@econ.uio.no
 Clement Levallois=clevallois@rsm.nl
 Cuong Le van=levan@univ-paris1.fr
 Van Ha Le=h.v.le@rug.nl
 Maria Vittoria Levati=levati@econ.mpg.de
 Ben Lev=blev@umich.edu
 Haluk Levent=levhaluk@gmail.com
 Gregory LEVIEUGE=gregory.levieuge@univ-orleans.fr
 Irina Levina=ilevina@hse.ru
 Andrew Theo Levin=alevin@imf.org
 David Levine=levine@haas.berkeley.edu
 David Levine=david@dklevine.com
 Michael E. Levine=melevine@nyu.edu
 Paul Levine=p.levine@surrey.ac.uk
 Ross Levine=ross_levine@haas.berkeley.edu
 Hagay Levin=hagayl@mscc.huji.ac.il
 Henry M. Levin=hl361@columbia.edu
 René Levínský=levinsky@econ.mpg.de
 Arik Levinson=aml6@georgetown.edu
 David Matthew Levinson=dlevinson@umn.edu
 Vladimir Lvovich Levin=vl_levin@cemi.mail.ru
 Steven Levitt=slevitt@midway.uchicago.edu
 Inna Levkovych=levkovych@iamo.de
 Nadine Levratto=nadine.levratto@u-paris10.fr
 Enrico Sergio Levrero=levrero@uniroma3.it
 Amnon Levy=amnon_levy@uow.edu.au
 Daniel Levy=daniel.levy@biu.ac.il
 Dominique Lévy=dominique.levy@ens.fr
 Louis Lévy-Garboua=louis.levy-garboua@univ-paris1.fr
 Horacio Levy=horacio.levy@oecd.org
 Marc Levy=marc.levy@ulb.ac.be
 Philip I. Levy=levy.philip@gmail.com
 Rachel Levy=rachel.levy@univ-tlse1.fr
 Dr Stephanie Levy=s.levy@lse.ac.uk
 Stephan Levy=stephan.levy@naviganteconomics.com
 Yehuda John Levy=john.calculus@gmail.com
 Eduardo Levy Yeyati=ely@utdt.edu
 Michal Lewandowski=michal.lewandowski@sgh.waw.pl
 Piotr Lewandowski=piotr.lewandowski@ibs.org.pl
 Arthur Lewbel=lewbel@bc.edu
 Joshua J. Lewer=jlewer@bradley.edu
 Alan Lewis=alanlewis@adelphia.net
 Ethan G. Lewis=ethan.g.lewis@dartmouth.edu
 Frank D. Lewis=lewisf@econ.queensu.ca
 Justin S. Lewis=lewisj2@unlv.nevada.edu
 Kurt F. Lewis=kurt.f.lewis@frb.gov
 Logan T. Lewis=logantlewis@ltlewis.net
 Maureen A. Lewis=maureenlewis2@gmail.com
 Vivien Lewis=vivien.lewis@kuleuven.be
 Stephen Leybourne=steve.leybourne@nottingham.ac.uk
 Dennis Patrick Leyden=dpleyden@uncg.edu
 Loet Leydesdorff=loet@leydesdorff.net
 Marius Christian Ley=marius.ley@kof.ethz.ch
 Andrew Leyshon=andrew.leyshon@nottingham.ac.uk
 Gustavo Leyva=leyva004@umn.edu
 Olivier l'Haridon=lharidon@greg-hec.com
 Muriel Lhéritier=mslheritier@hotmail.com
 Yannick L'Horty=yannick.lhorty@univ-paris-est.fr
 Stephane Lhuillery=stephane.lhuillery@icn-groupe.fr
 Chang Lian=clian@wisc.edu
 Che-Yuan Liang=che-yuan.liang@nek.uu.se
 Gechun Liang=gechun.liang@kcl.ac.uk
 Pinghan Liang=liangph@swufe.edu.cn
 Anpeng Li=anpenglee@gmail.com
 Yu-Jun Lian=arlionn@163.com
 Chi-Hung "Charles" Liao=ecoliao@ucdavis.edu
 Guanmin Liao=liaoguanmin@gmail.com
 Hailin Liao=h.liao@lboro.ac.uk
 Hua Liao=hliao@bit.edu.cn
 Wei Liao=cwliao@hkma.gov.hk
 Yin Liao=yin.liao@qut.edu.au
 Yuan Liao=yuanliao2008@u.northwestern.edu
 Konstantinos John Liapis=liapco@otenet.gr
 Panagiotis G Liargovas=liargova@uop.gr
 Alvin Liaw=alvin.t.liaw@gmail.com
 Dirk Libaers=libaersd@umkc.edu
 Gary D. Libecap=glibecap@bren.ucsb.edu
 Ben Li=benli36@gmail.com
 Paolo Liberati=paolo.liberati@uniroma3.it
 Barbara Liberda=barbara.liberda@uw.edu.pl
 Jose Maria Liberti=jliberti@depaul.edu
 Massimo Libertucci=massimo.libertucci@bancaditalia.it
 Jan Libich=j.libich@latrobe.edu.au
 Bin Li=bli2@imf.org
 Bo Li=libo@sem.tsinghua.edu.cn
 François Libois=francois.libois@unamur.be
 Marco Li Calzi=licalzi@unive.it
 Omar Licandro=omar.licandro@iae.csic.es
 Changying Li=changyingli@sdu.edu.cn
 Cheng Li=licheng@cass.org.cn
 Julien Licheron=julien.licheron@yahoo.fr
 Erik Lichtenberg=elichtenberg@arec.umd.edu
 Frank Lichtenberg=frank.lichtenberg@columbia.edu
 Chuan-Zhong Li=chuanzhong.li@nek.uu.se
 Chuntao Li=chtl@znufe.edu.cn
 Dan Li=danli1981@fudan.edu.cn
 Daniel Zhiyun LI=daniel.li@durham.ac.uk
 Brantley Liddle=btliddle@alum.mit.edu
 Defu Li=tjldf@tongji.edu.cn
 Dong Li=wuhandong@gmail.com
 Dongmei Li=dongmei@ucsd.edu
 Paolo Li Donni=paolo.lidonni@unipa.it
 Joëlle Liebermann=jlieberm@ulb.ac.be
 Stefan Liebig=stefan.liebig@uni-bielefeld.de
 Thilo Liebig=thilo.liebig@bundesbank.de
 Thomas Liebig=thomas.liebig@oecd.org
 Dominik Liebl=dliebl@uni-bonn.de
 Lenard Lieb=l.lieb@maastrichtuniversity.nl
 Jeffrey B. Liebman=jeffrey_liebman@harvard.edu
 Stan J Liebowitz=liebowit@utdallas.edu
 Denny Lie=denny.lie@sydney.edu.au
 carl e. Liedholm=liedhol1@msu.edu
 William M. Liefert=wliefert@ers.usda.gov
 Hsienming Lien=hmlien@nccu.edu.tw
 Freddy Liew=freddy.liew.2010@me.smu.edu.sg
 Venus Khim-Sen Liew=venusliew@yahoo.com
 Fei Li=lifei@email.unc.edu
 Feng Li=feng.li@cufe.edu.cn
 Marina Lifshits=lifmarina@yandex.ru
 Carel Ligeon=cligeon@aum.edu
 Audrey Light=light.20@osu.edu
 Thomas Light=tlight@rand.org
 Ethan Ligon=ligon@are.berkeley.edu
 Guoping Li=gpli100@yahoo.com
 Han Li=hli@swufe.edu.cn
 Hao Li=hao.li@ubc.ca
 Hongbin Li=lihongbin@sem.tsinghua.edu.cn
 Hongyi Li=hongyi@baf.msmail.cuhk.edu.hk
 Li Huanan=huanan3721@163.com
 Hui Li=m.li@latrobe.edu.au
 Ian W. Li=ian.li@uwa.edu.au
 Mark Lijesen=mlijesen@feweb.vu.nl
 李杰 (JIE LI)=jieli.cn@gmail.com
 Jing Li=lij14@miamioh.edu
 Jingyuan Li=jingyuanli@ln.edu.hk
 Jinjing Li=jinjing.li@natsem.canberra.edu.au
 Jinlu Li=jli@shawnee.edu
 Kai Li=kai.li@sauder.ubc.ca
 Ke Li=li.ke@nihon-u.ac.jp
 kunpeng Li=likp.07@gmail.com
 Florin Paul Costel Lilea=florin.lilea@yahoo.fr
 Alla Lileeva=lileeva@dept.econ.yorku.ca
 Lingfang (Ivy) Li=lingfangivy.li@gmail.com
 Liuling Li=liuling.li@gmail.com
 Lixing Li=lilixing@ccer.pku.edu.cn
 Eva Liljeblom=eva.liljeblom@hanken.fi
 Marco Lilla=m.lilla@univpm.it
 Helene Bie Lilleør=hbl@rff.dk
 Nicolas Lillo=n.a.lillo-bustos@warwick.ac.uk
 Gregory Lilly=lillyg@elon.edu
 Jean-Jacques LILTI=jean-jacques.lilti@univ-rennes1.fr
 Eduardo José Araújo Lima=eduardo.lima@bcb.gov.br
 Francisco Lima=francisco.lima@ist.utl.pt
 Francisco Soares de Lima=fsoaresdelima@yahoo.com
 Gilberto Tadeu Lima=giltadeu@usp.br
 Jose Luis Lima=jlima@cne.cl
 Luiz Renato Regis de Oliveira Lima=llima@utk.edu
 Maria Lima=elviral@eeg.uminho.pt
 Nuno M. Limão=limao@econ.umd.edu
 Tony Lima=tony.lima@csueastbay.edu
 Boon Tiong Lim=ecslimbt@nus.edu.sg
 Frank F. Limehouse=flimehouse@gmail.com
 Guay C. Lim=g.lim@unimelb.edu.au
 Ming-Yuan Leon Li=lmyleon@mail.ncku.edu.tw
 Minqiang Li=mli159@bloomberg.net
 Jasper Lim=jasper@merlien.org
 Kai Jie Shawn Lim=limkaijieshawn@gmail.com
 Kar Ho Lim=khlim2@gmail.com
 Katherine Lim=katielim@umich.edu
 Kian-Ping Lim=kianpinglim@yahoo.com
 Mah Hui Lim=limmahhui@gmail.com
 Leonid Limonov=limonov@hse.ru
 Shiok Ye Lim=sy_lim84@hotmail.com
 Sokchea Lim=slim@jcu.edu
 Song-Soo Lim=songsoo@korea.ac.kr
 Sonya Seongyeon Lim=slim1@depaul.edu
 Steven Lim=slim@waikato.ac.nz
 Muqun Li=muqunli@hotmail.com
 Wooyoung Lim=wooyoung78.lim@gmail.com
 Nan Li=sosclinan@gmail.com
 Nan Li=nanli1@gmail.com
 Francisco Liñán Alcalde=flinan@us.es
 Sera Linardi=linardi@pitt.edu
 Pedro Linares=pedro.linares@upcomillas.es
 Biing-Hwan Lin=blin@ers.usda.gov
 Carl Lin=csmlin@bnu.edu.cn
 Cristina LINCARU=cristina.lincaru@yahoo.de
 Chen Lin=chenlin1@hku.hk
 William Lincoln=wlincoln@jhu.edu
 C.-Y. Cynthia Lin=cclin@primal.ucdavis.edu
 Lena Lindahl=lena.lindahl@sofi.su.se
 Mikael Lindahl=mikael.lindahl@nek.uu.se
 Henrik Lindberg=henrik.lindberg@ratio.se
 Nannette Lindenberg=nannette.lindenberg@die-gdi.de
 Leigh L. Linden=leigh.linden@austin.utexas.edu
 Vincent Linderhof=vincent.linderhof@wur.nl
 Daniël Linders=daniel.linders@kuleuven.be
 Stefan Linder=slinder@whu.edu
 Henrik Lindhjem=henrik.lindhjem@nina.no
 Åsa Lindholm Dahlstrand=asa.lindholm_dahlstrand@circle.lu.se
 Jo Thori Lind=j.t.lind@econ.uio.no
 Joanne Kathryn Lindley=joanne.lindley@kcl.ac.uk
 Florian Lindner=florian.lindner@econ.lmu.de
 Ines Lindner=i.d.lindner@vu.nl
 Jason M. Lindo=lindojasonm@gmail.com
 Matthew J. Lindquist=matthew.lindquist@sofi.su.se
 Erik Lindqvist=erik.lindqvist@hhs.se
 Tobias Lindqvist=toblindqvist@hotmail.com
 Richard C. Lindrooth=richard.lindrooth@ucdenver.edu
 Charles Robin Lindsey=robin.lindsey@sauder.ubc.ca
 Annika Lindskog=annika.lindskog@economics.gu.se
 Lars A. Lindvall=lars.lindvall@gmail.com
 Edward Meng Hua Lin=mhlin@stat.sinica.edu.tw
 Eric S. Lin=slin@mx.nthu.edu.tw
 Thomas Lines=mail@tomlines.org.uk
 Fengfeng Lin=ff.p.lin@gmail.com
 David C. Ling=ling@ufl.edu
 Christopher Lingle=clingle@ufm.edu
 Shiqing Ling=maling@ust.hk
 Tai-Hu Ling=lingtaihu@gmail.com
 Haizhen Lin=hzlin@indiana.edu
 Nicholas Li=nick.li@utoronto.ca
 Jorge Li Ning Chaman=jlining@ositran.gob.pe
 Jin-Lung (henry) Lin=jlin@mail.ndhu.edu.tw
 Justin Yifu Lin=justinlin@ccer.pku.edu.cn
 Benjamin Linkow=benlinks@yahoo.com
 Peter Michael Link=michael.link@zmaw.de
 Mi Lin=mlin@lincoln.ac.uk
 林明仁(Ming-Jen Lin) (Ming-Jen Lin)=mjlin@ntu.edu.tw
 Sebastian Linnemayr=slinnema@rand.org
 Laurent Linnemer=laurent.linnemer@ensae.fr
 Joshua Linn=linn@rff.org
 Scott C. Linn=slinn@ou.edu
 Panlang Lin=panlang.lin@gmail.com
 qin liang lin, Sr.=linqinliang2004@163.com
 Shu Lin=shulin75@gmail.com
 Philip Mark Linsley=pl521@york.ac.uk
 Stephen Andrew Linstead=sl519@york.ac.uk
 Bruce Linster=bruce.linster@usafa.edu
 Oliver Bruce Linton=obl20@cam.ac.uk
 Tyrone T. Lin=tjlin@mail.ndhu.edu.tw
 Tzu-Chin Lin=tclin@nccu.edu.tw
 Wanchuan Lin=wanchuan@gmail.com
 Xiaoji Lin=lin_1376@fisher.osu.edu
 Yi-Chen Lin=ylin@mail.tku.edu.tw
 Yi-Hsing Lin=yhlin1949@nqu.edu.tw
 Stefania Lionetti=stefania.lionetti@cnh.com
 Abraham Lioui=abraham.lioui@edhec.edu
 Christos Liouris=chr_liouris@yahoo.com
 Phillip Li=phillip.li@occ.treas.gov
 Anna Lipinska=anna.lipinska@frb.gov
 Barton Lipman=blipman@bu.edu
 Jana Lippelt=lippelt@ifo.de
 Steffen Lippert=steffen.lippert@gmail.com
 Matteo Lippi Bruni=matteo.lippibruni2@unibo.it
 Marco Lippi=ml@lippi.ws
 Douglas C. Lippoldt=douglas.lippoldt@oecd.org
 Alexander Lipponer=alexander.lipponer@bundesbank.de
 Oliver Lipps=oliver.lipps@fors.unil.ch
 Molly Lipscomb=molly.lipscomb@virginia.edu
 Richard George Lipsey=rlipsey@sfu.ca
 Douglas Lipton=dlipton@umd.edu
 Qian Cher Li=cher.li@nottingham.ac.uk
 Qiang Li=qiangliriem@gmail.com
 Cristina Lira=clira@cba.ua.edu
 Rita Yi Man Li=ritarec@hotmail.com
 T.C. Lirn=tedlirn@ccms.nkfust.edu.tw
 Maurizio Lisciandra=mlisciandra@unime.it
 Jeremy Lise=j.lise@ucl.ac.uk
 Katerina Lisenkova=k.lisenkova@niesr.ac.uk
 Shanjun Li=sl2448@cornell.edu
 Shi Li=lishi@bnu.edu.cn
 Domenico Lisi=domenico.lisi@unict.it
 Francesco Lisi=lisif@stat.unipd.it
 Gaetano Lisi=gaetano.lisi@unicas.it
 Evgeny Lisin=lisinym@gmail.com
 Roman Liska=roman.liska@jrc.ec.europa.eu
 Matti Liski=matti.liski@aalto.fi
 Francesco Lissoni=francesco.lissoni@u-bordeaux4.fr
 John List=jlist@uchicago.edu
 Tao Li=taoli96@gmail.com
 Anastasia Litina=anastasia.litina@uni.lu
 Tong Li=cli@milkeninstitute.org
 Dorian Aymara Litvine=dorian.litvine@gmail.com
 Albert Yung-Hsu Liu=ayl23@cornell.edu
 Amy Y.C. Liu=yukchu.liu@anu.edu.au
 Benjamin Liu=b.liu@griffith.edu.au
 Chin Te Liu=ctliu@umich.edu
 Chu-An Liu=ecslca@nus.edu.sg
 Chun Liu=liuch@sem.tsinghua.edu.cn
 Chun-Chu Liu=lcc@mail.cjcu.edu.tw
 Chunping Liu=chunping.liu@ntu.ac.uk
 Edith X. Liu=edith.liu@cornell.edu
 Gareth David Liu-Evans=gareth.liu.evans@gmail.com
 Fei Liu=lf8597@126.com
 Guangling Liu=gliu@sun.ac.za
 Guoxin Liu=liugxhk@yahoo.com.hk
 Haiyong Liu=liuh@ecu.edu
 Haoming Liu=ecsliuhm@nus.edu.sg
 Jing Liu=jliu.blueta@gmail.com
 Ju Liu=ju.liu@circle.lu.se
 Li Liu=li.liu@sbs.ox.ac.uk
 Lihu Liu=llh_xmu@126.com
 Lin Liu=liulin.apple@gmail.com
 Lucy Qian Liu=qliu3@imf.org
 Ming Liu=liuming@nankai.edu.cn
 Pengfei Liu=pengfei.liu@uconn.edu
 Philip Liu=pliu@cppib.ca
 Qiao Liu=qiao_liu@gsm.pku.edu.cn
 Qihong Liu=qliu@ou.edu
 Runjuan Liu=runjuan.liu@ualberta.ca
 Teng Dong Liu=tl342@drexel.edu
 Ting Liu=ting.liu@stonybrook.edu
 Tung Liu=tliu@bsu.edu
 Wan-Hsin Liu=wan-hsin.liu@ifw-kiel.de
 Liu Wei=liuv@ruc.edu.cn
 Wei-han Liu=weihanliu2002@yahoo.com
 Wen-Fang Liu=liuwf2k@yahoo.com
 Liu, Xiangbo=xiangbo.liu@ruc.edu.cn
 Xiangping Liu=xiangping.liu@economics.gu.se
 Xiaochun Liu=xiaochun.liu@emory.edu
 Xiaodong Liu=xiaodong.liu@colorado.edu
 Xiaoyun Liu=liuxy@cau.edu.cn
 Xuepeng Liu=xliu6@kennesaw.edu
 Yajie Liu=yajie.liu@sintef.no
 Yang LIU=liu-yang@rieti.go.jp
 Yanyan Liu=y.liu@cgiar.org
 Yizao Liu=yizao.liu@uconn.edu
 Yong Liu=liu.yong@whu.edu.cn
 Yongzheng Liu=yongzheng.liu@ruc.edu.cn
 Yu-Jane Liu=yjliu@gsm.pku.edu.cn
 Yunhua Liu=ayuliu@ntu.edu.sg
 Zhen Liu=zl24@buffalo.edu
 Zheng Liu=zliu001@gmail.com
 Giacomo Livan=glivan@ictp.it
 Ilias Livanos=i.livanos@warwick.ac.uk
 Christian Livi=christian.livi@unine.ch
 Brendan Livingston=livingstonb@rowan.edu
 Jeffrey A. Livingston=jlivingston@bentley.edu
 Michael Livingston=mlivingston@ers.usda.gov
 Luca Livio=luca.livio85@gmail.com
 Gilad Livne=g.livne@city.ac.uk
 Igor Livshits=livshits@uwo.ca
 Wei Li=wei@aspenimpact.com
 Jacek Liwinski=jacek.liwinski@wp.pl
 Wu LI=liwu@staff.shu.edu.cn
 Xiaogu Li=xli41@utk.edu
 Xiaoming Li=xiaoming.l.li@gmail.com
 Xiao-Ming Li=x.n.li@massey.ac.nz
 Xi Hao Li=xihao.li@gmail.com
 Yan Li=liyan@uwec.edu
 Yanfei Li=yanfei.li@outlook.com
 Yao Li=liyao@uestc.edu.cn
 Li, Yao Amber=yaoli@ust.hk
 Yiting Li=yitingli@ntu.edu.tw
 Yong Li=s04085590@ruc.edu.cn
 Yongjun Li, Sr.=lionli@ustc.edu
 Youping Li=liyouping@ecust.edu.cn
 Yuan Li=yuan.li@hhs.se
 Yuefen Li=yuefen.li@unctad.org
 Sandra Valentina Lizarazo=slizaraz@eco.uc3m.es
 Carmen Lizarraga=clizarra@ugr.es
 Zhe Li=lizhezhe@hotmail.com
 Zhigang Li=zli.economics@gmail.com
 Zhisheng Li=zhishengli@gmail.com
 Zhiyong Li=zizhizy@gmail.com
 Zhiyuan Li=zhyli97@gmail.com
 Colin Martyn Lizieri=cml49@cam.ac.uk
 Martin Ljunge=martin.ljunge@ifn.se
 Alexander Ljungqvist=al75@nyu.edu
 Ariunaa Lkhagvadorj=ariun2010@googlemail.com
 Irving Llamosas-Rosas=llamosas@email.arizona.edu
 Gastón Llanes=gaston@llanes.com.ar
 Jose Ramon Llanes=jrllanes@auburn.edu
 Humberto Llavador=humberto.llavador@upf.edu
 Freddy Paul Llerena Pinto=fllerena@economica.com.ec
 Richard Von Llewelyn=rvl@ksu.edu
 Maria Llop=maria.llop@urv.cat
 Manuel Llorca-Jaña=manuel_llorca@hotmail.com
 Raquel Llorente-Heras=raquel.llorente@uam.es
 Aniol Llorente-Saguer=aniol.llorente.saguer@gmail.com
 Luis-Gonzalo Llosa=luisllosa@ucla.edu
 Teresa Lloyd-Braga=tlb@clsbe.lisboa.ucp.pt
 Peter Lloyd-Davies=peterrld@monkeynutproductions.com
 Huw Lloyd-Ellis=lloydell@qed.econ.queensu.ca
 Stéphanie Lluis=slluis@uwaterloo.ca
 Joan Llull=joan.llull@movebarcelona.eu
 Fernanda Llussá=fajl@fct.unl.pt
 Osmar Leandro Loaiza Quintero=olloaizaq@unal.edu.co
 Rubén Albeiro Loaiza=rloaizma@gmail.com
 Andrew W. Lo=alo@mit.edu
 Norman V. Loayza=nloayza@worldbank.org
 Felix Lobo=flobo@eco.uc3m.es
 Maria Carmela Lo Bue=mlobue@uni-goettingen.de
 Alberto Locarno=alberto.locarno@bancaditalia.it
 Andrea Locatelli=loc.andrea@gmail.com
 Marilena Locatelli=marilena.locatelli@unito.it
 Adam James Loch=adam.loch@unisa.edu.au
 Christoph Loch=c.loch@jbs.cam.ac.uk
 Lance Lochner=llochner@uwo.ca
 Håkan Locking=hakan.locking@lnu.se
 Daniel Lockton=dan@danlockton.co.uk
 Ben Lockwood=b.lockwood@warwick.ac.uk
 Lee M. Lockwood=lee.lockwood@northwestern.edu
 Sergio Lodde=lodde@unica.it
 Silvia Loddo=silvia.loddo@gmail.com
 Elisabetta Lodigiani=elisabetta.lodigiani@unive.it
 Martin Philip Loeb=mloeb@rhsmith.umd.edu
 Simon Loertscher=simonl@unimelb.edu.au
 George Loewenstein=gl20@andrew.cmu.edu
 Michael Loewy=mloewy@usf.edu
 Matthijs Lof=matthijs.lof@aalto.fi
 Magnus Lofstrom=lofstrom@ppic.org
 Nanthakumar Loganathan=kumar@umt.edu.my
 Oksana Loginova=loginovao@missouri.edu
 Youenn Loheac=youenn.loheac@france-bs.com
 Olivier Pierre Lohest=olivier.lohest@nbb.be
 Marie-Sophie Löhlein=loehlein@sigmund-freud-institut.de
 Steffen Lohmann=steffen.lohmann@wiwi.uni-goettingen.de
 Luanne Lohr=luanne.lohr@ams.usda.gov
 Sanguck Loh=suloh@ajou.ac.kr
 Tim Lohse=tim.lohse@hwr-berlin.de
 Heikki A. Loikkanen=heikki.loikkanen@helsinki.fi
 Massimo Loi=massimo.loi@iktsenteret.no
 Patrice Loisel=loiselp@supagro.inra.fr
 Stéphane Loisel=stephane.loisel@univ-lyon1.fr
 Katrine Vellesen Løken=katrine.loken@econ.uib.no
 Yiing Jia Loke=yjloke@usm.my
 Kin Chung Lo=kclo@yorku.ca
 Michael Lokshin=mlokshin@worldbank.org
 Ulrich Lölke=u.loelke@hamburg.de
 Alessia Lombardi=alessialom@gmail.com
 Marco Jacopo Lombardi=marco.lombardi@bis.org
 Giovanni Lombardo=giannilmbd@gmail.com
 Vincenzo Lombardo=vincenzo.lombardo@uniparthenope.it
 Ming Chien Lo=mclo@stcloudstate.edu
 Kirsten Lommatzsch=kirsten.lommatzsch@bundesbank.de
 Kjell Erik Lommerud=kjell.lommerud@econ.uib.no
 Elio Londero=eliolondero@hotmail.com
 Andres Felipe Londoño=alondo34@eafit.edu.co
 David Andres Londono Bedoya=davidlondono@javeriana.edu.co
 Jaime Londoño=jaime.a.londono@gmail.com
 Silvia London=slondon@uns.edu.ar
 Dara LONG=longdara@gmail.com
 Simonetta Longhi=slonghi@essex.ac.uk
 Ernesto Longobardi=ernesto.longobardi@uniba.it
 Wenjin Long=longwenjin@gmail.com
 David Longworth=david_longworth@carleton.ca
 Constant Lonkeng Ngouana=clonkeng@imf.org
 Lars Lønstrup=loe@sam.sdu.dk
 Thomas S. Lontzek=thomas.lontzek@business.uzh.ch
 Hans Lööf=hans.loof@indek.kth.se
 Jasper Bastiaan van Loo=jasper.van-loo@cedefop.europa.eu
 Brigitte Loose=brigitte.loose@iwh-halle.de
 Elsabe Loots=elsabe.loots@up.ac.za
 Carolina Lopera Oquendo=carolina.lopera@urosario.edu.co
 Nicola Maria Rinaldo Loperfido=nicola.loperfido@uniurb.it
 Alexandra Ferreira Lopes=alexandra.ferreira.lopes@iscte.pt
 Ana Sofia Lopes=analopes@estg.ipleiria.pt
 Fernando Rodrigues Lopes=flopes@uac.pt
 João Carlos Lopes=jcflopes@iseg.utl.pt
 Luís Lopes=perlopes@fe.uc.pt
 Luís Miguel Lopes=llopes@iscac.pt
 Marcos Felipe Mendes Lopes=marcoslopes@gvmail.br
 Margarida Chagas Lopes=mchagaslopes@gmail.com
 Patricia Teixeira Lopes=patricia@fep.up.pt
 Alberto López Sebastián=alberto.lopez@ccee.ucm.es
 Carmen Lopez-Andion=carmen.lopez.andion@usc.es
 Andrés López=anlopez@fund-cenit.org.ar
 Diana Lopez-Avila=diana.lopez.avila@ens.fr
 Enrique Lopez-Bazo=elopez@ub.edu
 Florencia Lopez Boo=florencial@iadb.org
 Luis Felipe Lopez-Calva=lflopezcalva@worldbank.org
 Liliana Lopez Chamorro=llopezch@gmail.com
 Francisco Javier López Chanez=francisco.lopez@itcelaya.edu.mx
 Claude Lopez=claude.lopez@banque-france.fr
 José Ernesto López-Córdova=jelopezcordova@gmail.com
 Javier Mateo López-Cuñat=cunyat@ua.es
 David Camilo López=dlopezva@banrep.gov.co
 Javier López-de-Lacalle=javlacalle@yahoo.es
 Marcos Mailoc López de Prado=lopezdeprado@gmail.com
 Florencio Lopez-de-Silanes=florencio.lopezdesilanes@edhec.edu
 Enrique López=elopezen@banrep.gov.co
 Germán López-Espinosa=glespinosa@unav.es
 Esteban Lopez=lopezoch@illinois.edu
 Federico Lopez Fagundez=flf@cema.edu.ar
 Alejandro Lopez-Feldman=lopezfeldman@gmail.com
 Ana Mª López García (Ana Maria Lopez Garcia)=ana.lopez@uam.es
 Miguel-Angel Lopez-Garcia=miguelangel.lopez@uab.es
 Paloma Lopez-Garcia=paloma.lopez-garcia@ecb.europa.eu
 Javier Lopez Gonzalez=j.lopez-gonzalez@sussex.ac.uk
 Fernando Lopez Gutierrez=lopezf@wustl.edu
 Humberto Lopez=hlopez@worldbank.org
 Félix López-Iturriaga=flopez@eco.uva.es
 Jimmy Lopez=jimmy.lopez@u-bourgogne.fr
 Jordi López=jordi.lopez@uab.es
 Jose A. Lopez=jose.a.lopez@sf.frb.org
 Jose Joaquin Lopez=joaquinlopez@uchicago.edu
 Luis Antonio López=luis.lsantiago@uclm.es
 Maria Claudia Lopez=mclopezperez@gmail.com
 Arnoldo López Marmolejo=arnoldo.lopez@bbva.com
 Martha López=mlopezpi@banrep.gov.co
 Cristina Lopez-Mayan=cristina.lopez.mayan@uab.es
 Ana Jesús López Menéndez=anaj@uniovi.es
 Miguel A. LOPEZ-MORELL=mlmorell@um.es
 Rodrigo Lopez-Pablos=rodrigo.lopezpablos@educ.ar
 Erika Lopez Ponton=erikalopezponton@gmail.com
 Ramon Lopez=rlopez@arec.umd.edu
 David Lopez-Rodriguez=davidlopezrodriguezphd@gmail.com
 Jesus Lopez-Rodriguez=jelopez@udc.es
 J. David Lopez-Salido=david.j.lopez-salido@frb.gov
 María del Pilar López Uribe=m.d.lopez-uribe@lse.ac.uk
 Kristian Lopez Vargas=lopez-vargas@econ.umd.edu
 Fernando Salvador López Vicente=fernando.lopez@bde.es
 Antonia López Villavicencio=lopezvillavicencio@univ-paris13.fr
 Pablo Lopez Zadicoff=pdl02@cema.edu.ar
 Danilo Lopomo Beteto=d.beteto@uq.edu.au
 Giuseppe (Pino) Lopomo=glopomo@duke.edu
 Anna Lo Prete=anna.loprete@unito.it
 Lynn M. LoPucki=lopucki@law.ucla.edu
 Eduardo Lora=eduardo.a.lora@gmail.com
 Maria Lorca-Susino=marialorca@yahoo.com
 Grace Lordan=g.lordan@lse.ac.uk
 Montague J. Lord=mlord@montaguelord.com
 Duduiala Popescu Lorena=lorena_ucb@yahoo.com
 Adrien Lorenceau=lorenceau@pse.ens.fr
 Benjamin Lorent=blorent@ulb.ac.be
 Christian Lorenz=christian.lorenz@gmx.ch
 Edoardo Lorenzetti=e.lorenzetti@ceris.cnr.it
 Eleonora Lorenzini=eleonora.lorenzini@unipv.it
 Jan Lorenz=post@janlo.de
 Francisco Xavier Lores=franciscoxavier.lores@usc.es
 Mico Loretan=mico.loretan@mac.com
 Simon Loretz=simon.loretz@uni-bayreuth.de
 Oliver Lorz=lorz@rwth-aachen.de
 Anthony Lo Sasso=losasso@uic.edu
 Bart Los=b.los@rug.nl
 Cornelis A. Los=clos@alliant.edu
 Simon M. S. Lo=losimonms@yahoo.com.hk
 Frédéric M. Loss=frederic.loss@dauphine.fr
 Vahid Lotfi=vlotfi@live.com
 Emanuela Lotti=e.lotti@soton.ac.uk
 Carlo Lottieri=lottieri@tiscali.it
 Francesca Lotti=francesca.lotti@bancaditalia.it
 Alessia Lo Turco=a.loturco@univpm.it
 Aïleen Lotz=a.lotz@erc-cercatrova.eu
 Sébastien Lotz=lotz@u-paris2.fr
 Henri Loubergé=henri.louberge@unige.ch
 Francisco Louçã=flouc@iseg.utl.pt
 Fernando Louge=fmlouge@gmail.com
 Jason Loughrey=jason.loughrey@teagasc.ie
 Philippe Louis=philippe.louis@umons.ac.be
 Elena Loukoianova=eloukoianova@imf.org
 Ahmed Loulit=hloulit@ulb.ac.be
 Prakash Loungani=ploungani@imf.org
 Kiatanantha Lounkaew=kiananan@dpu.ac.th
 Claire Loupias=claire.loupias@univ-evry.fr
 Andre Oliveira Ferreira Loureiro=andrefortaleza@yahoo.com
 Paulo R.A. Loureiro=pauloloureiro@unb.br
 Lina Sofia Lourenço-Gomes=lsofia@utad.pt
 Óscar Domingos Lourenço=osl@fe.uc.pt
 Helen Louri=elouri@bankofgreece.gr
 Megan Louw=meganlouw@gmail.com
 Xiaoxia Lou=lous@udel.edu
 Dimitrios P. Louzis=dlouzis@aueb.gr
 Anna Lovasz=lovasz.anna@krtk.mta.hu
 Yuliya Lovcha=yuliya.lovcha@gmail.com
 David Love=dlove@williams.edu
 David R.F. Love=dlove@brocku.ca
 Jim Love=j.j.love@strath.ac.uk
 Michael C. Lovell=mlovell@wesleyan.edu
 Michael F. Lovenheim=mfl55@cornell.edu
 Scott Thomas Loveridge=loverid2@msu.edu
 Stefania Lovo=stefanialovo@gmail.com
 Aaron Matthew Lowen=lowena@gvsu.edu
 Hamish Low=hamish.low@econ.cam.ac.uk
 Sarah A. Low=slow@ers.usda.gov
 Gino Loyola=gloyola@fen.uchile.cl
 René Lozano Cortés=renlozan@uqroo.mx
 Fernando A. Lozano=fernando.lozano@pomona.edu
 Nancy Lozano-Gracia=nlozano@worldbank.org
 Ana Lozano-Vivas=avivas@uma.es
 Vahe Lskavyan=lskavyan@ohio.edu
 Martien Lubberink=martien.lubberink@vuw.ac.nz
 Britta Lübcke=bluebcke@gmx.de
 Dmitry Lubensky=dmitry.lubensky@gmail.com
 Diego Lubian=diego.lubian@univr.it
 Thomas Lubik=thomas.lubik@rich.frb.org
 Michel Lubrano=michel.lubrano@univ-amu.fr
 Godfrey A. S. Lubulwa=glubulwa@hotmail.com
 Stefano Lucarelli=stefano.lucarelli@unibg.it
 Andre Lucas=a.lucas@vu.nl
 Maria Raquel Lucas=mrlucas@uevora.pt
 Vander Lucas=vlucas@unb.br
 Marcella Lucchetta=lucchett@unive.it
 Riccardo (Jack) Lucchetti=r.lucchetti@univpm.it
 Paolo Lucchino=p.lucchino@niesr.ac.uk
 Pierre Lucena=pierrelucena@gmail.com
 Krista Lucenti=kristalucenti@yahoo.com
 Brian M. Lucey=blucey@tcd.ie
 Carlo Lucheroni=carlo.lucheroni@unicam.it
 Chia-Hui Lu=chlu@mail.ntpu.edu.tw
 Chia-Hui Lu=lu.chiahui@cityu.edu.hk
 Joseph Nicholas Luchman=jluchman@gmail.com
 Elisa Luciano=elisa.luciano@unito.it
 Claudio Lucifora=claudio.lucifora@unicatt.it
 Bernd Lucke=lucke@econ.uni-hamburg.de
 Matthias Lücke=matthias.luecke@ifw-kiel.de
 Yannick Lucotte=ylucotte@esgms.fr
 Elke Lüdemann=elke.luedemann@kfw.de
 Rodney D. Ludema=ludemar@georgetown.edu
 Carlos Ludena=carlosludena@yahoo.com
 Ding Lu=lu_ding@alumni.northwestern.edu
 Sydney C. Ludvigson=sydney.ludvigson@nyu.edu
 Alexander Ludwig=alexander.ludwig@mailbox.tu-dresden.de
 Alexander Ludwig=ludwig@wiso.uni-koeln.de
 Johannes Ludwig=johannes.ludwig@rgs-econ.de
 Markus Ludwig=markus.ludwig@unibas.ch
 Udo Ludwig=udo.ludwig@iwh-halle.de
 Simon Luechinger=simon.luechinger@unilu.ch
 Maria Jose Luengo-Prado=m.luengo@neu.edu
 Torben Luetje=mail@torbenluetje.com
 Steven Lugauer=slugauer@nd.edu
 Haydée Lugo=hlugo@ccee.ucm.es
 Maria Ana Lugo=mlugo1@worldbank.org
 Stefano Lugo=s.lugo@uu.nl
 Volodymyr Lugovskyy=vlugovsk@indiana.edu
 Wolfgang J. Luhan=wolfgang.luhan@rub.de
 Melanie Lührmann=m.luhrmann@ifs.org.uk
 Hon-Kwong Lui=hklui@ln.edu.hk
 Peeter Luikmel=peeter.luikmel@mail.ee
 Prof. Kul B Luintel=luintelk@cardiff.ac.uk
 Jingfeng Lu=ecsljf@nus.edu.sg
 Anna Maria Lukasiewicz=alukasiewicz@csu.edu.au
 Anna Lukiyanova=alukyanova@mail.ru
 Christoph Lülfesmann=cluelfes@sfu.ca
 Meng Lu=tracy.lu@nielsen.com
 Mingshan Lu=lu@ucalgary.ca
 Rünno Lumiste=runno.lumiste@tseba.ttu.ee
 Francesco Luna=fluna@imf.org
 Eduardo Luis Lundberg=duduberg@live.com
 Mattias Lundberg=mlundberg@worldbank.org
 Shelly Lundberg=lundberg@econ.ucsb.edu
 Sofia Lundberg, U=sofia.lundberg@econ.umu.se
 Petter Lundborg=petter.lundborg@nek.lu.se
 Asger Lunde=alunde@econ.au.dk
 Tommy Lundgren=tommy.lundgren@sekon.slu.se
 Michael Lundholm=mlu@ne.su.se
 Nannan Lundin=nannan.lundin@gmail.com
 Jens Friis Lund=jens@life.ku.dk
 Jens Lundsgaard=jens.lundsgaard@oecd.org
 Frederik Lundtofte=frederik.lundtofte@nek.lu.se
 Bengt-Åke Lundvall=bal@business.aau.dk
 Dan Călin Lungescu=dan.lungescu@econ.ubbcluj.ro
 Camelia Iuliana Lungu=camelia.lungu@cig.ase.ro
 Eliza Olivia Lungu=eliza.olivia.lungu@gmail.com
 Laurian Lungu=ll@laurianlungu.com
 Tadeyo Kachunga Lungu=lungutk@coppernet.zm
 Yannick Lung=lung@u-bordeaux4.fr
 Changlin Luo=changlin.luo@gmail.com
 Chenglong Luo=xxlong@ustc.edu
 Guo Ying Luo=luogy@mcmaster.ca
 罗航 (Robin Hang Luo)=robin.h.luo@gmail.com
 Ming-Ching Luoh=luohm@ntu.edu.tw
 Kalevi Luoma=kalevi.luoma@vatt.fi
 Mi Luo=mi.luo@nyu.edu
 Patrizia Luongo=p.luongo@dse.uniba.it
 Luong Tuan Anh=luong.tuananh@mail.shufe.edu.cn
 Wei Luo=luowei@gsm.pku.edu.cn
 Xiao Luo=ecslx@nus.edu.sg
 Yulei Luo=yulei.luo@gmail.com
 Zhehui Luo=luozhehu@msu.edu
 Daniela Lup=dlup@chicagobooth.edu
 Arthur Lupia=lupia@umich.edu
 Claudio Lupi=lupi@unimol.it
 Frank Lupi=lupi@msu.edu
 Annalisa Luporini=luporini@unifi.it
 Barbara Luppi=barbara.luppi@unimore.it
 Joseph P. Lupton=joseph.p.lupton@jpmorgan.com
 Radu Lupu=radu.lupu@rei.ase.ro
 Jayson L. Lusk=jayson.lusk@okstate.edu
 Hanno Lustig=hlustig@anderson.ucla.edu
 Nora Lustig=nlustig@tulane.edu
 Paulo Roberto Barbosa Lustosa=lustosa@unb.br
 Holger Lüthen=holger.luethen@fu-berlin.de
 William J. Luther=lutherw@kenyon.edu
 Helmut Lütkepohl=hluetkepohl@diw.de
 Emiliano Luttini=eeluttini@uh.edu
 Erzo F.P. Luttmer=erzo.fp.luttmer@dartmouth.edu
 Matthias Lutz=matthias.lutz@unisg.ch
 Stefan Lutz=stefanhlutz@aol.com
 Wanbo Lu=luwanbo.swufe@gmail.com
 Wencong Lu=wenclu@zju.edu.cn
 Xiangyun Lu=xl1d13@soton.ac.uk
 Yi Lu=justinly6@gmail.com
 Yingying Lu=lu_ying_ying@hotmail.com
 Jeroen Luyten=jeroen.luyten@ua.ac.be
 Yuanzhu Lu=yuanzhulu@cufe.edu.cn
 路征 (Zheng Lu)=zluecon@gmail.com
 Tommaso Luzzati=tluzzati@ec.unipi.it
 Travis J. Lybbert=tlybbert@ucdavis.edu
 Vassilis Lychnaras=vlychn@kepe.gr
 Reamonn Lydon=reamonn.lydon@centralbank.ie
 Jeanette Ngaire Lye=jnlye@unimelb.edu.au
 Johan Lyhagen=johan.lyhagen@statistics.uu.se
 Lisa Lynch=lisalynch@brandeis.edu
 Lori Lynch=llynch@arec.umd.edu
 Michael Lynn=wml3@cornell.edu
 Peter Lynn=plynn@essex.ac.uk
 Štefan Lyócsa=stefan.lyocsa@euke.sk
 Kenneth S. Lyon=klyon@econ.usu.edu
 Richard K. Lyons=lyons@haas.berkeley.edu
 Ronan C. Lyons=ronan.lyons@tcd.ie
 Sean Lyons=sean.lyons@esri.ie
 Thomas Peyton Lyon=tplyon@umich.edu
 Marco Lyrio=marco.lyrio@insper.edu.br
 Iryna V. Lysenko=lysenko_iren@ukr.net
 Nikita Lyssenko=nlysenko@mun.ca
 Teemu Lyytikäinen=teemu.lyytikainen@vatt.fi
