 Rolf Aaberge=rolf.aaberge@ssb.no
 David Aadland=aadland@uwyo.edu
 Rob Aalbers=r.aalbers@cpb.nl
 Eline Aas=eline.aas@medisin.uio.no
 Knut Are Aastveit=knut-are.aastveit@norges-bank.no
 Luz Karime Abadia Alvarado=labadia@javeriana.edu.co
 Alberto Abadie=alberto_abadie@harvard.edu
 Karim Abadir=k.m.abadir@imperial.ac.uk
 Zelalem Godaye Abahana=zabahana@ufl.edu
 Yulia Abakumova=yabakumova@eu.spb.ru
 Anna Abalkina=abalkina@gmail.com
 Irina Abankina=abankinai@hse.ru
 Kseniya Abanokova=kabanokova@hse.ru
 Paolo Abarcar=pabarcar@umich.edu
 Gianpaolo Abatecola=gianpaolo.abatecola@uniroma2.it
 Antonio Abatemarco=aabatemarco@unisa.it
 Megersa Abera Abate=megersa.abate@vti.se
 Ali Abbas=aliabbas@uiuc.edu
 Faisal Abbas=fabbas@comsats.edu.pk
 Osman Furkan Abbasoğlu=furkan.abbasoglu@tcmb.gov.tr
 Abdessalem Abbassi=abbassi.abdessalem@gmail.com
 S. M. Ali Abbas=sabbas@imf.org
 Syed Kanwar Abbas=kanwarabbas_iiie@yahoo.com
 Jan-Frederik Jozef Abbeloos=jan-frederik.abbeloos@standaard.be
 Brant Abbott=abbottbrant@gmail.com
 Jaap H. Abbring=j.h.abbring@uvt.nl
 Mirko Abbritti=mabbritti@unav.es
 Ali Abcha=abcha.doc@gmail.com
 Manuel Angel Abdala=mabdala@compasslexecon.com
 Yamile Abdala Rioja=yamileabdala@icloud.com
 Abed AL-Nasser Abdallah=abedabdallah@aus.edu
 Dr. Hisham Handal Abdelbaki=habdelbaki@hotmail.com
 Yasmine M. Abdelfattah=yasmine.mohamed@bue.edu.eg
 Hamid Abdel Hakh=abdelhakh_hamid@yahoo.fr
 Abdelhamid EL BOUHADI=el_bouhadihamid@yahoo.fr
 YAHYAOUI Abdelkarim=abdelkarim.yahyaoui@fsegs.rnu.tn
 Ahmed Hamed Abd Ellah=ahmhamed@hotmail.com
 Hesham M Abdel-Rahman=habdelra@uno.edu
 Faouzi ABDENNOUR=abdennour.faouzi@gmail.com
 Md. Joynal Abdin=mdjoynal@gmail.com
 M. Shabri Abd. Majid=hannanan@gmail.com
 Doaa Salman Abdou=doaaslman@yahoo.com
 Baharom Abdul Hamid=baharom.abdulhamid@taylors.edu.my
 Abdullahi Olabode Abdulkadri=abdullahi.abdulkadri@uwimona.edu.jm
 Iskandar Abdullaev=iabdullaev@carec.kz
 Sabah S. Abdullah=sabdull1@jhu.edu
 Selamah Abdullah Yusof=selamah@iium.edu.my
 Besim Verdi Abdullai=besimabdullai@gmail.com
 Emad Mohammad Abdullatif=emadabdullatif@hotmail.com
 Muhamed Zulkhibri Abdul Majid=khibri1974@yahoo.com
 Malek Mohammad Abdul=malekr25@gmail.com
 Akmal A. Abdurazakov=akmal.abdurazakov@gmail.com
 Degnet Abebaw=degnet2003@yahoo.com
 Girum Abebe Tefera=girumpop@yahoo.com
 Kenzo Abe=k-abe@econ.osaka-u.ac.jp
 Andrew Abel=abel@wharton.upenn.edu
 Istvan Abel=iabel280@gmail.com
 Jaison Robert Abel=jaison.abel@ny.frb.org
 Jennifer Abel-Koch=abelkoch@uni-mainz.de
 Jose-Maria Abellan-Perpiñan=dionisos@um.es
 Tilak Abeysinghe=tilakabey@nus.edu.sg
 Pongrapeeporn Abhakorn=abhakorn@hotmail.com
 Abdul Abiad=aabiad@imf.org
 Aled ab Iorwerth=abiorwerth.aled@fin.gc.ca
 Pablo Abitbol=pabloabitbol@gmail.com
 Jose-Miguel Abito=mabito@u.northwestern.edu
 Mohamed R. Abonazel=mabonazel@hotmail.com
 Kodjo Abotsi=abotsi@gmail.com
 Rahi Abouk=abouk@ohio.edu
 Esmaiel Abounoori=esmaiel.abounoori@gmail.com
 Sofiane Aboura=sofiane.aboura@dauphine.fr
 John M. Abowd=john.abowd@cornell.edu
 Salem M. Abo-Zaid=salem.abozaid@ttu.edu
 Arpad J. Abraham=arpad.abraham@eui.eu
 Biju Abraham=kbiju2@yahoo.co.in
 Katharine Abraham=kabraham@umd.edu
 Vinoj Abraham=vinojabraham@gmail.com
 Burton Alan Abrams=abramsb@udel.edu
 Rosa M. Abrantes-Metz=rabrante@stern.nyu.edu
 Maria Joy V. Abrenica=ma_joy.abrenica@upd.edu.ph
 Alexandre Abreu=alexjabreu@gmail.com
 Margarida Abreu=mabreu@doc.iseg.utl.pt
 Maria Abreu=ma405@cam.ac.uk
 Rute Abreu=ra_ipg@hotmail.com
 Luisa Fernanda Abreu Sernandez=fabreu@uvigo.es
 Zewdu Ayalew Abro=zewduayalewabro@gmail.com
 Suleiman Abu-Bader=abubader@bgu.ac.il
 Kamarudin Abu Bakar=kamarudin@utem.edu.my
 Emmanuel Abuelafia=emmabuel@hotmail.com
 Assem Abu Hatab=assem_hatab@hotmail.com
 Hadeel Salem Abu Loghod=hadeelss@gmail.com
 Aamer S. Abu-Qarn=aamer@bgu.ac.il
 George Abuselidze=abuseri@mail.ru
 Mohammad Abu-Zaineh=mohammad.abu-zaineh@inserm.fr
 Ali Acaravcı=acaravci@hotmail.com
 Antonio Accetturo=antonio.accetturo@bancaditalia.it
 Elvio Accinelli=elvio.accinelli@eco.uaslp.mx
 Olivier Accominotti=o.accominotti@lse.ac.uk
 Antonio Acconcia=antonio.acconcia@unina.it
 marco accorinti, Sr.=m.accorinti@irpps.cnr.it
 María Teresa Aceytuno=maria.aceytuno@dege.uhu.es
 Mohamed Akli ACHABOU=ma.achabou@ipag.fr
 Sushant Acharya=acharya@econ.umd.edu
 Viral V. Acharya=vacharya@stern.nyu.edu
 Rajat Acharyya=rajat.acharyya@gmail.com
 Martin Achtnicht=achtnicht@zew.de
 Lahcen Achy=achyinsea@gmail.com
 Bernur Acikgoz Ersoy=bernur@gmail.com
 Senay Acikgoz=asenay@gazi.edu.tr
 Daniel Ackerberg=daniel.ackerberg@gmail.com
 Frank Ackerman=frankackerman12@gmail.com
 Lucy F. Ackert=lackert@kennesaw.edu
 Robert J Ackland=robert.ackland@anu.edu.au
 Karina Acosta=kacostor@banrep.gov.co
 Manuel Acosta=manuel.acosta@uca.es
 Pablo Acosta=acostapablo@gmail.com
 Irma Lorena Acosta Reveles=ilacosta2@hotmail.com
 Alessandro Acquisti=acquisti@andrew.cmu.edu
 Zoltan J. Acs,=zacs@gmu.edu
 Eugenio Actis Di Pasquale=edipasq@mdp.edu.ar
 Andrés Acuña=aacunad@ubiobio.cl
 Antonis Adam=aadam@cc.uoi.gr
 Christopher Adam=christopher.adam@economics.ox.ac.uk
 Klaus Adam=adam@uni-mannheim.de
 Tasso Adamopoulos=tasso@econ.yorku.ca
 Wiktor Adamowicz=vic.adamowicz@ualberta.ca
 Damian C. Adams=dcadams@ufl.edu
 F. Gerard Adams=adams@ssc.upenn.edu
 Jonathon Adams-Kane=jonathonak@gmail.com
 David Adamson=d.adamson@uq.edu.au
 Kunle Y. Adamson=dr.adamson@adamson-economics.org
 Philip David Adams=philip.adams@vu.edu.au
 Richard H. Adams, Jr.=adams@bide.com
 Scott Adams=sjadams@uwm.edu
 Zeno Adams=zeno.adams@unisg.ch
 Bernardino Adao=bernardino.pereira.adao@bportugal.pt
 Johnson Samuel Adari, Ph.D.=jsadari@mail.uonbi.ac.ke
 Waleed Ahmad Addas=wajaddas@yahoo.com
 Elisabetta Addis=addis@uniss.it
 John Addison=ecceaddi@moore.sc.edu
 Adebayo Michael Adebiyi, Sr.=mikebiyi@yahoo.com
 J. Adetunji Adegbesan=tadegbesan@lbs.edu.ng
 Yvonne Adema=adema@ese.eur.nl
 Nermin Ademi=n.ademi@kultura.gov.mk
 Maja Adena=maja.adena@wzb.eu
 Oluwatosin Adeniyi=saino78@yahoo.com
 Deodat E. Adenutsi=deo.adenutsi@gmail.com
 Temitayo Adenike Adepoju=temmytee11@yahoo.com
 Olutomi Ibukunolu Adeyemi=tomi_adeyemi@hotmail.co.uk
 Shola Adeyemi=sholadeyemi2003@yahoo.com
 Achyuta R. Adhvaryu=adhvaryu@umich.edu
 Kampon Adireksombat=kampon@gmail.com
 Stéphane Adjemian=stephane.adjemian@univ-lemans.fr
 Lee C. Adkins=lee.adkins@okstate.edu
 Muhammad Akhyar Adnan=ibnu8adnan@yahoo.com
 Nick Adnett=n.j.adnett@staffs.ac.uk
 Malin Adolfson=malin.adolfson@gmail.com
 Kwame Adom=kadom@ug.edu.gh
 Adom Philip Kofi=adomonline@yahoo.co.uk
 Stef Adriaenssens=stef.adriaenssens@hubrussel.be
 Tobias Adrian=tobias.adrian@ny.frb.org
 Alicia Adsera=adsera@princeton.edu
 Marina E. Adshade=marina.adshade@gmail.com
 Frank Adu=frankadu64@gmail.com
 Monica Adya=monica.adya@marquette.edu
 Diederik Aerts=diraerts@vub.ac.be
 Elvin Namig Afandi=e.afandi@yahoo.com
 Sylvanus Kwaku Afesorgbor=safes@asb.dk
 Antonio Affuso=antonio.affuso@tesoro.it
 Ermanno Affuso=eaffuso@southalabama.edu
 Gara M. Afonso=gara.afonso@ny.frb.org
 Pedro Miguel Baptista Afonso=pedrombafonso@gmail.com
 Ana Paula Africano=apa@fep.up.pt
 Adriana Agapie=adriana.agapie@yahoo.com
 Aman Agarwal=aa@iifbs.edu
 Natasha Agarwal=agarwana3@gmail.com
 Rahul Agarwal=senseirahul@rediffmail.com
 Sumit Agarwal=ushakri@yahoo.com
 Tommaso Agasisti=tommaso.agasisti@polimi.it
 Murali Agastya=murali.agastya@sydney.edu.au
 Temisan Agbeyegbe=tagbeyeg@hunter.cuny.edu
 Julius Agbor Agbor=jagbor1970@gmail.com
 Mohammed Moosa Ageli=mageli@ksu.edu.sa
 Pierre-Richard Agénor=pierre-richard.agenor@manchester.ac.uk
 Philipp Ager=phag@sam.sdu.dk
 Aradhana Aggarwal=aradhnaaggarwal@ncaer.org
 Nidhi Aggarwal=nidhi@igidr.ac.in
 Raj Aggarwal=aggarwa@uakron.edu
 Shalini Aggarwal=shaliniaggar@gmail.com
 Suresh Chand Aggarwal=sureshchag@yahoo.com
 Alia Aghajanian=a.aghajanian@ids.ac.uk
 Edouard D. Aghion=eaghion@gmail.com
 George Agiomirgianakis=gmagios@eap.gr
 Anna Agliari=anna.agliari@unicatt.it
 Betty Agnani=bagnani@ugr.es
 Luca Agnello=luca.agnello01@unipa.it
 Pablo Agnese=pablo.agnese@fh-duesseldorf.de
 Delina Emilova Agnosteva=dea34@drexel.edu
 Manuel R. Agosin=managosin@gmail.com
 Marisa Agostini=marisa.agostini@unive.it
 David R. Agrawal=dagrawal@uga.edu
 Per J. Agrell=per.agrell@uclouvain.be
 Hanna Ågren=hanna.agren@finance.ministry.se
 Martin Ågren=martin.agren.nek@gmail.com
 Juan Carlos Aguado Franco=juancarlos.aguado@urjc.es
 Itziar Aguado=itziar.aguado@ehu.es
 Luis Fernando Aguado Quintero=lfaguado@javerianacali.edu.co
 Ernesto Aguayo-Téllez=ernestoaguayo@gmail.com
 Diego Alonso Agudelo=dagudelo@eafit.edu.co
 Luís Aguiar-Conraria=aguiarconraria@gmail.com
 Hugo Menino Aguiar=hugoaguiar.pt@gmail.com
 Luis Aguiar=luis.aguiar@ec.europa.eu
 Angel Humberto Aguiar Román=aaguiar@purdue.edu
 Emma Aguila=eaguila@rand.org
 Giovanna Aguilar Andía=gaguila@pucp.edu.pe
 Arturo Alberto Aguilar Esteva=arturo.aguilar@itam.mx
 Tirza July Aguilar Salas=tirza@ucb.edu.bo
 Maria Modesta Aguilera=maguildi@banrep.gov.co
 Victor Aguirregabiria=victor.aguirregabiria@utoronto.ca
 Iñaki Aguirre=inaki.aguirre@ehu.es
 Ana Agundez Garcia=ana.agundez-garcia@ec.europa.eu
 Muhammad Yousuf AGURIA=myaguria@yahoo.com
 Itai Agur=itai333@hotmail.com
 Marcos Agurto Adrianzen=marcos.agurto@udep.pe
 Hernández-Bastida Agustín=bastida@ugr.es
 Felix Agyei-Sasu=felixagyeisasu@yahoo.com
 Mazbahul Ahamad=mg.ahamad@gmail.com
 Jaime Rafael Ahcar Olmos=jrahcarolmos@gmail.com
 Alan Ahearne=alan.ahearne@nuigalway.ie
 Daniel Felix Ahelegbey=dfkahey@unive.it
 Kenneth R. Ahern=kenneth.ahern@marshall.usc.edu
 Stephen Eli Ahiabu=ahiabu@yahoo.com
 Avner Ahituv=aahituv@econ.haifa.ac.il
 Francis Ahking=francis.ahking@uconn.edu
 Gerd Ahlert=ahlert@gws-os.com
 Montek S Ahluwalia=dch@nic.in
 Azkar Ahmad=azkar@pide.org.pk
 Iftikhar Ahmad=ifftyahmad@hotmail.com
 Kaikaus Ahmad=k.ahmad@cgiar.org
 Munir Ahmad=camunir@yahoo.com
 Nadim Ahmad=nadim.ahmad@oecd.org
 Naved Ahmad=nahmad@iba.edu.pk
 Nawaz Ahmad NCBAE=nawazecon_fin@hotmail.com
 Nawaz Ahmad=nawazahmad_pk@hotmail.com
 Sohail Ahmad=puresohail@yahoo.com
 Taleb Ahmad=taleb_ahmad1976@yahoo.de
 Usman Ahmad=rohanahmed2001@yahoo.com
 سینا احمدزاده ماشین چی (Sina Ahmadzadeh Mashinchi)=s.ahmadzadeh@auckland.ac.nz
 Ather Maqsood Ahmed=dr.athar@nbs.edu.pk
 Ayaz Ahmed=ayaz@pide.org.pk
 Doaa Akl Ahmed=doaa.ahmed01@fcom.bu.edu.eg
 Elsadig Musa Ahmed=elsadigmusa@yahoo.com
 Habib Ahmed=drhahmed@gmail.com
 Jameel Ahmed=j.ahmed@maastrichtuniversity.nl
 Mansur Ahmed=mansur@bids.org.bd
 Md Shabbir Ahmed=shabtax@yahoo.com
 Md Shoaib Ahmed=shoaib.ffl@hotmail.com
 Mohd. Saleh Ahmed=msahmed@squ.edu.om
 Mumtaz Ahmed=mumtaz.mumtazahmed@gmail.com
 Rasha M. Ahmed=rasha.ahmed@trincoll.edu
 Salma Ahmed=salma.ahmed@deakin.edu.au
 Shahid Ahmed=shahec@gmail.com
 Syed M. Ahmed=syeda@cameron.edu
 Vaqar Ahmed=vahmed@gmail.com
 Walid M.A. Ahmed=wmaziz@hotmail.com
 Namkee Ahn=namkee.ahn@unican.es
 Seoungpil Ahn=spahn@sogang.ac.kr
 Seung C. Ahn=seungminahn@gmail.com
 Tom Ahn=thomas.ahn@uky.edu
 Rudiger Ahrend=rudiger.ahrend@oecd.org
 Steffen Ahrens=steffen.ahrens@tu-berlin.de
 AFM Mainul Ahsan=mainul@iub.edu.bd
 Henna Ahsan=henna.ahsan@pide.org.pk
 Reshad Ahsan=rahsan@unimelb.edu.au
 Syed M. Ahsan=syed.ahsan@concordia.ca
 Vinod Ahuja=vinod.ahuja@fao.org
 Hildegart Ahumada=hahumada@utdt.edu
 Ruta Aidis=raidis@gmu.edu
 Wafa Aidi=aidi.wafa@graduateinstitute.ch
 ERIC Nimako AIDOO=ghanaogonos@yahoo.com
 Robert Aidoo=badubob@yahoo.co.uk
 Toke S Aidt=tsa23@econ.cam.ac.uk
 Francesco Aiello=f.aiello@unical.it
 Karl Aiginger=karl.aiginger@wifo.ac.at
 David Aikman=david.aikman@bankofengland.co.uk
 Alina Georgeta Ailincă=alina.glod@gmail.com
 Carmen Aina=carmen.aina@eco.unipmn.it
 Marco Airaudo=marco.airaudo@drexel.edu
 Jim Airola=jimairola@me.com
 Rosa Aísa=raisa@unizar.es
 Andrew Aitken=andy2aitken@gmail.com
 Varouj Aram Aivazian=varouj.aivazian@utoronto.ca
 Shekhar Aiyar=saiyar@imf.org
 Ana Aizcorbe=ana.aizcorbe@bea.gov
 Joshua Aizenman=aizenman@usc.edu
 Anna Aizer=anna_aizer@brown.edu
 Olubunmi Idowu Ajani=oi.ajani@mail.ui.edu.ng
 Oluyede Clifford Ajayi=ajayi@gmx.net
 Viktors Ajevskis=viktors.ajevskis@bank.lv
 Ian Martin Ajzenszmidt=ian.ajzenszmidt@alumni.unimelb.edu.au
 Hideo Akabayashi=hakab@econ.keio.ac.jp
 Brou Emmanuel Aka=emmanuel_aka_brou@yahoo.fr
 Jiro Akahori=akahori@se.ritsumei.ac.jp
 Nobuo Akai=akai@osipp.osaka-u.ac.jp
 Mustafa Akal=akal@sakarya.edu.tr
 Olusegun Ayodele Akanbi=akanboa@unisa.ac.za
 Omolara Ololade Akanji=aomolara@hotmail.com
 Ali T. Akarca=akarca@uic.edu
 Alpaslan Akay=alpaslan.akay@economics.gu.se
 Dara Akbarian=dakbarian@yahoo.com
 Syed Ather Hussain Akbari=ather.akbari@smu.ca
 Mashfique Ibne Akbar=akbar.mashfique@gmail.com
 Sajjad Akbar=sajjad.akbar@gems9.gov.bc.ca
 Elif Akben Selçuk=elif.akben@boun.edu.tr
 Fahad Akber=cancerian45@hotmail.com
 Mevlude Akbulut-Yuksel=mevlude@dal.ca
 Emin Akcaoglu=eakcaoglu@gmail.com
 İbrahim Semih Akçomak=akcomak@metu.edu.tr
 Eray AKDAĞ=erayakdag@gmail.com
 Sinan AKDAL=sinanakdal@gmail.com
 Sacit Hadi Akdede=shakdede@adu.edu.tr
 Esra Akdeniz Duran=esraakdeniz@gmail.com
 Randall Akee=rakee@ucla.edu
 Anders Akerman=anders.akerman@ne.su.se
 Amanar Akhabbar=amanar.akh@gmail.com
 Jalal Akhavein=akhajal@blackrock.com
 Naseem Akhter=naseemakhter_pide@yahoo.com
 Hiroya Akiba=hiroya@waseda.jp
 Fatih Akici=fakici@smu.edu
 Çiğdem Akın=cakin@johnshopkins.it
 Ozge Akinci=ozge.akinci@frb.gov
 Natalia Vasilievna Akindinova=nakindinova@hse.ru
 Guzin Gulsun Akin=gulsun.akin@boun.edu.tr
 Akin-Olusoji Akinyele=sojiakinyele@yahoo.co.uk
 Zafer Akin=zaferakin@gmail.com
 Philip Olakunle Akiode=philip@kunleakiode.com
 Yıldız Akkaya=yakkaya@bilkent.edu.tr
 K. Ali Akkemik=akkemik@gmail.com
 Huseyin Cagri Akkoyun=cagri.akkoyun@tcmb.gov.tr
 Uğur Akman=akman@boun.edu.tr
 Christian ZAMO AKONO=zchristy2@yahoo.fr
 Usenobong F. Akpan=uakpan@yahoo.co.uk
 Richard Akresh=akresh@illinois.edu
 Ewa Aksman=aksman@wne.uw.edu.pl
 Bora Aktan=boraktan@gmail.com
 Erkan Aktaş=erkanaktas@mersin.edu.tr
 Zelal Aktas=zelal.kotan@tcmb.gov.tr
 Shaheen Akter=aktshahe@aol.com
 Sonia Akter=s.akter@irri.org
 Haydar Akyazı=hakyazi@yahoo.com
 Ahmet Akyol=aakyol@econ.yorku.ca
 Cem Akyurek=cakyurek@evcap.com
 Abid A. Al-Abdali=drabid1995@hotmail.com
 Samson Adeniyi Aladejare=aladejare4reel2000@yahoo.co.uk
 Paul Alagidede=paul.alagidede@wits.ac.za
 Abul Quasem Al-Amin=amin_cant@yahoo.com
 Md. Mahmudul Alam=rony000@gmail.com
 Moneer Alam=moneer@iegindia.org
 M. Shahid Alam=m.alam@neu.edu
 Pervaiz Alam=palam@kent.edu
 Shamsul Alam=getshams@hotmail.com
 Tasneem Alam=tasneem_sbp@yahoo.com
 Fairlie Reinoso Alan=afairli@pucp.edu.pe
 Angel Alañon Pardo=angel@ccee.ucm.es
 Sule Alan=salancrossley@gmail.com
 Larbi Alaoui=larbi.alaoui@gmail.com
 Gloria Alarcón-García=gloria@um.es
 David Alary=david.alary@tse-fr.eu
 Claude Alavoine=c.alavoine@ipag.fr
 Mouawiya Al Awad=mouawiya.alawad@gmail.com
 Shireen AlAzzawi=salazzawi@scu.edu
 Nicolás Albacete=nicolas.albacete@oenb.at
 Alberto Albahari=alberto.albahari@uma.es
 Manuel Albaladejo=mj_albaladejo@yahoo.es
 Daniel Albalate=albalate@ub.edu
 Claudio Albanese=claudio@albanese.co.uk
 Giuseppe Albanese=giuseppe.albanese@bancaditalia.it
 Marina Albanese=albanese@unina.it
 Stefania Albanesi=stefania.albanesi@ny.frb.org
 Pedro Albarran Perez=pedro.albarran@gmail.com
 Adalberto Alberici=adalberto.alberici@unimi.it
 Enrique Alberola=alberola@bde.es
 Heidi J. Albers=jo.albers@oregonstate.edu
 Scott Alan Albers=scott_albers@msn.com
 Sönke Albers=albers@bwl.uni-kiel.de
 Julien Albertini=albertij@cms.hu-berlin.de
 Max Albert=max.albert@wirtschaft.uni-giessen.de
 Luis Miguel Albisu=lmalbisu@cita-aragon.es
 Cornelia Alboiu=coraalboiu@yahoo.com
 Alice Albonico=alice.albonico@unimib.it
 Facundo Albornoz=f.albornoz@bham.ac.uk
 David Yves Albouy=albouy@illinois.edu
 Michel ALBOUY=michel.albouy@grenoble-em.com
 James Albrecht=albrecht@georgetown.edu
 Silviu Iulian Alb=iulian_s_alb@yahoo.com
 Gina Albu=ginaalbu@yahoo.com
 Claudiu Tiberiu Albulescu=claudiual@yahoo.com
 Bruno Albuquerque=brunoalbuquerque19@yahoo.com
 Eduardo da Motta e Albuquerque=albuquer@cedeplar.ufmg.br
 Paula C. Albuquerque=pcma@iseg.utl.pt
 Paulo Albuquerque=paulo.albuquerque@simon.rochester.edu
 Rui Albuquerque=ralbuque@bu.edu
 André Albuquerque Sant'Anna=andre.santanna@bndes.gov.br
 Philippe Alby=philippe.alby@univ-tlse1.fr
 Francisco Alcalá=alcala.paco@gmail.com
 Federico Agustín Alcalde Bessia=falcald@yahoo.com.ar
 Jose Alcalde=jose.alcalde@ua.es
 Jorge Alcalde-Unzu=jorge.alcalde@ehu.es
 Vicent Alcantara=vicent.alcantara@uab.es
 José Carlos Rodríguez Alcantud=jcr@usal.es
 Carlo Alcaraz=carloalcaraz@gmail.com
 Lorena Alcázar=lalcazar@grade.org.pe
 Cinzia Alcidi=cinzia.alcidi@ceps.eu
 Alain Alcouffe=alain.alcouffe@ut-capitole.fr
 Erik Alda=erik.alda@gmail.com
 Covadonga Aldamiz-echevarría=covadonga.aldamiz@ehu.es
 Ana Teresa Aldana=ana.aldana@uexternado.edu.co
 Alisher Aldashev=alisher.aldashev@googlemail.com
 Gani Aldashev=gani.aldashev@fundp.ac.be
 Anamaria Aldea=anamaria.aldea@csie.ase.ro
 Harold Alderman=h.alderman@cgiar.org
 Simon Alder=simon.alder@econ.uzh.ch
 Luigi Aldieri=luigi.aldieri@uniparthenope.it
 Eric Mark Aldrich=ealdrich@ucsc.edu
 Thomas Taylor Aldridge=ttaldridge@googlemail.com
 Dante Mendes Aldrighi=aldrighi@usp.br
 Joseph E. Aldy=joealdy@gmail.com
 Ciprian Ionel Alecu=aiciprian@yahoo.com
 Abdul Aleem=abdulaleem75@yahoo.co.uk
 Joaquin Alegre=joaquin.alegre@uv.es
 Javier Alejo=javieralejo@gmail.com
 Luis Alejandro Alejos Marroquin=lalejos@iadb.org
 Mercik Roman Aleksander=mercik.aleksander@gmail.com
 Ana Claudia Alem=aalem@bndes.gov.br
 Douglas Alcantara Alencar=dougsky@gmail.com
 Mohammad Alenezi=msalenez@safat.kisr.edu.kw
 Amadeo Alentorn=aalentorn@gmail.com
 Alberto Alesina=aalesina@harvard.edu
 George Alessandria=george.alessandria@gmail.com
 Pietro Alessandrini, Sr.=p.alessandrini@univpm.it
 Sergio Alessandrini=sergio.alessandrini@unimore.it
 Rob Alessie=r.j.m.alessie@rug.nl
 Jonathan E. Alevy=jalevy@uaa.alaska.edu
 Barbara Joyce Alexander=balexander@arguendoinc.com
 Carol Alexander=c.alexander@sussex.ac.uk
 G Caleb Alexander=galexand@jhsph.edu
 Gigi Monique Alexander=dr.gigialexander@gmail.com
 Gordon J. Alexander=gjalex@umn.edu
 Ian Alexander=ian.alexander@cepa.co.uk
 Kim Suzanne Alexander=kalexand@uow.edu.au
 Constantine Alexandrakis=constantine.alexandrakis@hofstra.edu
 Fernando Alexandre=falex@eeg.uminho.pt
 Alexandre=herve.alexandre@dauphine.fr
 Matilda Alexandrova=matildaa@unwe.acad.bg
 Felicia Alexandru=alexandryafelicia@yahoo.com
 Dony Alex=donyalex@gmail.com
 Alexander Gennadievich Alexeev=aalekseev@eu.spb.ru
 Michael Alexeev=malexeev@indiana.edu
 Vitali Alexeev=valexeev@utas.edu.au
 Annika Alexius=annika.alexius@ne.su.se
 Michelle Alexopoulos=malex@chass.utoronto.ca
 Martina Alexova=martina.alexova@gmail.com
 Gilles Alfandari=galfandari@worldbank.org
 Maria Rosaria ALFANO=mariarosaria.alfano@unina2.it
 Simone Alfarano=alfarano@eco.uji.es
 José Antonio Alfaro=jalfaro@unav.es
 Laura Alfaro=lalfaro@hbs.edu
 Rodrigo Alfaro=ralfaro@ymail.com
 Knut Halvor Alfsen=knut.alfsen@netcom.no
 Yann Algan=yann.algan@sciences-po.fr
 Ingela Alger=ingela.alger@tse-fr.eu
 Syed Othman Hussin Alhabshi=soalhabshi@inceif.org
 Abdullah Al-Hassan=aalhassan@imf.org
 Abdul Latif Alhassan=lateef85@yahoo.com
 Ahmed Alhayky=alfanooce@hotmail.com
 Sadegh Alhosseini=eco@alhosseini.org
 Didier Yélognissè ALIA=d.alia@uky.edu
 Roger Aliaga-Diaz=roger_aliaga-diaz@vanguard.com
 Javier Aliaga Lordemann=jaliaga@ucb.edu.bo
 Huson Joher Ali Ahmed=huson.aliahmed@deakin.edu.au
 Amanat Ali=amanat@qau.edu.pk
 Amjad Ali=amjad.ali3@hotmail.com
 Heba Abdel Monem Ali=hebaabdelmonem1974@gmail.com
 R. Santos Alimi=santos4rd@gmail.com
 Bobur Alimov=balimov@adb.org
 Muhammad Mahboob Ali=pipulbd@gmail.com
 Nabil Ali=nabil.ali@oecd.org
 S. Nageeb M. Ali=snali@ucsd.edu
 Syed Mubashir Ali=syedmubashirali@yahoo.com
 G. Alivelu=alivelu2003@gmail.com
 Ahmet Alkan=alkan@sabanciuniv.edu
 Sabina Alkire=sabina.alkire@qeh.ox.ac.uk
 Dorothée Allain-Dupré=dorothee.allain-dupre@oecd.org
 Marie-Laure Allain=marie-laure.allain@polytechnique.edu
 Olivier Allain=olivier.allain@parisdescartes.fr
 Olivier Allais=olivier.allais@ivry.inra.fr
 Erindi Allaj=erindi.allaj@uniroma2.it
 Grant Jordan Allan=grant.j.allan@strath.ac.uk
 Paul Allanson=p.f.allanson@dundee.ac.uk
 Hunt Allcott=hunt.allcott@nyu.edu
 Guillaume Allègre=guillaume.allegre@ofce.sciences-po.fr
 Jean-Pierre Allegret=jallegret@u-paris10.fr
 James Alleman=james.alleman@colorado.edu
 David Edmund Allen=profallen2007@gmail.com
 Douglas W. Allen=allen@sfu.ca
 Edward William Allen=ewallen@ers.usda.gov
 Franklin Allen=allenf@wharton.upenn.edu
 James Patrick Allen=j.allen@roa.unimaas.nl
 P Geoffrey Allen=allen@resecon.umass.edu
 Rebecca Allen=r.allen@ioe.ac.uk
 Robert Carson Allen=bob.allen@nuffield.ox.ac.uk
 Steven Allen=steve_allen@ncsu.edu
 Melanie Allwine=mallwine@gwu.edu
 Ingvild Almås=ingvild.almas@nhh.no
 Aléssio Tony Cavalcanti de Almeida=alessiotony@gmail.com
 Alexandre Nunes Almeida=alex.almeida859@gmail.com
 Anabela Almeida=aalmeida@ubi.pt
 Caio Almeida=calmeida@fgv.br
 Rita Almeida=ralmeida@worldbank.org
 Filipe Almeida-Santos=almeidasantos.filipe@gmail.com
 Vanda Almeida=almeidavanda@gmail.com
 James Alm=jalm@tulane.edu
 Antonio Almodovar=amal@fep.up.pt
 Isabel Almudi=ialmudi@unizar.es
 Usama Zuhair Al-mulali=usama_81z@yahoo.com
 Miguel Almunia=m.almunia@warwick.ac.uk
 Amjad D. Al-Nasser=amjadyu@yahoo.com
 Umit Alniacik=umit.alniacik@kocaeli.edu.tr
 Marta Aloi=marta.aloi@nottingham.ac.uk
 Ibrahim Alomar=ialomar@hotmail.com
 Md Fardous Alom=fardousalom@gmail.com
 Angel Alonso Arroba=angel.alonsoarroba@oecd.org
 César Alonso-Borrego=cesar.alonso@uc3m.es
 Jaime Alonso-Carrera=jalonso@uvigo.es
 Pablo Alonso González=pablo.alonsog@uah.es
 Jose M. Alonso=alonsoajm@unican.es
 Julio César Alonso=jcalonso@icesi.edu.co
 Miguel A. Alonso Neira=miguelangel.alonso@urjc.es
 Jorge Alonso Ortiz=jorge.alonso@itam.mx
 Eduard Alonso-Pauli=ealonso@upo.es
 Ruperto P. Alonzo=ruperto.alonzo@up.edu.ph
 Arash Aloosh=arash.aloosh@bi.no
 Marwan M. Aloqeili=maloqeili@birzeit.edu
 Carlos Alós-Ferrer=carlos.alos-ferrer@uni-koeln.de
 Chaker Aloui=chakeraloui2@yahoo.fr
 Riadh Aloui=riadh.aloui@isg.rnu.tn
 Rym ALOUI=rym.aloui.bensaid@gmail.com
 Marcel ALOY=marcel.aloy@univ-amu.fr
 Sami Alpanda=salpanda@amherst.edu
 C. Emre Alper=ealper@imf.org
 William Alpert=alpert@uconn.edu
 Henry C. Alphin Jr.=henry@drexel.edu
 Selçuk Alp=alp@yildiz.edu.tr
 Vida Lina B. Alpuerto=v.alpuerto@cgiar.org
 Ron Alquist=ralquist@bankofcanada.ca
 Ahmad Nahar Al-Rfou=ahmadrfou_357@yahoo.com
 Samer Am Al-Rjoub=salrjoub@hu.edu.jo
 Ali J. Al-Sadig=alijassima@yahoo.com
 Nidal A. Alsayyed=nsayed1970@yahoo.com
 Omar Hesham AlShehabi=omar.alshehabi@gmail.com
 Ragna Alstadheim=ragna.alstadheim@norges-bank.no
 Annette Alstadsæter=annette.alstadsater@medisin.uio.no
 Carlo Altavilla=carlo.altavilla@ecb.int
 Erdinç Altay=eraltay@istanbul.edu.tr
 Wilhelm Althammer=wilhelm.althammer@hhl.de
 Alper Altinanahtar=aaltinanahtar@yeditepe.edu.tr
 Galip Altinay=galtinay@yahoo.com
 Duha T Altindag=altindag@auburn.edu
 Nadir Altinok=nadir.altinok@univ-lorraine.fr
 Taner ALTINOK=taneraltunok@gmail.com
 Elizabeth J. Altman=ealtman@hbs.edu
 Morris Altman=morris.altman@vuw.ac.nz
 Jörn Altmann=jorn.altmann@acm.org
 Steffen Altmann=altmann@iza.org
 Carlo Altomonte=carlo.altomonte@unibocconi.it
 Rosanne Altshuler=altshule@rci.rutgers.edu
 Sumru Altug=saltug@ku.edu.tr
 Yener Altunbas=abs011@bangor.ac.uk
 Fahad M. Alturki=fahad.alturki@barcap.com
 Amaia Altuzarra=amaia.altuzarra@ehu.es
 Wilfried Altzinger=altzing@wu.ac.at
 Omar Ahmad Al-Ubaydli=omar@omar.ec
 Nilay aluftekin=naluftekin@ybu.edu.tr
 Betty Margot Alvarado Pérez=alvarado_bm@up.edu.pe
 Facundo Alvaredo=alvaredo@pse.ens.fr
 Gustavo Varela Alvarenga=gualvarenga@gmail.com
 Andrés Alvarez=ca.alvarez967@uniandes.edu.co
 Inmaculada Concepcion Alvarez Ayuso=inmaculada.alvarez@uam.es
 Begoña Álvarez=alvarez@uvigo.es
 Francisco Alvarez-Cuadrado=francisco.alvarez-cuadrado@mcgill.ca
 Francisco Alvarez Gonzalez=fralvare@ccee.ucm.es
 Isabel Álvarez=isabel.alvarez@ccee.ucm.es
 Lía Alvarez=lia_alvarez@lycos.com
 Pedro Pablo Alvarez Lois=pedro.alvarez-lois@santandergbm.com
 Carlos Álvarez-Nogal=canogal@clio.uc3m.es
 Maria Jose Alvarez Pelaez=mjp@dst.dk
 Roberto Alvarez=robalvar@fen.uchile.cl
 Sebastián Alvarez=sebastian.alvarez@unige.ch
 Sharon A. Alvarez=alvarez_42@cob.osu.edu
 Xosé Carlos Álvarez Villamarín=xalvarez@uvigo.es
 Carlos Francisco Alves=calves@fep.up.pt
 Denisard C. O. Alves=dcoalves@usp.br
 Guillermo Alves=guillermo_alves_temperan@brown.edu
 Helena Baptista Alves=halves@ubi.pt
 Sergio A. Lago Alves=sergiolago@hotmail.com
 Mauricio Alviar=malviar@udea.edu.co
 Jorge Luis Alvis=jalvis@unitecnologica.edu.co
 Jeffrey Alwang=alwangj@vt.edu
 Khamis Hamed Al-Yahyaee=yahyai@squ.edu.om
 Mohammed Alzahrani=mfaraj@kfupm.edu.sa
 Haitham A. Al-Zoubi=hazoubi@ssc.gov.jo
 Cristina Amado=camado@eeg.uminho.pt
 Diego Amador=diego.amador.o@gmail.com
 Francisco Javier Amador=famador@ull.es
 João Amador=jamador@bportugal.pt
 Juan Sebastián Amador Torres=jamadoto@banrep.gov.co
 Lloyd Ahamefule Amaghionyeodiwe=lamaghionyeodiwe@yahoo.co.uk
 Vincent Amanor-Boadu=vincent@ksu.edu
 Jomana Amara=jhamara@nps.edu
 Pedro S. Amaral=pedro.amaral@clev.frb.org
 Pedro Vasconcelos Amaral=pedrovma@cedeplar.ufmg.br
 Mohamed Amara=amara_isg@yahoo.fr
 Himanshu Akhila Amarawickrama=hamarawick@gmail.com
 Daniel AMARIEI=d.amariei@uem.ro
 Olga Ioana AMARIEI=o.amariei@uem.ro
 João Amaro de Matos=amatos@fe.unl.pt
 Simona Amati=samati@kreabgavinanderson.com
 Oriol Amat=oriol.amat@upf.edu
 Francesca Amaturo=francesca.amaturo@tesoro.it
 Voxi Heinrich S Amavilah=amavilah@msn.com
 Frederic Amblard=frederic.amblard@univ-tlse1.fr
 Kate Ambler=k.ambler@cgiar.org
 Steven Ambler=ambler.steven@uqam.ca
 Angela Ambrosino=angela.ambrosino@unito.it
 Alessandra Amendola=alamendola@unisa.it
 Matthias Amen=matthias.amen@web.de
 Carlo Amenta=carlo.amenta@unipa.it
 Oscar Amerighi=oscar.amerighi@enea.it
 John Ameriks=john_ameriks@vanguard.com
 Kevin Amess=kevin.amess@nottingham.ac.uk
 Alessia Amighini=alessia.amighini@eco.unipmn.it
 Lucy Amigo Dobaño=lamigo@uvigo.es
 Jean-Pierre Amigues=amigues@toulouse.inra.fr
 Samir Amine=samir.amine@uqo.ca
 Hanudin Amin=hanudin_zu@yahoo.com
 Mohammad Amin=mamin@worldbank.org
 Bany Ariffin Amin Noordin=bany@putra.upm.edu.my
 Munira Aminova=m_aminova@yahoo.com
 Pooyan Amir Ahmadi=amir@wiwi.uni-frankfurt.de
 Ashkan Amiri=ashkan_amiri2001@yahoo.com
 Rabah AMIR=ramir@eller.arizona.edu
 Emmanuel Bentum Amissah=bentum2002@yahoo.com
 Mary Amiti=mary.amiti@ny.frb.org
 Hans Amman=hans.amman@gmail.com
 Aliyu A. Ammani=aaammani@yahoo.co.uk
 Francesco Amodio=francesco.amodio@upf.edu
 Erica P. Amorim=amorim.erica@gmail.com
 Mourad Ben Amor=ben.amor@usherbrooke.ca
 José Ernesto Amorós Espinosa=eamoros@udd.cl
 Pablo Amoros=pag@uma.es
 Michael Patrick Amos=michael_patrick_amos@hotmail.com
 Fadi Amroush=fadyamr@yahoo.com
 Catalina Amuedo-Dorantes=camuedod@mail.sdsu.edu
 Alberto AMURGO PACHECO=alberto.amurgo@graduateinstitute.ch
 Kafayat Amusa=amusako@unisa.ac.za
 Cosmin Petronel AMZA=cosmin.amza@gmail.com
 Alexis Anagnostopoulos=alexis.anagnostopoulos@stonybrook.edu
 Giovanni Anania=ganania@unical.it
 Alex Anas=alexanas@buffalo.edu
 Anastasios Anastasopoulos=anast3925@yahoo.com
 Titik Anas=titik.anas@csis.or.id
 Stanislav Anatolyev=sanatoly@nes.ru
 Karim Lourdes Anaya=ka272@cam.ac.uk
 Nejat Anbarci=nejat.anbarci@deakin.edu.au
 Draghici Anca=adraghici@eng.upt.ro
 Postole Mirela Anca=anca.postole@yahoo.com
 Kwaw Senyi Andam=andamifpri@gmail.com
 Philipp an de Meulen=philipp.andemeulen@rwi-essen.de
 Rainer Andergassen=rainer.andergassen@unibo.it
 Luisa Anderloni=luisa.anderloni@unimi.it
 Esben Sloth Andersen=esa@business.aau.dk
 Jesper Levring Andersen=jla@foi.ku.dk
 Jørgen Juel Andersen=jorgen.j.andersen@bi.no
 Laura Mørch Andersen=la@foi.ku.dk
 Lykke E. Andersen=landersen@inesad.edu.bo
 Signe Hald Andersen=sha@rff.dk
 Steffen Andersen=sa.eco@cbs.dk
 Torben G. Andersen=t-andersen@northwestern.edu
 Jake Anders=jake@jakeanders.co.uk
 Alistair R. Anderson=a.r.anderson@rgu.ac.uk
 Axel Z. Anderson=aza@georgetown.edu
 Benjamin Anderson=bcanderson@colgate.edu
 Derek Thomas Anderson=dta7dk@virginia.edu
 Edward Anderson=edward.anderson@uea.ac.uk
 Evelyn Leung Anderson=e.anderson@mcauley.acu.edu.au
 Gordon Anderson=anderson@chass.utoronto.ca
 James Anderson=james.anderson.1@bc.edu
 James Horton Anderson=janderson2@worldbank.org
 James L. Anderson=andersonuri@gmail.com
 Jock R. Anderson=jock.r.anderson@gmail.com
 John Andrew Anderson=john.anderson@une.edu.au
 John Edwin Anderson=janderson4@unl.edu
 Katharine A. Anderson=andersok@andrew.cmu.edu
 Kathryn Hart Anderson=kathryn.anderson@vanderbilt.edu
 Kym Anderson=kym.anderson@adelaide.edu.au
 Michael L. Anderson=mlanderson@berkeley.edu
 Richard G. Anderson=rganderson.stl@gmail.com
 Simon Anderson=sa9w@virginia.edu
 Soren T. Anderson=sta@msu.edu
 Claes Andersson=claeand@chalmers.se
 Fredrik Andersson=fredrik.andersson@nek.lu.se
 Fredrik NG Andersson=ngf.andersson@nek.lu.se
 Henrik Andersson=henrik.andersson@tse-fr.eu
 Pernilla Andersson Joona=pernilla.andersson.joona@sofi.su.se
 Martin Andersson=martin.andersson@circle.lu.se
 Sven Anders=sven.anders@ualberta.ca
 Charles H. Anderton=canderto@holycross.edu
 Ascension Andina-Diaz=aandina@uma.es
 Corrado Andini=andini@uma.pt
 Amy Whritenour Ando=amyando@illinois.edu
 David Andolfatto=david.andolfatto@stls.frb.org
 Tahir Raza Shah Andrabi=tandrabi@pomona.edu
 Julian Andrada-Felix=jandrada@dmc.ulpgc.es
 André Luiz Campos de Andrade=alca_rj2002@yahoo.com.br
 Saraly Andrade de Sa=saraly.andrade@env.ethz.ch
 José Baltazar S. Osório Andrade Guerra=baltazar.guerra@unisul.br
 João Sousa Andrade=jasa@fe.uc.pt
 Luiz Flavio Andrade=andrade@irdes.fr
 Philippe Andrade=philippe.andrade@banque-france.fr
 Gustavo Andrade Ramirez=gustavoandrade2@hotmail.com
 Jorge Miguel Andraz=jandraz@ualg.pt
 Christine André=christine.andre@ens.fr
 Christophe André=christophe.andre@oecd.org
 Kai Andree=kandree@uni-potsdam.de
 Anca Andreescu=anca.andreescu@ase.ro
 Tatiana E. Andreeva=andreeva@gsom.pu.ru
 Francisco J. André=andre@ccee.ucm.es
 Dalina Maria Andrei=dalinaandrei@yahoo.com
 Liviu Catalin Andrei=liviucandrei@yahoo.com
 Tudorel Andrei=andreitudorel@yahoo.com
 Daniela Andrén=daniela.andren@oru.se
 Niclas Andrén=niclas.andren@fek.lu.se
 Thomas Andrén=thomas.andren@saco.se
 Patrick Andreoli-Versbach=patrick.andreoliversbach@gmail.com
 James Andreoni=andreoni@ucsd.edu
 Paul E. Andre=andre@essec.fr
 Pierre André=pierre.andre01@polytechnique.org
 Pablo de Andrés Alonso=p.andres@uam.es
 Javier Andrés=javier.andres@uv.es
 K. Philipp Andres=pka24@cam.ac.uk
 Mark Andrew=mark.andrew.1@city.ac.uk
 David Andrews=dandrew1@oswego.edu
 Donald W. K. Andrews=donald.andrews@yale.edu
 Margaret Andrews=mandrews@ers.usda.gov
 Soamiely Andriamananjara=sandriamananjara@worldbank.org
 Svetlana Andrianova=sa153@le.ac.uk
 Alin Marius Andries=alin.andries@uaic.ro
 Natalia Andries=natalia.andries@utu.fi
 Irina Andrievskaya=iandrievskaya@hse.ru
 Andreas Andrikopoulos=apa@aegean.gr
 Athanasios Andrikopoulos=aandriko@cc.uoi.gr
 Panagiotis Andrikopoulos=pandrikopoulos@dmu.ac.uk
 Eirini Andriopoulou=peace@aueb.gr
 Maria Letitia Andronic (bratulescu)=letitia.andronic@unitbv.ro
 Muhammad Anees=anees@aneconomist.com
 Vincent Anesi=vincent.anesi@nottingham.ac.uk
 Alvin P. Ang=angalvinp@gmail.com
 Andrew Ang=aa610@columbia.edu
 Luis Angeles=luis.angeles@glasgow.ac.uk
 George-Marios Angeletos=marios.angeletos@uzh.ch
 Timotheos Angelidis=tangel@uop.gr
 Paolo Angelini=paolo.angelini@bancaditalia.it
 Viola Angelini=v.angelini@rug.nl
 James Angel=angelj@georgetown.edu
 Ignazio Angeloni=ignazio.angeloni@ecb.int
 Konstantinos Angelopoulos=k.angelopoulos@lbss.gla.ac.uk
 Eleni Angelopoulou=eangelopoulou@bankofgreece.gr
 Vera Angelova=vera.angelova@tu-berlin.de
 Nikolay Angelov=nikolay.angelov@ifau.uu.se
 Manuela Angelucci=mangeluc@umich.edu
 Silke Anger=silke.anger@iab.de
 Silvia Angilella=angisil@unict.it
 Deniz Anginer=danginer@worldbank.org
 James B. Ang=james.ang@ntu.edu.sg
 Apanard Penny Angkinand Prabha=pprabha@milkeninstitute.org
 John Angle=angle@inequalityprocess.org
 Erik Angner=eangner@gmu.edu
 Alain Étté Angora=angotela@yahoo.fr
 Joshua Angrist=angrist@mit.edu
 Ana B. Ania=ana-begona.ania-martinez@univie.ac.at
 Vasiliy Aleksandrovich Anikin=vasiliy.anikin@gmail.com
 Fernando Anjos=fernando.anjos@mccombs.utexas.edu
 Abedullah Anjum=abedullah@yahoo.com
 Lian An=lan3@uky.edu
 Mark Y An=mark_y_an@fanniemae.com
 Nabil Annabi=nabilannabi@hotmail.com
 Kurt Annen=annen@web-reg.de
 Barbara Annicchiarico=barbara.annicchiarico@uniroma2.it
 Samuel Kobina Annim=skannim@gmail.com
 Emmanuel Anoruo=eanoruo@coppin.edu
 Paloma Anos-Casero=panoscasero@worldbank.org
 Kuhanathan Ano Sujithan=kuhanathan.ano-sujithan@dauphine.fr
 Abdel Latef Majed Anouze=aamajed2001@hotmail.com
 Gian Paolo Ansaloni=gpansaloni@gmail.com
 Shahriar Ansari Chaharsoughi=shansari4@gmail.com
 Jugnu Ansari=jansari@rbi.org.in
 Luc Anselin=luc.anselin@asu.edu
 Erik Ansink=erikansink@gmail.com
 José Anson=jose.anson@upu.int
 Heather Antecol=heather.antecol@claremontmckenna.edu
 Manel Antelo=manel.antelo@usc.es
 David Anthoff=anthoff@berkeley.edu
 Alessandro Antimiani=antimiani@inea.it
 Gaetano Antinolfi=gaetano@artsci.wustl.edu
 Pamfili Antipa=pamfili.antipa@banque-france.fr
 Evgeny Antipov=eugene.antipov@gmail.com
 John M. Antle=john.antle@oregonstate.edu
 Bertille Antoine=bertille_antoine@sfu.ca
 Pablo Antolin=pablo.antolin@oecd.org
 Cristiano Antonelli=cristiano.antonelli@unito.it
 Daniela Antonescu=daniela.antonescu25@gmail.com
 Mihail Antonescu=mihail.antonescu.dj@mfinante.ro
 Elena Antoniadou=antoniadou@ozemail.com.au
 Roberto Antonietti=roberto.antonietti@unipd.it
 Manfred Antoni=manfred.antoni@iab.de
 Davide Antonioli=ntndvd@unife.it
 Alberto Antonioni=alberto.antonioni@unil.ch
 Fabio Antoniou=fabio.antoniou@wiwi.hu-berlin.de
 James J. Anton=james.anton@duke.edu
 José Ignacio Antón=janton@usal.es
 Christos Antonopoulos=canton@mnec.gr
 Rania Antonopoulos=rania@levy.org
 Kate L. Antonovics=kantonov@ucsd.edu
 Arturo Antón-Sarabia=arturo.anton@cide.edu
 Sorin Gabriel Anton=sorin.anton@uaic.ro
 Ari-Veikko Anttiroiko=kuaran@uta.fi
 António Antunes=antunesaa@gmail.com
 Daví José Nardy Antunes=davinardyantunes@gmail.com
 Werner Antweiler=werner@sauder.ubc.ca
 Angelos Adonis Antzoulatos=antzoul@unipi.gr
 Mikhail Anufriev=mikhail.anufriev@uts.edu.au
 S Anukriti=anukriti@bc.edu
 Andre K. Anundsen=andre-kallak.anundsen@norges-bank.no
 Ahmed W. Anwar=ahmed.anwar@ed.ac.uk
 Amar Iqbal Anwar=amar.iqbal.anwar@gmail.com
 Muhammad Anwar=anwar258@gmail.com
 Mumtaz Anwar=mumtaz.anwar@pu.edu.pk
 Saba Anwar=saba@pide.org.pk
 Sajid Anwar=sanwar@usc.edu.au
 Sofia Anwar=sofia_ageconomist@yahoo.com
 John C. Anyanwu=j.anyanwu@afdb.org
 Zhiyong An=anzy2008@gmail.com
 Marcela Anzola=manzola@gmail.com
 Alessio Anzuini=alessio.anzuini@gmail.com
 Masanao Aoki=aoki@econ.ucla.edu
 Shuhei Aoki=shuhei.aoki@gmail.com
 Amal Aouadi=amel.el_aouadi@udamail.fr
 Zaier Aouani=zaier.aouani@nu.edu.kz
 Ainhoa Aparicio=ainhoa.aparicio@carloalberto.org
 Francisco Javier Aparicio=javier.aparicio@cide.edu
 Mª. Gloria Aparicio (M. Gloria Aparicio,)=gloria.aparicio@ehu.es
 Sebastian Aparicio=aparicio.s@gmail.com
 Roberta Apa=roberta.apa1@gmail.com
 Ignacio Apella=ignacioa@cedes.org
 Nicholas Apergis=napergis@unipi.gr
 Jose Apesteguia=jose.apesteguia@upf.edu
 Jeffrey Apland=japland@umn.edu
 Diana Apostol=altai78@yahoo.com
 Alexander Apostolides=alexapostolides@gmail.com
 Mico Apostolov=mico.apostolov@sssup.it
 Bénédicte H. Apouey=benedicte.apouey@psemail.eu
 David Cole Appels=dave.appels@frontier-economics.com
 Gildas Appéré=gildas.appere@free.fr
 Francesco Paolo Appio=f.appio@sssup.it
 John Appleby=j.appleby@kingsfund.org.uk
 Andrea APPOLLONI=andrea.appolloni@uniroma2.it
 Patricia Frances Apps=patricia.apps@sydney.edu.au
 Rodolfo Apreda=ra@cema.edu.ar
 Tommaso Aquilante=tommaso.aquilante@ulb.ac.be
 Araar Abdelkrim=aabd@ecn.ulaval.ca
 Reza (Gholamreza) Arabsheibani=g.arabsheibani@swansea.ac.uk
 Ayşen Araç=aysens@hacettepe.edu.tr
 Giampaolo Arachi=giampaolo.arachi@unisalento.it
 M. Jose Aracil=maracil1@us.es
 Satheesh Aradhyula=satheesh@ag.arizona.edu
 Andres Aradillas-Lopez=aaradill@ssc.wisc.edu
 Enriqueta Aragones=enriqueta.aragones@iae.csic.es
 Fernando Martín Aragón Sánchez=faragons@sfu.ca
 Gisella Aragón=aragon_gs@up.edu.pe
 Koki Arai=koki_arai@jftc.go.jp
 Mahmood Arai=mahmood.arai@ne.su.se
 Amjad Ali Arain=amjad.arain@yahoo.com
 Real Arai=real@hiroshima-u.ac.jp
 Miguel Aramendia=miguel.aramendia@ehu.es
 Jorge E. Arana=jarana@daea.ulpgc.es
 Rodrigo F. Aranda=rodrigo.aranda@usach.cl
 Carlos A. Arango=carango1@yahoo.com
 Mauricio Arango=marangoisa@gmail.com
 Luis Eduardo Arango Thomas=larangth@banrep.gov.co
 Meltem A. Aran=meltem.aran@developmentanalytics.org
 Catherine Araujo Bonjean=c.araujo-bonjean@u-clermont1.fr
 Claudio Araujo=claudio.araujo@udamail.fr
 Sergio René Araujo Enciso=araujo.enciso@gmail.com
 Eurilton Araújo=eurilton@gmail.com
 Gustavo Silva Araujo=gustavo.araujo@bcb.gov.br
 Luis Araujo=araujolu@msu.edu
 Luiz Alberto D´Ávila de Araújo (Luiz Alberto DAvila de Araujo)=davila@bb.com.br
 Ricardo Azevedo Araujo=rsaaraujo@unb.br
 Sonia Araujo=sonia.araujo@oecd.org
 Tanya Vianna de Araújo=tanya@iseg.utl.pt
 Josep-Maria Arauzo-Carod=josepmaria.arauzo@urv.cat
 Damilola Felix Arawomo=damfelara@yahoo.com
 Ivan Araya=iaraya@udec.cl
 Henry Aray=haray@ugr.es
 Jorge Arbache=jarbache@gmail.com
 Emrah Arbak=emrah.arbak@nbb.be
 Cemal Eren Arbatli=earbatli@gmail.com
 Elif Ceren Arbatli=earbatli@imf.org
 Maria Arbatskaya=marbats@emory.edu
 Marcelo Aarestrup Arbex=arbex@uwindsor.ca
 Muhammad Farooq Arby=farooq.arby@sbp.org.pk
 Calin Arcalean=calin.arcalean@esade.edu
 Jean-Louis Leslie Arcand=jean-louis.arcand@graduateinstitute.ch
 Manuela Arcanjo=marcanjo@iseg.utl.pt
 Eva O. Arceo-Gomez=eva.arceo@cide.edu
 Oscar Arce=o.arce@bde.es
 Edith Jeanne Archambault=archamb@univ-paris1.fr
 Liza Archanskaia=archanskaia@gmail.com
 David Archer=david.archer@bis.org
 Eugenio Archontopoulos=earchontopoulos@gmail.com
 Andres Mauricio Arcila=amarcila@icesi.edu.co
 Angel Arcos=aarcos@esi.us.es
 davide arduini, Sr.=darduini@alice.it
 Remo Arduini=remo.arduini@unimi.it
 Tiziano Arduini=tiziano.arduini@uniroma1.it
 Francisco Jose Areal=f.j.areal@reading.ac.uk
 Nikolay Arefiev=nicolay_arefiev@yahoo.com
 F. Alfonso Arellano=alfonso.arellano@gmail.com
 Manuel Arellano=arellano@cemfi.es
 Paúl Arenas=parenasr@outlook.com
 Piotr Arendarski=parendarski@wne.uw.edu.pl
 Mario Arend=arendser@bc.edu
 Mary Paula Arends-Kuenning=marends@illinois.edu
 Jacob Nielsen Arendt=jacn@kora.dk
 Stefan Arent=arent@ifo.de
 Waldyr Dutra Areosa=waldyr.dutra@bcb.gov.br
 Bismarck Javier Arevilca Vasquez=bismarck_arevilc@hotmail.com
 Rabah Arezki=rarezki@imf.org
 Maria Felice Arezzo=mariafelice.arezzo@uniroma1.it
 Antonio Argandona=argandona@iese.edu
 Elena Argentesi=elena.argentesi@unibo.it
 Amedeo Argentiero=amedeo.argentiero@unipg.it
 Nicolae Razvan ARGESANU=argesanur@yahoo.com
 Michael Arghyrou=arghyroum@cardiff.ac.uk
 Carmen Arguedas=carmen.arguedas@uam.es
 Ricardo Arguello=arguello.ricardo@gmail.com
 Ali ARI=ali.ari@kirklareli.edu.tr
 Mauricio Arias=mariasji@gmail.com
 Xosé Carlos Arias Moreira=xcarias@uvigo.es
 Feyza ARICA=feyzarica@gmail.com
 Fabio R. Aricò=f.arico@uea.ac.uk
 Babur Wasim Arif=baburwasim@yahoo.com
 Mohamed Ariff=ariff13@gmail.com
 Mohamed Ariff=mohdariff19@gmail.com
 Ghulam Mohammad Arif=gmarif@pide.org.pk
 Jasmina Arifovic=arifovic@sfu.ca
 Shahnaz Akhtar Arifullah=shahnazarifullah@aup.edu.pk
 Umaima Arif=umaima.arif@gmail.com
 Murat Arik=marik@mtsu.edu
 Ilker Murat AR=ilkerar@ktu.edu.tr
 Arimura, Toshihide=toshi.arimura@gmail.com
 Javier Arin=franciscojavier.arin@ehu.es
 K Peren Arin=kerim.arin@zu.ac.ae
 Juan Carlos Arismendi Zambrano=jarismen@hotmail.com
 Yakup Eser ARISOY=eser.arisoy@dauphine.fr
 David Aristei=daristei@stat.unipg.it
 Oihana Aristondo=oihana.aristondo@ehu.es
 Adiwan F. Aritenang=a.aritenang@gmail.com
 Akira Ariyoshi=aariyoshi@ics.hit-u.ac.jp
 Alfredo Ariza=alfredoariza@upo.es
 Francisco Arizala=farizala@gmail.com
 Evren Arık=evren.arik@borsaistanbul.com
 Hal Richard Arkes=arkes.1@osu.edu
 Aleksandra Arkit=a.arkit@wmie.uz.zgora.pl
 Costas Arkolakis=costas.arkolakis@yale.edu
 Stephen Armah=armah.stephen@gmail.com
 Dan Armeanu=darmeanu@yahoo.com
 Beatriz Armendáriz=b.armendariz@ucl.ac.uk
 Roc Armenter=roc.armenter@phil.frb.org
 Alex Armstrong=armstronga@econ.queensu.ca
 J. Scott Armstrong=armstrong@wharton.upenn.edu
 Mark Armstrong=mark.armstrong@economics.ox.ac.uk
 Paula Louise Armstrong=paula.louise.armstrong84@gmail.com
 Shiro Patrick Armstrong=shiro.armstrong@anu.edu.au
 Channing Arndt=channing@wider.unu.edu
 Sven Arndt=lowe@claremontmckenna.edu
 Patrick P. Arni=arni@iza.org
 Erik Arnold=erik.arnold@technopolis-group.com
 Ivo Arnold=i.arnold@nyenrode.nl
 Jeffrey Bernard Arnold=jeffrey.arnold@gmail.com
 Jens Matthias Arnold=jens.arnold@oecd.org
 Lutz Georg Arnold=lutz.arnold@wiwi.uni-regensburg.de
 Marc Arnold=marc.arnold@unisg.ch
 Michael A. Arnold=marnold@udel.edu
 Marco Arnone=marco.arnone@gmail.com
 Richard Arnott=richard.arnott@ucr.edu
 Melanie Arntz=arntz@zew.de
 Patricio Aroca=patricio.aroca@uai.cl
 Fidel Aroche Reyes=aroche@unam.mx
 Janine Aron=janine.aron@economics.ox.ac.uk
 Ankit Arora=ankitarora@hush.com
 Ashish Arora=ashish.arora@duke.edu
 Saurabh Arora=s.arora@tue.nl
 Vipin Arora=arora.vk13@gmail.com
 Mohamed El Hedi AROURI=mohamed.arouri@u-clermont1.fr
 Leandro Arozamena=larozamena@utdt.edu
 Alfonso Arpaia=alfonso.arpaia@ec.europa.eu
 Bruno Arpino=bruno.arpino@upf.edu
 Jose Maria Arranz=josem.arranz@uah.es
 Gerardo Arregui-Ayastuy=gerardo.arregui@ehu.es
 Patricia Arregui=arregui@grade.org.pe
 Rodrigo Antonio Arriagada Cisternas=rarriagadac@uc.cl
 Iván Arribas=ivan.arribas@ivie.es
 Alessandro Arrighetti=alessandro.arrighetti@unipr.it
 Anu Kovarikova Arro=anu.arro@cerge-ei.cz
 Luc Arrondel=arrondel@pse.ens.fr
 Leticia Arroyo Abad=larroyoabad@middlebury.edu
 Martín Ricardo Arroyo=martinricardoarroyo@gmail.com
 Santiago Arroyo=jarroyo@javerianacali.edu.co
 Benito Arruñada=benito.arrunada@upf.edu
 Hossein Arsham=harsham@ubalt.edu
 Ali Arslan=cimderaslan@hotmail.com
 M. Oguz Arslan=moarslan@anadolu.edu.tr
 Yavuz Arslan=yavuz.arslan@tcmb.gov.tr
 Elsa Artadi=elsa.artadi@gmail.com
 Daniel Artana=daniel@fiel.org.ar
 Seyfettin Artan=seyfettinartan@gmail.com
 Carolina Arteaga Cabrales=caro_artc@hotmail.com
 Julio Cesar Arteaga=julio.arteagagr@uanl.edu.mx
 Carlos O. Arteta=carlos.o.arteta@frb.gov
 Rogério Arthmar=arthmar.vix@gmail.com
 Miguel Artiach=miguelartiach@ua.es
 Panagiotis Artikis=partikis@unipi.gr
 Manuel Artís=manuel.artis@ub.edu
 Michael John Artis=michael.artis@manchester.ac.uk
 Iñaki Arto=inaki.arto@bc3research.org
 Philippe Artzner=artzner@math.u-strasbg.fr
 Marc Artzrouni=marc.artzrouni@univ-pau.fr
 Wiji Arulampalam=wiji.arulampalam@warwick.ac.uk
 Raj Arunachalam=arunacha@umich.edu
 Mothkuri Aruna=maruna@icfaiuniversity.org
 Thankom Arun=tgarun@uclan.ac.uk
 S. Boragan Aruoba=aruoba@econ.umd.edu
 Rigas Arvanitis=rigas@option-service.fr
 Paulo Roberto Arvate=paulo.arvate@fgv.br
 Mak Arvin=marvin@trentu.ca
 Anil Arya=arya@cob.osu.edu
 Gaurab Aryal=aryalg@uchicago.edu
 Nasser Ary Tanimoune=nasser.arytanimoune@uottawa.ca
 Camila Arza=camilaarza@hotmail.com
 Mohammad Arzaghi=marzaghi@aus.edu
 Francisco Javier Arze del Granado=farzedelgranado@imf.org
 Kai Arzheimer=kai.arzheimer@googlemail.com
 Mohammad Niaz Asadullah=m.asadullah@reading.ac.uk
 John Asafu-Adjaye=j.asafuadjaye@uq.edu.au
 Muhammad Asali=muhammad.asali@gmail.com
 Gordon Newlove Asamoah=gasamoahn@yahoo.com
 Goksel Asan=goksel.asan@bilgi.edu.tr
 Carlos J. Asarta=asarta@udel.edu
 Erik Åsberg=erik.asberg@ihh.hj.se
 Guido Ascari=guido.ascari@unipv.it
 David Aschauer=daschaue@bates.edu
 Frank Asche=frank.asche@uis.no
 Aurora Ascione=aurora.ascione@cc.gsi.gov.uk
 Serhat Asci=sasci@ufl.edu
 Jorge Gabriel Aseff=jorge.aseff@gmail.com
 Javier Asensio=javier.asensio@uab.es
 Kwadwo Asenso-okyere=k.asenso-okyere@cgiar.org
 Vincenzo Asero=vasero@unict.it
 Samuel G. Asfaha=samuelasfaha@hotmail.com
 Dr. Zahid Asghar=g.zahid@gmail.com
 Olumuyiwa Ashaolu=oluashaolu2000@gmail.com
 Nathan J. Ashby=njashby@utep.edu
 Adam B. Ashcraft=adam.ashcraft@ny.frb.org
 Geir B. Asheim=g.b.asheim@econ.uio.no
 Orley Ashenfelter=c6789@princeton.edu
 Masahiro Ashiya=ashiya@econ.kobe-u.ac.jp
 Richard Ashley=ashleyr@vt.edu
 Damoun Ashournia=damoun.ashournia@economics.ox.ac.uk
 Afsheen Ashraf=afsheen_lmis@hotmail.com
 Mohammad Ashraf=ashraf@uncp.edu
 Quamrul Ashraf=quamrul.h.ashraf@williams.edu
 Arvind Ashta=arvind.ashta@escdijon.eu
 Mamak Ashtari=ashtarim@yahoo.com
 john k. Ashton=j.ashton@bangor.ac.uk
 Ahmet Atil Asici=asici@itu.edu.tr
 Rozilee Asid=rozilee@ums.edu.my
 Chowdhury Abdullah Al Asif=asifchowdhury7872@gmail.com
 Ioannis Asimakopoulos=iasimakopoulos@bankofgreece.gr
 Stylianos Asimakopoulos=s.asimakopoulos.1@research.gla.ac.uk
 Jebaraj Asirvatham=ajebaraj@gmail.com
 Hossein Askari=askari@gwu.edu
 Philippe Askenazy=philippe.askenazy@ens.fr
 John Asker=jasker@stern.nyu.edu
 Nikos Askitas=askitas@iza.org
 Aqib Aslam=aaslam@imf.org
 Monazza Aslam=monazza.aslam@wolfson.oxon.org
 Muhammad Amir Aslam=amir_aslam22@yahoo.com
 Muhammad Shakeel Aslam=aslam.shakeel@gmail.com
 Nektarios Aslanidis=nektarios.aslanidis@urv.cat
 Heidi Wiig Aslesen=heidi.w.aslesen@bi.no
 Raies Asma=asma.raies@malix.univ-paris1.fr
 Roberto Carlos Asmat=robertocarlos.ab@gmail.com
 Esmaeil Asnavandi=asnavandi@gmail.com
 Simplice Anutechia Asongu=asongus@afridev.org
 Andrea Asoni=asoni@uchicago.edu
 Tamon Asonuma=tasonuma@imf.org
 Asrafuzzaman=asrafrobin@gmail.com
 Bengt Assarsson=bengt.assarsson@nek.uu.se
 Katrin Assenmacher=katrin.assenmacher@snb.ch
 Andreas Assiotis=assiotis.andreas@ucy.ac.cy
 Pier Francesco Asso=francesco.asso@unipa.it
 Dimitrios Asteriou=d.a.asteriou@eap.gr
 Roberto Astolfi=roberto.astolfi@oecd.org
 Pablo Astorga=pastorga1@googlemail.com
 Nikos Astroulakis=astroulakis@econ.soc.uoc.gr
 Vasily I. Astrov=astrov@wiiw.ac.at
 Alfonso A. Astudillo=alf_a@mit.edu
 Carolina Asuaga=casuaga@ccee.edu.uy
 Aslihan Atabek=aslihan.atabek@tcmb.gov.tr
 Alp E. Atakan=aatakan@ku.edu.tr
 Gamal Atallah=gamal.atallah@uottawa.ca
 Samer Atallah=satallah@aucegypt.edu
 Aziz Atamanov=aatamanov@worldbank.org
 H Nur Ata Nurcan=nur.ata@economics.ox.ac.uk
 Hilal Atasoy=hilal.atasoy@temple.edu
 Atabek Atayev=atabek.ataev@gmail.com
 Victoria M. Ateca-Amestoy=victoriamaria.ateca@ehu.es
 Vincenzo Atella=atella@uniroma2.it
 George Athanasiou=athansgeo@gmail.com
 Panayiotis P. Athanasoglou=ppathanasoglou@gmail.com
 George Athanasopoulos=george.athanasopoulos@monash.edu
 Paul Atherton=p.atherton@ioe.ac.uk
 Susan Athey=athey@stanford.edu
 Laure Athias=laure.athias@idheap.unil.ch
 Kartik Athreya=kartik.athreya@rich.frb.org
 Suma Athreye=suma.athreye@brunel.ac.uk
 Prema-chandra Athukorala=prema-chandra.athukorala@anu.edu.au
 Miguel Atienza=miatien@ucn.cl
 Syed Muhammad Atif=bukhari.aatif@gmail.com
 Amir Atiya=amir@alumni.caltech.edu
 David Guy Atkin=davidgatkin@gmail.com
 Frank J. Atkins=atkins@ucalgary.ca
 Robert D. Atkinson=ratkinson@itif.org
 Mark Atlas=mka_envtl@verizon.net
 Manoj Atolia=matolia@fsu.edu
 Joseph Atta-Mensah=jattamensah@uneca.org
 Giuseppe Attanasi=attanasi@unistra.fr
 Orazio Attanasio=o.attanasio@ucl.ac.uk
 M. Aykut Attar=maattar@hacettepe.edu.tr
 Witsanu Attavanich=attavanich.witsanu@gmail.com
 Oguz Atuk=oguz.atuk@tcmb.gov.tr
 Gianfranco Enrico Atzeni=atzeni@uniss.it
 Antoine Auberger=antoine.auberger@u-paris2.fr
 Cécile AUBERT=cecile.aubert@u-bordeaux4.fr
 Clémence Aubert=caubert@esg.fr
 Magali Aubert=aubert@supagro.inra.fr
 Nicolas Stephane Aubert=naubert@univ-tln.fr
 Patrick Aubert=patrick.aubert@m4x.org
 Miguel St. Aubyn=mstaubyn@iseg.utl.pt
 Sabrina Auci=sabrina.auci@unipa.it
 Henri Audigé=henri.audige@gmail.com
 David B. Audretsch=daudrets@indiana.edu
 Francesco Audrino=francesco.audrino@unisg.ch
 Raphael Auer=raphael.auer@snb.ch
 Simone Auer=simone.auer@snb.ch
 Heike Auerswald=heike.auerswald@tu-dresden.de
 Wolfgang Auer=auer@ifo.de
 Emmanuelle Augeraud-Véron=eaugerau@univ-lr.fr
 Jean-François Auger=auger.jean-francois@uqam.ca
 Peter Augsdorfer=peter.augsdorfer@fh-ingolstadt.de
 Boris Augurzky=augurzky@rwi-essen.de
 Sebastian Auguste=sauguste@utdt.edu
 Paweł Augustynowicz=pawel.augustynowicz@gmail.com
 M. Christopher Auld=auld@uvic.ca
 Pirkko Aulin-Ahmavaara=aulin@nettilinja.fi
 Saku Aura=auras@missouri.edu
 Plopeanu P. Aurelian=aplopeanu@gmail.com
 Selena Aureli=selena.aureli@unibo.it
 Emmanuelle Auriol=emmanuelle.auriol@tse-fr.eu
 Nils aus dem Moore=nils.ausdemmoore@rwi-essen.de
 Marcel Ausloos=marcel.ausloos@ulg.ac.be
 Siobhan Austen=siobhan.austen@cbs.curtin.edu.au
 D. Andrew Austin=austin.andrew@gmail.com
 David H. Austin=david.austin@cbo.gov
 Ole Gunnar Austvik=ole.gunnar.austvik@kaldor.no
 David Autor=dautor@mit.edu
 Tristan Auvray=tristan.auvray@univ-paris13.fr
 Anamaria Avadanei=anamaria_avadanei86@yahoo.com
 Marcos Ávalos Bracho=marcos.avalos@uia.mx
 Eloy Eduardo Ávalos Alvarado=eavalosa@unmsm.edu.pe
 Fernando Hugo Avalos=fernando.avalos@bis.org
 Marco Avarucci=marco.avarucci@glasgow.ac.uk
 Matej Avbelj=matej_avbelj@yahoo.com
 Emin AVCI=eavci@marmara.edu.tr
 Svetlana Avdasheva=avdash@hse.ru
 Daniel Avdic=daniel.avdic@uni-due.de
 Stefan Avdjiev=stefan.avdjiev@bis.org
 Krenar Avdulaj=ies.avdulaj@gmail.com
 George Avelino F.=george.avelino@fgv.br
 Campo Alcides Avellaneda Bautista=campoa.avellanedab@unilibrebog.edu.co
 Ana Paula Macedo de Avellar=anaavellar@ie.ufu.br
 Natasha Avendaño=n_avenda@yahoo.com
 Rolando Avendano=rolando.avendano@oecd.org
 Eric Avenel=eric.avenel@univ-rennes1.fr
 Susan L. Averett=averetts@lafayette.edu
 Oscar Ivan Avila Montealegre=oscar.avila03@gmail.com
 Maria Victoria Aviles Blanco=mvaviles@upo.es
 Arieh Avishur=avishur@bgumail.bgu.ac.il
 Tiberiu Cristian Avramescu=cristiavr@yahoo.com
 Vasile Avram=vasileavram@gmail.com
 Alina Florentina Avrigeanu=alina.avrigeanu@gmail.com
 Rojhat Berdan Avsar=ravsar@colum.edu
 Veysel Avsar=veysel.avsar@antalya.edu.tr
 Ashar Awan=asharawan786@hotmail.com
 Masood Sarwar Awan=awan811@hotmail.com
 Wasim Abbas Awan=wasimabbasawan@gmail.com
 Ahmed Mohammed Awel=ahmi2008@gmail.com
 Titus O. Awokuse=kuse@udel.edu
 Olalekan Bashir Aworinde=aworindeob@tasued.edu.ng
 Achraf AYADI=achraf.ayadi@int-evry.fr
 Nesrine Ayadi=nesrineayadi@laposte.net
 Rym Ayadi=rym.ayadi@ceps.be
 Astrid Loretta Ayala=aayala@ufm.edu
 Alfonso Leonel Ayala Loro=aayalaloro@yahoo.com
 Luis Ayala=luis.ayala@urjc.es
 Roberto Ayala=rayala5@yahoo.com
 Abdurrahman Aydemir=aaydemir@sabanciuniv.edu
 Burcu Aydin=baydin@imf.org
 Nursel Aydiner-Avsar=nursel.aydiner@gediz.edu.tr
 Faruk Aydın=faruk.aydin@tcmb.gov.tr
 N. Emrah Aydinonat=aydinonat@gmail.com
 Suat Aydin=suat.aydin@yahoo.com.tr
 Neslihan Aydogan=aydogan@cankaya.edu.tr
 Elçin Aykaç Alp=aykace@gmail.com
 Dilek Aykut=daykut@worldbank.org
 Jonathan Aylen=j.aylen@manchester.ac.uk
 Roy Ayllón=roy.ayllon@bcrp.gob.pe
 Sara Ayllón=sara.ayllon@udg.edu
 Melvin Ayogu=melvin@ayogu.com
 Alain Ayong Le Kama=alain.ayonglekama@u-paris10.fr
 Ian Ayres=ian.ayres@yale.edu
 Ahmet Faruk Aysan=ahmetfarukaysan@gmail.com
 Cevriye Aysoy=cevriye.aysoy@tcmb.gov.tr
 Uluc Aysun=uaysun@bus.ucf.edu
 R. Emre Aytimur=raytimu@uni-goettingen.de
 María-Isabel Ayuda=mayuda@unizar.es
 Meghana Ayyagari=ayyagari@gwu.edu
 Padmaja Ayyagari=padmaja-ayyagari@uiowa.edu
 Pablo Azabache La Torre=pazabache@bcp.com.pe
 Helmuts Azacis=azacish@cf.ac.uk
 Rohit Azad=rohit@jnu.ac.in
 M. Azali=azali@putra.upm.edu.my
 Md Shafiul Azam=msa1@aber.ac.uk
 Mehtabul Azam=mehtabazam@gmail.com
 Costas Azariadis=azariadi@wustl.edu
 Jose Azar=jazar@crai.com
 Leonid V. Azarnert=leonid.azarnert@gmail.com
 Ofer H. Azar=azar@som.bgu.ac.il
 Celine Azemar=c.azemar@lbss.gla.ac.uk
 Christopher Dean Azevedo=cazevedo@ucmo.edu
 Cyntia Freitas Azevedo=cyntia.azevedo@bcb.gov.br
 Eduardo M. Azevedo=eazevedo@wharton.upenn.edu
 Hugo Daniel Azevedo=hazevedo@santander.com.br
 João Pedro Azevedo=jazevedo@worldbank.org
 Paulo Furquim de Azevedo=paulo.azevedo@fgv.br
 Susana Garrido Azevedo=sazevedo@ubi.pt
 AKM Azhar=azhar.akm.upm@gmail.com
 Rauf Ahmed Azhar=raufazhar@yahoo.com
 Meshach Jesse Aziakpono=meshach.aziakpono@usb.ac.za
 Toseef Azid=toseef.azid@mihe.org.uk
 Iwan Azis=ija1@cornell.edu
 Farooq Aziz=drfaziz@yahoo.com
 Haris Aziz=haris.aziz@nicta.com.au
 W.N.W Azman-Saini=wazman@putra.upm.edu.my
 Ghazala Azmat=g.azmat@qmul.ac.uk
 MOHAMED ALI AZOUZI, Sr.=mohamed_azouzi@yahoo.fr
 Diego Azqueta=diego.azqueta@uah.es
 Oliver Azuara=oazuara@uchicago.edu
 Jose Ignacio Azuela Flores=jazuelaflores@gmail.com
 Rodrigo Azuero=rodazuero@gmail.com
 Sana AZZABI=azzabisana@yahoo.fr
 Carlo Azzarri=c.azzarri@cgiar.org
 Marina Azzimonti=marina.azzimonti@gmail.com
 Ivano Azzini=ivano.azzini@jrc.it
