 David Eagle=deagle@ewu.edu
 Raul Eamets=raul.eamets@ut.ee
 John Earle=earle@gmu.edu
 Peter E. Earl=p.earl@economics.uq.edu.au
 Sophal Ear=sophal@alumni.princeton.edu
 David Easley=dae3@cornell.edu
 William Easterly=william.easterly@nyu.edu
 B. Curtis Eaton=eaton@ucalgary.ca
 Derek Eaton=djf.eaton@gmail.com
 Jonathan Eaton=jonathan_eaton@brown.edu
 Christian Hubert Ebeke=cebeke@imf.org
 Michael Wilhelm Ebeling=michaelebeling@t-online.de
 Monique Ebell=ebell@wiwi.hu-berlin.de
 Nikos Ebel=nikosebel@gmx.de
 Robert D. Ebel=robertebel@gmail.com
 Juan Eberhard=juan.eberhard@marshall.usc.edu
 Markus Eberhardt=markus.eberhardt@nottingham.ac.uk
 Jakob Eberl=jakob.eberl@lmu.de
 Janice Eberly=eberly@kellogg.northwestern.edu
 Nicolas EBER=nicolas.eber@unistra.fr
 Randall Eberts=eberts@upjohninstitute.org
 Udo Ebert=ebert@uni-oldenburg.de
 André Ebner=andre.ebner@lrz.uni-muenchen.de
 Mehran Ebrahimi=mehran@sri.utoronto.ca
 M. Shahid Ebrahim=m.s.ebrahim@bangor.ac.uk
 Giulio Ecchia=giulio.ecchia@unibo.it
 Sencer Ecer=ecer@itu.edu.tr
 Juan José Echavarría=jechavso@gmail.com
 Rebeca Aguinaga Echávarri=rebeca.echavarri@unavarra.es
 Luciana Echazu=lechazu@clarkson.edu
 Federico Echenique=fede@hss.caltech.edu
 Cruz Echevarría=cruz.echevarria@ehu.es
 Damien Échevin=damien.echevin@usherbrooke.ca
 John C. Eckalbar=jeckalbar@csuchico.edu
 E. Woodrow Eckard=woody.eckard@ucdenver.edu
 Martina Eckardt=martina.eckardt@andrassyuni.hu
 Espen Eckbo=b.espen.eckbo@dartmouth.edu
 Carsten Eckel=carsten.eckel@lmu.de
 Catherine C Eckel=ceckel@econmail.tamu.edu
 Paul Eckerstorfer=paul.eckerstorfer@jku.at
 Daniel Eckert=daniel.eckert@uni-graz.at
 Verena Eckl=verena.eckl@stifterverband.de
 Zvi Eckstein=zeckstein@idc.ac.il
 Anastasios A. Economides=economid@uom.gr
 George Economides=gecon@aueb.gr
 Nicholas S. Economides=economides@stern.nyu.edu
 Claire Economidou=economidou@unipi.gr
 Athina Vissarion Economou=aeconomou@econ.uth.gr
 Emmanouil-Marios-Lazaros Economou=emmoikon@uth.gr
 Fotini Economou=feconom@unipi.gr
 Ezry Fahmy Eddy Yusof=ezryfahmy@yahoo.com
 Benjamin Eden=ben.eden@vanderbilt.edu
 Ottmar Edenhofer=ottmar.edenhofer@pik-potsdam.de
 Lorraine Eden=leden@tamu.edu
 Maya Eden=meden@worldbank.org
 Armin Eder=armin.eder@student.uibk.ac.at
 Josh Ederington=ederington@uky.edu
 Sjef Ederveen=s.ederveen@minez.nl
 Castillo Huerta Edgar=ecastillo@cmasch.com
 Rochelle Edge=rochelle.m.edge@frb.gov
 David Edgerton=david.edgerton@nek.lu.se
 Rosemarie Edillon=rgedillon@neda.gov.ph
 Per-Anders Edin=per-anders.edin@nek.uu.se
 Piyadasa Edirisuriya=piyadasa.edirisuriya@monash.edu
 Hali Edison=hedison@imf.org
 Aaron Edlin=edlin@econ.berkeley.edu
 Lena Edlund=le93@columbia.edu
 Alex Edmans=aedmans@wharton.upenn.edu
 Karin Edmark=karin.edmark@ifn.se
 Kelly Dane Edmiston=kelly.edmiston@kc.frb.org
 Chris Edmond=cedmond@unimelb.edu.au
 Eric Edmonds=eedmonds@dartmouth.edu
 William Ewell Edmondson, Jr.=wedmonds@ers.usda.gov
 Valentin Edo Hernandez=vedohern@ucm.es
 Cyriaque EDON=cyriaque.edon@gmail.com
 Harald Edquist=harald.edquist@fores.se
 Dinu Eduard=dinueduard@netscape.net
 Tudor Edu=tudoredu@yahoo.com
 Finley Edwards=finleyedwards@gmail.com
 John H. Y. Edwards=tulanejohnedwards@yahoo.com
 Lawrence Edwards=lawrence.edwards@uct.ac.za
 Rebecca Edwards=rebecca.edwards@sydney.edu.au
 Ryan D. Edwards=redwards@qc.cuny.edu
 Mónica Edwards-Schachter=moed@ingenio.upv.es
 Sebastian Edwards=sebastian.edwards@anderson.ucla.edu
 Jan Eeckhout=j.eeckhout@ucl.ac.uk
 Ellis Anthon Eff=anthon.eff@mtsu.edu
 Nury Effendi=nury.effendi@fe.unpad.ac.id
 Ekpeno Linus Effiong=ekpenol@gmail.com
 Anne Bradstreet Wallace Effland=aeffland@ers.usda.gov
 Levan Efremidze=levan.efremidze@gmail.com
 Georgios Efthyvoulou=g.efthyvoulou@sheffield.ac.uk
 Pablo Egana del Sol=pae2110@columbia.edu
 Obiamaka P. Egbo=obiamaka.egbo@unn.edu.ng
 Johan Egebark=johan.egebark@ne.su.se
 Hartmut Egger=hartmut.egger@uni-bayreuth.de
 Thierry Eggerickx=thierry.eggerickx@uclouvain.be
 Peter H. Egger=egger@kof.ethz.ch
 Håkan Eggert=hakan.eggert@economics.gu.se
 Gauti B. Eggertsson=gauti_eggertsson@brown.edu
 Karen Nisa Eggleston=karene@stanford.edu
 Jude EGGOH=comlanvi-jude.eggoh@univ-orleans.fr
 Mark Eghan=nanaeghan@gmail.com
 Massimo Egidi=megidi@luiss.it
 Alfredo D. Egidio dos Reis=alfredo@iseg.utl.pt
 Alexei Egorov=avegorov@mail.wvu.edu
 Lyudmila Egorova=legorova@hse.ru
 Georgy Egorov=g-egorov@kellogg.northwestern.edu
 Martin Egozcue=egozcuemj@gmail.com
 Kyota Eguchi=eguchi@sk.tsukuba.ac.jp
 Jon X Eguia=jon.eguia@bristol.ac.uk
 Melf-Hinrich Ehlers=melf.ehlers@hutton.ac.uk
 Cole Ehmke=cehmke@uwyo.edu
 Ronald Ehrenberg=rge2@cornell.edu
 Norman Ehrentreich=ehrentreich@ldi-research.com
 Jürgen Ehrke=jehrke@gmail.com
 Isaac Ehrlich=mgtehrl@buffalo.edu
 Michael Ehrmann=mehrmann@bankofcanada.ca
 Peter Eibich=peibich@diw.de
 Martin Eichenbaum=eich@northwestern.edu
 Reiner Eichenberger=reiner.eichenberger@unifr.ch
 Barry Eichengreen=eichengr@econ.berkeley.edu
 Theo Eicher=te@u.washington.edu
 Werner Eichhorst=eichhorst@iza.org
 Stefan Eichler=stefan.eichler@tu-dresden.de
 Alexander Friedrich Eickelpasch=aeickelpasch@diw.de
 Sandra Eickmeier=sandra.eickmeier@bundesbank.de
 Ashraf Galal Eid=asheid@kfupm.edu.sa
 Erling Eide=erling.eide@jus.uio.no
 Jean Eid=jeid@wlu.ca
 Thomas Eife=eife@uni-hd.de
 Sylvester Eijffinger=s.c.w.eijffinger@uvt.nl
 Bjarni G. Einarsson=bjagein@gmail.com
 Hassan Eini-Zinab=h_eini_z@yahoo.com
 Klaus Eisenack=klaus.eisenack@uni-oldenburg.de
 Robert Allen Eisenbeis=770rae@gmail.com
 Larry Eisenberg=larry@riskengineer.com
 Theodore Eisenberg=te13@cornell.edu
 Jens Eisenschmidt=jens.eisenschmidt@ecb.int
 Thomas Eisensee=thomas.eisensee@finance.ministry.se
 Michael Eisermann=michael.eisermann@mathematik.uni-stuttgart.de
 Joel Hinaunye Eita=hinaeita@yahoo.co.uk
 João Miguel Ejarque=joao.ejarque@econ.ku.dk
 Olof Ejermo=olof.ejermo@circle.lu.se
 Anders Ekeland=anders.ekeland@online.no
 Robert B. Ekelund=bobekelund@prodigy.net
 Anders Ekholm=anders.ekholm@hanken.fi
 Karolina Ekholm=karolina.ekholm@riksbank.se
 Cumhur Ekinci=ekincicu@itu.edu.tr
 Caner Ekizceleroglu=canerekizceleroglu@gmail.com
 Matias Eklöf=maek28@handelsbanken.se
 Johan Erik Eklund=johan.eklund@ihh.hj.se
 Muhammad Ather Elahi=matherelahi@gmail.com
 Vladimir Stanislavovich Elakhovskiy=yelachovskiy@hse.ru
 حسين عبد المطلب الاسرج (Hussein Elasrag)=elasrag@gmail.com
 Mohamed A. Elbannan=melbannan@aucegypt.edu
 Chris Elbers=c.t.m.elbers@vu.nl
 Alexander Elbittar=elbittar@gmail.com
 Adam Elbourne=adam_elbourne@hotmail.com
 Ceyhun Elci=ceyhun.elci@lsbu.ac.uk
 Mohamed El Dahshan=mohamed@post.harvard.edu
 John Elder=john.elder@colostate.edu
 Todd Elder=telder@msu.edu
 Damien Sean Eldridge=d.eldridge@latrobe.edu.au
 Konstantinos Eleftheriou=kostasel@otenet.gr
 Sofia Eleftheriou=sofelef@unipi.gr
 Ola Elerian=lola.elerian@nuffield.oxon.org
 Thomas Elger=thomas@elger.se
 Amirah El-Haddad=amirah.elhaddad@gmail.com
 Mohsen Elhafsi=mohsen.elhafsi@ucr.edu
 Nadima El-Hassan=nadima.el-hassan@uts.edu.au
 Leandro Elia=leandroelia79@gmail.com
 Julio Jorge Elias=je49@cema.edu.ar
 Marcus Eliason=marcus.eliason@ifau.uu.se
 Jonas Eliasson=jonas.eliasson@abe.kth.se
 Bernard Elie=elie.bernard@uqam.ca
 Mikael Elinder=mikael.elinder@nek.uu.se
 Shari Eli=shari.eli@utoronto.ca
 Javier Elizalde=jelizalde@unav.es
 Sarah El Joueidi=sarah.eljoueidi@gmail.com
 Ilyess EL KAROUNI=ilyess.el-karouni@univ-paris8.fr
 David Elkayam=david.elkayam@boi.org.il
 Youssef El-Khatib=youssef_elkhatib@uaeu.ac.ae
 Marwan Elkhoury=elkhoury.marwan@gmail.com
 AbdelRahmen El Lahga=rahmen.lahga@gmail.com
 Lina Maria Ellegård=linamaria.ellegard@nek.lu.se
 Markus Eller=markus.eller@oenb.at
 Andrea Ellero=ellero@unive.it
 Roberto Ellery=ellery@unb.br
 Tore Ellingsen=tore.ellingsen@hhs.se
 Caroline Elliott=c.f.elliott@hud.ac.uk
 Graham Elliott=gelliott@weber.ucsd.edu
 Robert J R Elliott=r.j.elliott@bham.ac.uk
 Gene Ellis=gellis@eerc.kiev.ua
 Michael Ellis=mellis@kent.edu
 Glenn Ellison=gellison@mit.edu
 Martin Ellison=martin.ellison@economics.ox.ac.uk
 Randall P. Ellis=ellisrp@bu.edu
 Matthew Ellman=matthew.ellman@iae.csic.es
 Eskandar Elmarzougui=eskandar.elmarzougui.1@ulaval.ca
 Toufic M. El Masri=elmasri@leuphana.de
 Najat El Mekkaoui de Freitas=najat.el-mekkaoui@dauphine.fr
 Douglas Elmendorf=doug.elmendorf@cbo.gov
 Jihad C. Elnaboulsi=jihad.elnaboulsi@univ-fcomte.fr
 Katarina Elofsson=katarina.elofsson@slu.se
 Pedro Elosegui=pelosegui@bcra.gov.ar
 Imane El Ouadghiri=ielouadg@u-paris10.fr
 Yassine El Qalli=y.elqalli@ucam.ac.ma
 Zouheir El-Sahli=zouheir.el-sahli@nek.lu.se
 Mohammed I. T. El-Sakka=elsakka@cba.edu.kw
 Ahmed Elsayed=a.mohamed@maastrichtuniversity.nl
 Khaled Kadry Elsayed=k_elsayed@mailer.eun.eg
 Tarek el Sehity=tarek.el-sehity@univie.ac.at
 Elgilani Eltahir Elshareif=gsharief@gmail.com
 Helmut Elsinger=helmut.elsinger@oenb.at
 Benjamin Elsner=elsner@iza.org
 Jon Elster=jonelster@hotmail.com
 Steffen Elstner=steffen.elstner@svr-wirtschaft.de
 Julie Ann Elston=julie.elston@osucascades.edu
 Adem Yavuz Elveren=ademyavuzelveren@gmail.com
 Joel Andrew Elvery=joel.elvery@clev.frb.org
 Yousef Elyasi=yousef.elyasi@gmail.com
 Noha M.F. Emara=noha.emara@rutgers.edu
 Abel B. Embaye=abel.embaye@gmail.com
 Patrick M. Emerson=patrick.emerson@oregonstate.edu
 John C Herbert Emery=hemery@ucalgary.ca
 Tom Emery=emery@nidi.nl
 Christian Arnault Emini=ceminia@yahoo.fr
 Furkan Emirmahmutoglu=emirfurkan@gmail.com
 Charlotte Emlinger=charlotte.emlinger@cepii.fr
 Ross B. Emmett=emmettr@msu.edu
 William Robert Emmons=william.r.emmons@stls.frb.org
 Winand Emons=winand.emons@vwi.unibe.ch
 M. Shahe Emran=shahe_emran@yahoo.com
 Cosmin Enache=cosmin.enache@yahoo.com
 David ENCAOUA=encaoua@univ-paris1.fr
 Maria E. Enchautegui=menchautegui@urban.org
 Henrik Enderlein=mail@henrik-enderlein.de
 Walter Enders=wenders@cba.ua.edu
 Jan Willem van den End=w.a.van.den.end@dnb.nl
 James Endres=jend5134@uni.sydney.edu.au
 George Enescu=geogens@yahoo.com
 Charles Engel=cengel@ssc.wisc.edu
 Christoph Engel=engel@coll.mpg.de
 Eduardo M.R.A. Engel=emraengel@gmail.com
 Bryan Engelhardt=bengelha@holycross.edu
 Carina Engelhardt=engelhardt@sopo.uni-hannover.de
 Sebastian von Engelhardt=sebastian.engelhardt@wiwi.uni-jena.de
 Dirk Engelmann=dirk.engelmann@uni-mannheim.de
 Melissa Engel=melissa.engel@zew.de
 Benjamin Engelstätter=engelstaetter@zew.de
 Merwan Engineer=menginee@uvic.ca
 Eric Allen Engle=engleerica@yahoo.com
 Jim Engle-Warnick=jim.engle-warnick@mcgill.ca
 Jeffrey Englin=jenglin@asu.edu
 Eric English=eric.english@bearpeakeconomics.com
 Florian Englmaier=fenglmaier.research@googlemail.com
 Michael Engman=mengman@worldbank.org
 Peter Engseld=peter.engseld@nek.lu.se
 Tom Engsted=tengsted@creates.au.dk
 Per Engström=per.engstrom@nek.uu.se
 Anders Engvall=anders.engvall@hhs.se
 Jacob Engwerda=engwerda@uvt.nl
 Yoke-Kee Eng=engyk@utar.edu.my
 Sören Enkelmann=soeren.enkelmann@googlemail.com
 Ahmed Ennasri=ennasri@lameta.univ-montp1.fr
 Huberto M. Ennis=huberto.ennis@rich.frb.org
 Hernan Enriquez=hernan.enriquez@usa.edu.co
 Dominik Enste=enste@gmx.de
 Rickard Enström=enstroemr@macewan.ca
 Horst Entorf=entorf@wiwi.uni-frankfurt.de
 Yunjong Eo=yunjong.eo@sydney.edu.au
 Patrick Eozenou=peozenou@worldbank.org
 Anne Epaulard=anne.epaulard@dauphine.fr
 Marianna Epicoco=epicoco@unistra.fr
 Paolo Epifani=paolo.epifani@unibocconi.it
 Brendan Epstein=epsteinb@umich.edu
 Gil S. Epstein=gil.epstein@biu.ac.il
 Larry Epstein=lepstein@bu.edu
 Roy Epstein=rje@royepstein.com
 Gheorghe Epuran=epuran.gheorghe@unitbv.ro
 Manuela Epure=mepure@yahoo.com
 Mircea Epure=mircea.epure@upf.edu
 Mustafa Hakan Eratalay=heratalay@eu.spb.ru
 Iñaki Erauskin=inaki.erauskin@deusto.es
 Bahar Celikkol Erbas=bcelikkol@etu.edu.tr
 Nancy Diane Erbe=nerbe@csudh.edu
 Michaela Erbenova=merbenova@imf.org
 Georg Erber=georg.erber@hotmail.de
 Can Erbil=can.erbil@bc.edu
 Aitor Erce=a.erce@esm.europa.eu
 Marco Ercolani=m.g.ercolani@bham.ac.uk
 Paolo Ercolani=p.ercolani@univpm.it
 Valerio Ercolani=valerio.ercolani@gmail.com
 Salvatore Ercolano=sercolano@unior.it
 Fatma Pinar Erdem=pinar.erdem@tcmb.gov.tr
 Magdalena Anna Erdem=magdalena.erdem@bis.org
 Orhan Erdem=orhan.erdem@borsaistanbul.com
 Seda Erdem=seda.erdem@stir.ac.uk
 Tulin Erdem=terdem@stern.nyu.edu
 Didar Erdinç=didar@aubg.bg
 Katrin Erdlenbruch=katrin.erdlenbruch@irstea.fr
 Aygün Erdoğan=aygunerdogan@hotmail.com
 Esen Erdogan Ciftci=eerdoganciftci@gmail.com
 Omer Erdogan=omer.erdogan@tcmb.gov.tr
 Oral Erdogan=oerdogan@pirireis.edu.tr
 Erkan Erdoğdu=erkan@erdogdu.net
 M. Mustafa Erdoğdu=mustafaerdogdu@marmara.edu.tr
 Oya Safinaz Erdogdu=oerdogdu@politics.ankara.edu.tr
 Daniel Erdsiek=erdsiek@zew.de
 Perekunah Bright Eregha=bright049@yahoo.com
 Александр Сергеевич Ерёменко (Aleksandr Yeryomenko)=rags-ase@ya.ru
 Ozkan Eren=oeren@lsu.edu
 Olaf Erenstein=o.erenstein@cgiar.org
 Ozgur Ergungor=ozgur.e.ergungor@clev.frb.org
 Selim Jürgen Ergun=sergun@metu.edu.tr
 Hakan Er=erhakan@akdeniz.edu.tr
 Dejan Eric=eric@ptt.rs
 Neil R. Ericsson=ericsson@frb.gov
 Bo H. Eriksen=bo@sam.sdu.dk
 Michael D. Eriksen=mike.eriksen@ttu.edu
 Jaime Erikson=jaime.erikson@asu.edu
 Tor Eriksson=tor@asb.dk
 Fredrik Erixon=fredrik.erixon@ecipe.org
 Lennart Erixon=lex@ne.su.se
 Emil Erjavec=emil.erjavec@bf.uni-lj.si
 Nisvan Erkal=n.erkal@unimelb.edu.au
 Michael H. R. Erkens=michael.erkens@gmx.net
 Taptuk Emre Erkoc=t.erkoc@keele.ac.uk
 Ulf G. Erlandsson=ulf.erlandsson@hotmail.com
 Albin Erlanson=albin.erlanson@nek.lu.se
 Christophe Ernaelsteen=christophe.ernaelsteen@unamur.be
 Christoph Ernst=ernst@ilo.org
 Ekkehard Ernst=ernste@ilo.org
 Vasily Erokhin=basilic@list.ru
 Isil Erol=isil.erol@ozyegin.edu.tr
 Andres Erosa=andres.erosa@gmail.com
 Guido Erreygers=guido.erreygers@uantwerpen.be
 Özgür Ömer Ersin=ozgurersin@gmail.com
 Filiz Ersoz=fersoz@yahoo.com
 Arhan S. Ertan=arhan.ertan@gmail.com
 Gül Ertan Özgüzer=gul.ertan@ieu.edu.tr
 Ceren Ertan Yoruk=yorukc@sage.edu
 Bilge Erten=be2203@columbia.edu
 Ibrahim Etem Erten=ierten@epdk.org.tr
 Ayşe Ertuğrul=ayse.ertugrul@bahcesehir.edu.tr
 Cemil Ertugrul=cemil51@yahoo.com
 Cem Ertur=cem.ertur@univ-orleans.fr
 Korkut Erturk=erturk@economics.utah.edu
 Mehmet Erturk=merturk@epdk.org.tr
 Abdul Azeez Erumban=a.a.erumban@rug.nl
 Burcay Erus=burcay.erus@boun.edu.tr
 H. Ozan Eruygur=eruygur@gmail.com
 Astrid Oline Ervik=astrid.ervik@nhh.no
 Inger Sommerfelt Ervik=inger.ervik@econ.uib.no
 Mehmet Eryigit=eryigit_m@ibu.edu.tr
 Refik Erzan=erzan@boun.edu.tr
 Cesar L. Escalante=cescalan@uga.edu
 Jose Juan Escalante Fernández=jescalantefernandez@yahoo.com.mx
 Monica Escaleras=mescaler@fau.edu
 Rafael Escalona Reynoso=re32@cornell.edu
 Juan Carlos Escanciano=jescanci@indiana.edu
 Marta Escapa=marta.escapa@ehu.es
 Josep-Oriol Escardibul=oescardibul@ub.edu
 Diego Escobari=escobarida@utpa.edu
 Octavio Romano Escobar Gamboa=oescobar@esg.fr
 Julio Escolano=jescolano@imf.org
 Raul Escorza=raulescorza@hotmail.com
 Laarni Escresa=laarni.escresa@eui.eu
 Alvaro Escribano=alvaroe@eco.uc3m.es
 Francisco Escribano Sotos=francisco.esotos@uclm.es
 Carlos Escudé=ce@cema.edu.ar
 Juan Ramón Escudero Núñez=jescuder@uacj.mx
 Verónica Escudero=escudero@ilo.org
 Hadi Salehi Esfahani=esfahani@illinois.edu
 Hamideh Esfahani=h.esfahani@imps.ac.ir
 Bahtiyor R. Eshchanov=b.eshchanov@gmail.com
 Ruzumboy A. Eshchanov=ruzimboy@mail.ru
 Neil Esho=neil.esho@bis.org
 Simel Esim=esim@ilo.org
 Gunnar S. Eskeland=gunnar.eskeland@nhh.no
 Peter Eso=peter.eso@economics.ox.ac.uk
 Giuseppe Espa=giuseppe.espa@economia.unitn.it
 Antonio M. Espín=kanton@ugr.es
 Emilio Espino=eespino@utdt.edu
 Ana Espinola-Arredondo=anaespinola@wsu.edu
 Alexandra M. Espinosa=alexandra.miranda@epn.edu.ec
 Christian Espinosa=christian.espinosa@udp.cl
 Miguel Andres Espinosa Farfan=espinomics@gmail.com
 Maria Espinosa=mariaespinosagoded@yahoo.es
 Maria Paz Espinosa=mariapaz.espinosa@ehu.es
 Rafael Salvador Espinosa Ramirez=rafaelsa@cucea.udg.mx
 Marco Espinosa-Vega=mespinosa@imf.org
 Raphael Espinoza=raphael.espinoza@chch.oxon.org
 José-Antonio Espín-Sánchez=joseaespin@gmail.com
 Manuel Espitia Escuer=espitia@unizar.es
 Lucio Esposito=lucio.esposito@uea.ac.uk
 Piero Esposito=p.esposito@sssup.it
 Roberto Esposti=r.esposti@univpm.it
 Alexis Sergio Esposto=aesposto@swin.edu.au
 Sergio Espuelas=sergio.espuelas@ub.edu
 Gerardo Esquivel=gesquive@colmex.mx
 Valeria Esquivel=valeria.esquivel@datamarkets.com.ar
 Essahbi Essaadi=essaadi_s@yahoo.fr
 Mohamed Naceur Essaddam=essaddam-n@rmc.ca
 Dennis Essers=dennis.essers@uantwerpen.be
 Jacques Loesse ESSO=lj.esso@gmail.com
 Mercedes Esteban-Bravo=mercedes.esteban@uc3m.es
 Joan Esteban=joan.esteban@iae.csic.es
 Susanna Esteban=susanna.esteban@gmail.com
 Alejandro Esteller-Moré=aesteller@ub.edu
 Fernanda Estevan=festevan@uottawa.ca
 Marcello de Moura Estevao Filho=mestevao@imf.org
 Silviano Esteve-Pérez=sesteve@uv.es
 Luiz Alberto Esteves=esteves@ufpr.br
 Rosa Branca Esteves=rbranca@eeg.uminho.pt
 Vicente Esteve=vicente.esteve@uv.es
 Berta Esteve-Volart=berta@econ.yorku.ca
 Dairo Ayiber Estrada=destrada@banrep.gov.co
 Fernando Estrada=persuacion@gmail.com
 Francisco Estrada=feporrua@atmosfera.unam.mx
 Carmen Estrades=carmen.estrades@gmail.com
 Arturo Estrella=estrea@rpi.edu
 Mukesh Eswaran=mukesh.eswaran@ubc.ca
 Dalibor Eterovic=dalibor.eterovic@uai.cl
 Wilfred John Ethier=ethierwj@msn.com
 Fabrice Etilé=etile@ivry.inra.fr
 Haggay Etkes=haggay@boi.org.il
 Federico Etro=federico.etro@unive.it
 Leonardo Luca Etro=leonardo.etro@sdabocconi.it
 David Ettinger=david.ettinger.fr@gmail.com
 Daniel Etzel=daniel.etzel@uni-bayreuth.de
 Ivan Etzo=ietzo@unica.it
 Nicholas Eubank=nickeubank@gmail.com
 Christian Eufinger=christian.eufinger@hof.uni-frankfurt.de
 Juan Luis Eugenio-Martin=jleugenio@daea.ulpgc.es
 Sara Eugeni=s.eugeni@warwick.ac.uk
 Beatrix Eugster=beatrix.eugster@unisg.ch
 Giuseppe Eusepi=giuseppe.eusepi@uniroma1.it
 Stefano Eusepi=stefano.eusepi@ny.frb.org
 Vasileios G. Evangelidis=vasilis.evangelidis@gmail.com
 Panagiotis Evangelopoulos=panevans@uop.gr
 Anthony J. Evans=anthonyjevans@gmail.com
 Charles L. Evans=charles.l.evans@chi.frb.org
 David Evans=david.evans@globaleconomicsgroup.com
 Edward A. Evans=eaevans@ufl.edu
 George William Evans=gevans@uoregon.edu
 Keith Shannon Evans=kevans@stlawu.edu
 Martin Evans=evansmdd@gmail.com
 Richard William Evans=revans@byu.edu
 Shane Evans=evanssbe@gmail.com
 Simon John Evenett=simon.evenett@unisg.ch
 Eirik Evenhouse=eirik.evenhouse@gmail.com
 William E. Even=evenwe@miamioh.edu
 Gerdie Everaert=gerdie.everaert@ugent.be
 Greetje M.M. Everaert=geveraert@imf.org
 Hans-Dieter Evers=hdevers@uni-bonn.de
 Michael Paul Evers=mevers@uni-bonn.de
 Michiel Evers=michiel.evers@gmail.com
 Martin P. Everts=martin.everts@gmail.com
 Haldun Evrenk=haldun_evrenk@yahoo.com
 Christian-Oliver Ewald=christian.ewald@glasgow.ac.uk
 Christian Ewerhart=christian.ewerhart@econ.uzh.ch
 Casper van Ewijk=c.vanewijk@uva.nl
 Andrew M. Ewing=ewing.andy@gmail.com
 Bradley T. Ewing=bradley.ewing@ttu.edu
 Filippos Exadaktylos=ph.exadaktylos@gmail.com
 Andreas Exenberger=andreas.exenberger@uibk.ac.at
 Manuel Expósito-Langa=maexlan@doe.upv.es
 Pilar Exposito=pilar.exposito@usc.es
 Peter Exterkate=exterkate@creates.au.dk
 Katherine Eyal=katherine.eyal@uct.ac.za
 Johan Eyckmans=johan.eyckmans@kuleuven.be
 Torsten Eymann=torsten.eymann@uni-bayreuth.de
 Roberto Ezcurra=roberto.ezcurra@unavarra.es
 Abel Ebeh Ezeoha=aezeoha@yahoo.co.uk
